Date,Team_target,Team_adversary,Team_target_score,Team_adversary_score,Season,Week,Day_of_week,Type,record,n_wins,n_loses,n_ties,rank,Previous_Rank,Rank_change,record_adversary,n_wins_adversary,n_loses_adversary,n_ties_adversary,rank_adversary,Previous_Rank_adversary,Rank_change_adversary,Game_winner,Rank_difference_before_game
2016-01-03,Arizona Cardinals,Seattle Seahawks,6,36,2015,17,domingo,Regular Season,13-3,13,3,0,4,1,3,10-6,10,6,0,3,10,-7,Seattle Seahawks,9
2016-01-03,Denver Broncos,Los Angeles Chargers,27,20,2015,17,domingo,Regular Season,12-4,12,4,0,2,4,-2,4-12,4,12,0,28,28,0,Denver Broncos,24
2016-01-03,San Francisco 49ers,Los Angeles Rams,19,16,2015,17,domingo,Regular Season,5-11,5,11,0,29,31,-2,7-9,7,9,0,22,17,5,San Francisco 49ers,14
2016-01-03,Atlanta Falcons,New Orleans Saints,17,20,2015,17,domingo,Regular Season,8-8,8,8,0,15,15,0,7-9,7,9,0,19,20,-1,New Orleans Saints,5
2016-01-03,Buffalo Bills,New York Jets,22,17,2015,17,domingo,Regular Season,8-8,8,8,0,14,16,-2,10-6,10,6,0,12,5,7,Buffalo Bills,11
2016-01-03,Carolina Panthers,Tampa Bay Buccaneers,38,10,2015,17,domingo,Regular Season,15-1,15,1,0,1,2,-1,6-10,6,10,0,24,22,2,Carolina Panthers,20
2016-01-03,Chicago Bears,Detroit Lions,20,24,2015,17,domingo,Regular Season,6-10,6,10,0,25,25,0,7-9,7,9,0,20,23,-3,Detroit Lions,2
2016-01-03,Cincinnati Bengals,Baltimore Ravens,24,16,2015,17,domingo,Regular Season,12-4,12,4,0,6,6,0,5-11,5,11,0,26,24,2,Cincinnati Bengals,18
2016-01-03,Cleveland Browns,Pittsburgh Steelers,12,28,2015,17,domingo,Regular Season,3-13,3,13,0,32,30,2,10-6,10,6,0,7,9,-2,Pittsburgh Steelers,21
2016-01-03,Dallas Cowboys,Washington Redskins,23,34,2015,17,domingo,Regular Season,4-12,4,12,0,30,29,1,9-7,9,7,0,11,12,-1,Washington Redskins,17
2016-01-03,Green Bay Packers,Minnesota Vikings,13,20,2015,17,domingo,Regular Season,10-6,10,6,0,10,8,2,11-5,11,5,0,9,11,-2,Minnesota Vikings,3
2016-01-03,Houston Texans,Jacksonville Jaguars,30,6,2015,17,domingo,Regular Season,9-7,9,7,0,13,14,-1,5-11,5,11,0,27,26,1,Houston Texans,12
2016-01-03,Indianapolis Colts,Tennessee Titans,30,24,2015,17,domingo,Regular Season,8-8,8,8,0,17,18,-1,3-13,3,13,0,31,32,-1,Indianapolis Colts,14
2016-01-03,Kansas City Chiefs,Oakland Raiders,23,17,2015,17,domingo,Regular Season,11-5,11,5,0,8,7,1,7-9,7,9,0,16,13,3,Kansas City Chiefs,6
2016-01-03,Miami Dolphins,New England Patriots,20,10,2015,17,domingo,Regular Season,6-10,6,10,0,21,27,-6,12-4,12,4,0,5,3,2,Miami Dolphins,24
2016-01-03,New York Giants,Philadelphia Eagles,30,35,2015,17,domingo,Regular Season,6-10,6,10,0,23,21,2,7-9,7,9,0,18,19,-1,Philadelphia Eagles,2
2015-12-28,Denver Broncos,Cincinnati Bengals,20,17,2015,16,segunda,Regular Season,11-4,11,4,0,4,8,-4,11-4,11,4,0,6,5,1,Denver Broncos,3
2015-12-27,Arizona Cardinals,Green Bay Packers,38,8,2015,16,domingo,Regular Season,13-2,13,2,0,1,2,-1,10-5,10,5,0,8,6,2,Arizona Cardinals,4
2015-12-27,Seattle Seahawks,Los Angeles Rams,17,23,2015,16,domingo,Regular Season,9-6,9,6,0,10,7,3,7-8,7,8,0,17,22,-5,Los Angeles Rams,15
2015-12-27,New Orleans Saints,Jacksonville Jaguars,38,27,2015,16,domingo,Regular Season,6-9,6,9,0,20,23,-3,5-10,5,10,0,26,20,6,New Orleans Saints,3
2015-12-27,Atlanta Falcons,Carolina Panthers,20,13,2015,16,domingo,Regular Season,8-7,8,7,0,15,16,-1,14-1,14,1,0,2,1,1,Atlanta Falcons,15
2015-12-27,Baltimore Ravens,Pittsburgh Steelers,20,17,2015,16,domingo,Regular Season,5-10,5,10,0,24,28,-4,9-6,9,6,0,9,4,5,Baltimore Ravens,24
2015-12-27,Buffalo Bills,Dallas Cowboys,16,6,2015,16,domingo,Regular Season,7-8,7,8,0,16,18,-2,4-11,4,11,0,29,29,0,Buffalo Bills,11
2015-12-27,Detroit Lions,San Francisco 49ers,32,17,2015,16,domingo,Regular Season,6-9,6,9,0,23,26,-3,4-11,4,11,0,31,30,1,Detroit Lions,4
2015-12-27,Kansas City Chiefs,Cleveland Browns,17,13,2015,16,domingo,Regular Season,10-5,10,5,0,7,9,-2,3-12,3,12,0,30,32,-2,Kansas City Chiefs,23
2015-12-27,Miami Dolphins,Indianapolis Colts,12,18,2015,16,domingo,Regular Season,5-10,5,10,0,27,25,2,7-8,7,8,0,18,21,-3,Indianapolis Colts,4
2015-12-27,Minnesota Vikings,New York Giants,49,17,2015,16,domingo,Regular Season,10-5,10,5,0,11,11,0,6-9,6,9,0,21,15,6,Minnesota Vikings,4
2015-12-27,New York Jets,New England Patriots,26,20,2015,16,domingo,Regular Season,10-5,10,5,0,5,10,-5,12-3,12,3,0,3,3,0,New York Jets,7
2015-12-27,Tampa Bay Buccaneers,Chicago Bears,21,26,2015,16,domingo,Regular Season,6-9,6,9,0,22,17,5,6-9,6,9,0,25,24,1,Chicago Bears,7
2015-12-27,Tennessee Titans,Houston Texans,6,34,2015,16,domingo,Regular Season,3-12,3,12,0,32,31,1,8-7,8,7,0,14,13,1,Houston Texans,18
2015-12-26,Philadelphia Eagles,Washington Redskins,24,38,2015,16,sábado,Regular Season,6-9,6,9,0,19,19,0,8-7,8,7,0,12,12,0,Washington Redskins,7
2015-12-24,Oakland Raiders,Los Angeles Chargers,23,20,2015,16,quinta,Regular Season,7-8,7,8,0,13,14,-1,4-11,4,11,0,28,27,1,Oakland Raiders,13
2015-12-21,New Orleans Saints,Detroit Lions,27,35,2015,15,segunda,Regular Season,5-9,5,9,0,23,22,1,5-9,5,9,0,26,25,1,Detroit Lions,3
2015-12-20,Philadelphia Eagles,Arizona Cardinals,17,40,2015,15,domingo,Regular Season,6-8,6,8,0,19,12,7,12-2,12,2,0,2,2,0,Arizona Cardinals,10
2015-12-20,Pittsburgh Steelers,Denver Broncos,34,27,2015,15,domingo,Regular Season,9-5,9,5,0,4,6,-2,10-4,10,4,0,8,5,3,Pittsburgh Steelers,1
2015-12-20,Los Angeles Chargers,Miami Dolphins,30,14,2015,15,domingo,Regular Season,4-10,4,10,0,27,28,-1,5-9,5,9,0,25,23,2,Los Angeles Chargers,5
2015-12-20,San Francisco 49ers,Cincinnati Bengals,14,24,2015,15,domingo,Regular Season,4-10,4,10,0,30,31,-1,11-3,11,3,0,5,4,1,Cincinnati Bengals,27
2015-12-20,Oakland Raiders,Green Bay Packers,20,30,2015,15,domingo,Regular Season,6-8,6,8,0,14,14,0,10-4,10,4,0,6,7,-1,Green Bay Packers,7
2015-12-20,Seattle Seahawks,Cleveland Browns,30,13,2015,15,domingo,Regular Season,9-5,9,5,0,7,8,-1,3-11,3,11,0,32,32,0,Seattle Seahawks,24
2015-12-20,Baltimore Ravens,Kansas City Chiefs,14,34,2015,15,domingo,Regular Season,4-10,4,10,0,28,29,-1,9-5,9,5,0,9,9,0,Kansas City Chiefs,20
2015-12-20,Indianapolis Colts,Houston Texans,10,16,2015,15,domingo,Regular Season,6-8,6,8,0,21,20,1,7-7,7,7,0,13,13,0,Houston Texans,7
2015-12-20,Jacksonville Jaguars,Atlanta Falcons,17,23,2015,15,domingo,Regular Season,5-9,5,9,0,20,21,-1,7-7,7,7,0,16,27,-11,Atlanta Falcons,6
2015-12-20,Minnesota Vikings,Chicago Bears,38,17,2015,15,domingo,Regular Season,9-5,9,5,0,11,11,0,5-9,5,9,0,24,19,5,Minnesota Vikings,8
2015-12-20,New England Patriots,Tennessee Titans,33,16,2015,15,domingo,Regular Season,12-2,12,2,0,3,3,0,3-11,3,11,0,31,30,1,New England Patriots,27
2015-12-20,New York Giants,Carolina Panthers,35,38,2015,15,domingo,Regular Season,6-8,6,8,0,15,17,-2,14-0,14,0,0,1,1,0,Carolina Panthers,16
2015-12-20,Washington Redskins,Buffalo Bills,35,25,2015,15,domingo,Regular Season,7-7,7,7,0,12,15,-3,6-8,6,8,0,18,16,2,Washington Redskins,1
2015-12-19,Dallas Cowboys,New York Jets,16,19,2015,15,sábado,Regular Season,4-10,4,10,0,29,24,5,9-5,9,5,0,10,10,0,New York Jets,14
2015-12-17,Los Angeles Rams,Tampa Bay Buccaneers,31,23,2015,15,quinta,Regular Season,6-8,6,8,0,22,26,-4,6-8,6,8,0,17,18,-1,Los Angeles Rams,8
2015-12-14,Miami Dolphins,New York Giants,24,31,2015,14,segunda,Regular Season,5-8,5,8,0,23,24,-1,6-7,6,7,0,17,20,-3,New York Giants,4
2015-12-13,Baltimore Ravens,Seattle Seahawks,6,35,2015,14,domingo,Regular Season,4-9,4,9,0,29,30,-1,8-5,8,5,0,8,6,2,Seattle Seahawks,24
2015-12-13,Green Bay Packers,Dallas Cowboys,28,7,2015,14,domingo,Regular Season,9-4,9,4,0,7,7,0,4-9,4,9,0,24,23,1,Green Bay Packers,16
2015-12-13,Denver Broncos,Oakland Raiders,12,15,2015,14,domingo,Regular Season,10-3,10,3,0,5,4,1,6-7,6,7,0,14,17,-3,Oakland Raiders,13
2015-12-13,Carolina Panthers,Atlanta Falcons,38,0,2015,14,domingo,Regular Season,13-0,13,0,0,1,1,0,6-7,6,7,0,27,15,12,Carolina Panthers,14
2015-12-13,Chicago Bears,Washington Redskins,21,24,2015,14,domingo,Regular Season,5-8,5,8,0,19,21,-2,6-7,6,7,0,15,18,-3,Washington Redskins,3
2015-12-13,Cincinnati Bengals,Pittsburgh Steelers,20,33,2015,14,domingo,Regular Season,10-3,10,3,0,4,3,1,8-5,8,5,0,6,8,-2,Pittsburgh Steelers,5
2015-12-13,Cleveland Browns,San Francisco 49ers,24,10,2015,14,domingo,Regular Season,3-10,3,10,0,32,32,0,4-9,4,9,0,31,26,5,Cleveland Browns,6
2015-12-13,Houston Texans,New England Patriots,6,27,2015,14,domingo,Regular Season,6-7,6,7,0,13,13,0,11-2,11,2,0,3,5,-2,New England Patriots,8
2015-12-13,Jacksonville Jaguars,Indianapolis Colts,51,16,2015,14,domingo,Regular Season,5-8,5,8,0,21,29,-8,6-7,6,7,0,20,16,4,Jacksonville Jaguars,13
2015-12-13,Kansas City Chiefs,Los Angeles Chargers,10,3,2015,14,domingo,Regular Season,8-5,8,5,0,9,9,0,3-10,3,10,0,28,31,-3,Kansas City Chiefs,22
2015-12-13,New York Jets,Tennessee Titans,30,8,2015,14,domingo,Regular Season,8-5,8,5,0,10,10,0,3-10,3,10,0,30,27,3,New York Jets,17
2015-12-13,Philadelphia Eagles,Buffalo Bills,23,20,2015,14,domingo,Regular Season,6-7,6,7,0,12,19,-7,6-7,6,7,0,16,12,4,Philadelphia Eagles,7
2015-12-13,Los Angeles Rams,Detroit Lions,21,14,2015,14,domingo,Regular Season,5-8,5,8,0,26,28,-2,4-9,4,9,0,25,22,3,Los Angeles Rams,6
2015-12-13,Tampa Bay Buccaneers,New Orleans Saints,17,24,2015,14,domingo,Regular Season,6-7,6,7,0,18,14,4,5-8,5,8,0,22,25,-3,New Orleans Saints,11
2015-12-10,Arizona Cardinals,Minnesota Vikings,23,20,2015,14,quinta,Regular Season,11-2,11,2,0,2,2,0,8-5,8,5,0,11,11,0,Arizona Cardinals,9
2015-12-07,Washington Redskins,Dallas Cowboys,16,19,2015,13,segunda,Regular Season,5-7,5,7,0,18,13,5,4-8,4,8,0,23,29,-6,Dallas Cowboys,16
2015-12-06,Pittsburgh Steelers,Indianapolis Colts,45,10,2015,13,domingo,Regular Season,7-5,7,5,0,8,9,-1,6-6,6,6,0,16,14,2,Pittsburgh Steelers,5
2015-12-06,New England Patriots,Philadelphia Eagles,28,35,2015,13,domingo,Regular Season,10-2,10,2,0,5,2,3,5-7,5,7,0,19,24,-5,Philadelphia Eagles,22
2015-12-06,New Orleans Saints,Carolina Panthers,38,41,2015,13,domingo,Regular Season,4-8,4,8,0,25,22,3,12-0,12,0,0,1,1,0,Carolina Panthers,21
2015-12-06,Oakland Raiders,Kansas City Chiefs,20,34,2015,13,domingo,Regular Season,5-7,5,7,0,17,16,1,7-5,7,5,0,9,10,-1,Kansas City Chiefs,6
2015-12-06,Los Angeles Chargers,Denver Broncos,3,17,2015,13,domingo,Regular Season,3-9,3,9,0,31,27,4,10-2,10,2,0,4,3,1,Denver Broncos,24
2015-12-06,Buffalo Bills,Houston Texans,30,21,2015,13,domingo,Regular Season,6-6,6,6,0,12,19,-7,6-6,6,6,0,13,11,2,Buffalo Bills,8
2015-12-06,Chicago Bears,San Francisco 49ers,20,26,2015,13,domingo,Regular Season,5-7,5,7,0,21,20,1,4-8,4,8,0,26,31,-5,San Francisco 49ers,11
2015-12-06,Cleveland Browns,Cincinnati Bengals,3,37,2015,13,domingo,Regular Season,2-10,2,10,0,32,32,0,10-2,10,2,0,3,5,-2,Cincinnati Bengals,27
2015-12-06,Miami Dolphins,Baltimore Ravens,15,13,2015,13,domingo,Regular Season,5-7,5,7,0,24,23,1,4-8,4,8,0,30,25,5,Miami Dolphins,2
2015-12-06,Minnesota Vikings,Seattle Seahawks,7,38,2015,13,domingo,Regular Season,8-4,8,4,0,11,6,5,7-5,7,5,0,6,7,-1,Seattle Seahawks,1
2015-12-06,New York Giants,New York Jets,20,23,2015,13,domingo,Regular Season,5-7,5,7,0,20,18,2,7-5,7,5,0,10,12,-2,New York Jets,6
2015-12-06,Los Angeles Rams,Arizona Cardinals,3,27,2015,13,domingo,Regular Season,4-8,4,8,0,28,26,2,10-2,10,2,0,2,4,-2,Arizona Cardinals,22
2015-12-06,Tampa Bay Buccaneers,Atlanta Falcons,23,19,2015,13,domingo,Regular Season,6-6,6,6,0,14,17,-3,6-6,6,6,0,15,15,0,Tampa Bay Buccaneers,2
2015-12-06,Tennessee Titans,Jacksonville Jaguars,42,39,2015,13,domingo,Regular Season,3-9,3,9,0,27,30,-3,4-8,4,8,0,29,28,1,Tennessee Titans,2
2015-12-03,Detroit Lions,Green Bay Packers,23,27,2015,13,quinta,Regular Season,4-8,4,8,0,22,21,1,8-4,8,4,0,7,8,-1,Green Bay Packers,13
2015-11-30,Cleveland Browns,Baltimore Ravens,27,33,2015,12,segunda,Regular Season,2-9,2,9,0,32,32,0,4-7,4,7,0,25,30,-5,Baltimore Ravens,2
2015-11-29,Denver Broncos,New England Patriots,30,24,2015,12,domingo,Regular Season,9-2,9,2,0,3,3,0,10-1,10,1,0,2,1,1,Denver Broncos,2
2015-11-29,Seattle Seahawks,Pittsburgh Steelers,39,30,2015,12,domingo,Regular Season,6-5,6,5,0,7,8,-1,6-5,6,5,0,9,9,0,Seattle Seahawks,1
2015-11-29,San Francisco 49ers,Arizona Cardinals,13,19,2015,12,domingo,Regular Season,3-8,3,8,0,31,29,2,9-2,9,2,0,4,4,0,Arizona Cardinals,25
2015-11-29,Atlanta Falcons,Minnesota Vikings,10,20,2015,12,domingo,Regular Season,6-5,6,5,0,15,11,4,8-3,8,3,0,6,7,-1,Minnesota Vikings,4
2015-11-29,Cincinnati Bengals,Los Angeles Rams,31,7,2015,12,domingo,Regular Season,9-2,9,2,0,5,5,0,4-7,4,7,0,26,22,4,Cincinnati Bengals,17
2015-11-29,Houston Texans,New Orleans Saints,24,6,2015,12,domingo,Regular Season,6-5,6,5,0,11,17,-6,4-7,4,7,0,22,26,-4,Houston Texans,9
2015-11-29,Indianapolis Colts,Tampa Bay Buccaneers,25,12,2015,12,domingo,Regular Season,6-5,6,5,0,14,10,4,5-6,5,6,0,17,12,5,Indianapolis Colts,2
2015-11-29,Jacksonville Jaguars,Los Angeles Chargers,25,31,2015,12,domingo,Regular Season,4-7,4,7,0,28,27,1,3-8,3,8,0,27,28,-1,Los Angeles Chargers,1
2015-11-29,Kansas City Chiefs,Buffalo Bills,30,22,2015,12,domingo,Regular Season,6-5,6,5,0,10,13,-3,5-6,5,6,0,19,14,5,Kansas City Chiefs,1
2015-11-29,New York Jets,Miami Dolphins,38,20,2015,12,domingo,Regular Season,6-5,6,5,0,12,16,-4,4-7,4,7,0,23,23,0,New York Jets,7
2015-11-29,Tennessee Titans,Oakland Raiders,21,24,2015,12,domingo,Regular Season,2-9,2,9,0,30,31,-1,5-6,5,6,0,16,18,-2,Oakland Raiders,13
2015-11-29,Washington Redskins,New York Giants,20,14,2015,12,domingo,Regular Season,5-6,5,6,0,13,20,-7,5-6,5,6,0,18,15,3,Washington Redskins,5
2015-11-26,Green Bay Packers,Chicago Bears,13,17,2015,12,quinta,Regular Season,7-4,7,4,0,8,6,2,5-6,5,6,0,20,19,1,Chicago Bears,13
2015-11-26,Dallas Cowboys,Carolina Panthers,14,33,2015,12,quinta,Regular Season,3-8,3,8,0,29,21,8,11-0,11,0,0,1,2,-1,Carolina Panthers,19
2015-11-26,Detroit Lions,Philadelphia Eagles,45,14,2015,12,quinta,Regular Season,4-7,4,7,0,21,24,-3,4-7,4,7,0,24,25,-1,Detroit Lions,1
2015-11-23,New England Patriots,Buffalo Bills,20,13,2015,11,segunda,Regular Season,10-0,10,0,0,1,1,0,5-5,5,5,0,14,12,2,New England Patriots,11
2015-11-22,Arizona Cardinals,Cincinnati Bengals,34,31,2015,11,domingo,Regular Season,8-2,8,2,0,4,3,1,8-2,8,2,0,5,4,1,Arizona Cardinals,1
2015-11-22,Minnesota Vikings,Green Bay Packers,13,30,2015,11,domingo,Regular Season,7-3,7,3,0,7,5,2,7-3,7,3,0,6,6,0,Green Bay Packers,1
2015-11-22,Seattle Seahawks,San Francisco 49ers,29,13,2015,11,domingo,Regular Season,5-5,5,5,0,8,11,-3,3-7,3,7,0,29,31,-2,Seattle Seahawks,20
2015-11-22,Los Angeles Chargers,Kansas City Chiefs,3,33,2015,11,domingo,Regular Season,2-8,2,8,0,28,28,0,5-5,5,5,0,13,15,-2,Kansas City Chiefs,13
2015-11-22,Atlanta Falcons,Indianapolis Colts,21,24,2015,11,domingo,Regular Season,6-4,6,4,0,11,8,3,5-5,5,5,0,10,17,-7,Indianapolis Colts,9
2015-11-22,Baltimore Ravens,Los Angeles Rams,16,13,2015,11,domingo,Regular Season,3-7,3,7,0,30,29,1,4-6,4,6,0,22,21,1,Baltimore Ravens,8
2015-11-22,Carolina Panthers,Washington Redskins,44,16,2015,11,domingo,Regular Season,10-0,10,0,0,2,2,0,4-6,4,6,0,20,20,0,Carolina Panthers,18
2015-11-22,Chicago Bears,Denver Broncos,15,17,2015,11,domingo,Regular Season,4-6,4,6,0,19,16,3,8-2,8,2,0,3,7,-4,Denver Broncos,9
2015-11-22,Detroit Lions,Oakland Raiders,18,13,2015,11,domingo,Regular Season,3-7,3,7,0,24,30,-6,4-6,4,6,0,18,14,4,Detroit Lions,16
2015-11-22,Houston Texans,New York Jets,24,17,2015,11,domingo,Regular Season,5-5,5,5,0,17,22,-5,5-5,5,5,0,16,13,3,Houston Texans,9
2015-11-22,Miami Dolphins,Dallas Cowboys,14,24,2015,11,domingo,Regular Season,4-6,4,6,0,23,18,5,3-7,3,7,0,21,27,-6,Dallas Cowboys,9
2015-11-22,Philadelphia Eagles,Tampa Bay Buccaneers,17,45,2015,11,domingo,Regular Season,4-6,4,6,0,25,19,6,5-5,5,5,0,12,23,-11,Tampa Bay Buccaneers,4
2015-11-19,Jacksonville Jaguars,Tennessee Titans,19,13,2015,11,quinta,Regular Season,4-6,4,6,0,27,26,1,2-8,2,8,0,31,25,6,Jacksonville Jaguars,1
2015-11-16,Cincinnati Bengals,Houston Texans,6,10,2015,10,segunda,Regular Season,8-1,8,1,0,4,2,2,4-5,4,5,0,22,27,-5,Houston Texans,25
2015-11-15,Seattle Seahawks,Arizona Cardinals,32,39,2015,10,domingo,Regular Season,4-5,4,5,0,11,7,4,7-2,7,2,0,3,6,-3,Arizona Cardinals,1
2015-11-15,Denver Broncos,Kansas City Chiefs,13,29,2015,10,domingo,Regular Season,7-2,7,2,0,7,4,3,4-5,4,5,0,15,19,-4,Kansas City Chiefs,15
2015-11-15,New York Giants,New England Patriots,26,27,2015,10,domingo,Regular Season,5-5,5,5,0,10,15,-5,9-0,9,0,0,1,1,0,New England Patriots,14
2015-11-15,Oakland Raiders,Minnesota Vikings,14,30,2015,10,domingo,Regular Season,4-5,4,5,0,14,13,1,7-2,7,2,0,5,8,-3,Minnesota Vikings,5
2015-11-15,Baltimore Ravens,Jacksonville Jaguars,20,22,2015,10,domingo,Regular Season,2-7,2,7,0,29,24,5,3-6,3,6,0,26,31,-5,Jacksonville Jaguars,7
2015-11-15,Green Bay Packers,Detroit Lions,16,18,2015,10,domingo,Regular Season,6-3,6,3,0,6,5,1,2-7,2,7,0,30,32,-2,Detroit Lions,27
2015-11-15,Philadelphia Eagles,Miami Dolphins,19,20,2015,10,domingo,Regular Season,4-5,4,5,0,19,16,3,4-5,4,5,0,18,20,-2,Miami Dolphins,4
2015-11-15,Pittsburgh Steelers,Cleveland Browns,30,9,2015,10,domingo,Regular Season,6-4,6,4,0,9,9,0,2-8,2,8,0,32,28,4,Pittsburgh Steelers,19
2015-11-15,Los Angeles Rams,Chicago Bears,13,37,2015,10,domingo,Regular Season,4-5,4,5,0,21,10,11,4-5,4,5,0,16,21,-5,Chicago Bears,11
2015-11-15,Tampa Bay Buccaneers,Dallas Cowboys,10,6,2015,10,domingo,Regular Season,4-5,4,5,0,23,25,-2,2-7,2,7,0,27,23,4,Tampa Bay Buccaneers,2
2015-11-15,Tennessee Titans,Carolina Panthers,10,27,2015,10,domingo,Regular Season,2-7,2,7,0,25,29,-4,9-0,9,0,0,2,3,-1,Carolina Panthers,26
2015-11-15,Washington Redskins,New Orleans Saints,47,14,2015,10,domingo,Regular Season,4-5,4,5,0,20,26,-6,4-6,4,6,0,24,18,6,Washington Redskins,8
2015-11-12,New York Jets,Buffalo Bills,17,22,2015,10,quinta,Regular Season,5-4,5,4,0,13,11,2,5-4,5,4,0,12,17,-5,Buffalo Bills,6
2015-11-09,Los Angeles Chargers,Chicago Bears,19,22,2015,9,segunda,Regular Season,2-7,2,7,0,22,19,3,3-5,3,5,0,21,28,-7,Chicago Bears,9
2015-11-08,Dallas Cowboys,Philadelphia Eagles,27,33,2015,9,domingo,Regular Season,2-6,2,6,0,23,26,-3,4-4,4,4,0,16,18,-2,Philadelphia Eagles,8
2015-11-08,Indianapolis Colts,Denver Broncos,27,24,2015,9,domingo,Regular Season,4-5,4,5,0,14,22,-8,7-1,7,1,0,4,2,2,Indianapolis Colts,20
2015-11-08,San Francisco 49ers,Atlanta Falcons,17,16,2015,9,domingo,Regular Season,3-6,3,6,0,30,31,-1,6-3,6,3,0,12,7,5,San Francisco 49ers,24
2015-11-08,Tampa Bay Buccaneers,New York Giants,18,32,2015,9,domingo,Regular Season,3-5,3,5,0,25,21,4,5-4,5,4,0,15,14,1,New York Giants,7
2015-11-08,Buffalo Bills,Miami Dolphins,33,17,2015,9,domingo,Regular Season,4-4,4,4,0,17,16,1,3-5,3,5,0,20,17,3,Buffalo Bills,1
2015-11-08,Carolina Panthers,Green Bay Packers,37,29,2015,9,domingo,Regular Season,8-0,8,0,0,3,5,-2,6-2,6,2,0,5,4,1,Carolina Panthers,1
2015-11-08,Minnesota Vikings,Los Angeles Rams,21,18,2015,9,domingo,Regular Season,6-2,6,2,0,8,11,-3,4-4,4,4,0,10,10,0,Minnesota Vikings,1
2015-11-08,New England Patriots,Washington Redskins,27,10,2015,9,domingo,Regular Season,8-0,8,0,0,1,1,0,3-5,3,5,0,26,24,2,New England Patriots,23
2015-11-08,New Orleans Saints,Tennessee Titans,28,34,2015,9,domingo,Regular Season,4-5,4,5,0,18,15,3,2-6,2,6,0,29,32,-3,Tennessee Titans,17
2015-11-08,New York Jets,Jacksonville Jaguars,28,23,2015,9,domingo,Regular Season,5-3,5,3,0,11,12,-1,2-6,2,6,0,31,29,2,New York Jets,17
2015-11-08,Pittsburgh Steelers,Oakland Raiders,38,35,2015,9,domingo,Regular Season,5-4,5,4,0,9,13,-4,4-4,4,4,0,13,9,4,Pittsburgh Steelers,4
2015-11-05,Cincinnati Bengals,Cleveland Browns,31,10,2015,9,quinta,Regular Season,8-0,8,0,0,2,3,-1,2-7,2,7,0,28,23,5,Cincinnati Bengals,20
2015-11-02,Carolina Panthers,Indianapolis Colts,29,26,2015,8,segunda,Regular Season,7-0,7,0,0,5,5,0,3-5,3,5,0,22,18,4,Carolina Panthers,13
2015-11-01,Denver Broncos,Green Bay Packers,29,10,2015,8,domingo,Regular Season,7-0,7,0,0,2,4,-2,6-1,6,1,0,4,2,2,Denver Broncos,2
2015-11-01,Dallas Cowboys,Seattle Seahawks,12,13,2015,8,domingo,Regular Season,2-5,2,5,0,26,20,6,4-4,4,4,0,8,9,-1,Seattle Seahawks,11
2015-11-01,Oakland Raiders,New York Jets,34,20,2015,8,domingo,Regular Season,4-3,4,3,0,9,16,-7,4-3,4,3,0,12,8,4,Oakland Raiders,8
2015-11-01,Atlanta Falcons,Tampa Bay Buccaneers,20,23,2015,8,domingo,Regular Season,6-2,6,2,0,7,7,0,3-4,3,4,0,21,28,-7,Tampa Bay Buccaneers,21
2015-11-01,Baltimore Ravens,Los Angeles Chargers,29,26,2015,8,domingo,Regular Season,2-6,2,6,0,27,26,1,2-6,2,6,0,19,21,-2,Baltimore Ravens,5
2015-11-01,Chicago Bears,Minnesota Vikings,20,23,2015,8,domingo,Regular Season,2-5,2,5,0,28,25,3,5-2,5,2,0,11,11,0,Minnesota Vikings,14
2015-11-01,Cleveland Browns,Arizona Cardinals,20,34,2015,8,domingo,Regular Season,2-6,2,6,0,23,24,-1,6-2,6,2,0,6,6,0,Arizona Cardinals,18
2015-11-01,Houston Texans,Tennessee Titans,20,6,2015,8,domingo,Regular Season,3-5,3,5,0,25,29,-4,1-6,1,6,0,32,30,2,Houston Texans,1
2015-11-01,New Orleans Saints,New York Giants,52,49,2015,8,domingo,Regular Season,4-4,4,4,0,15,17,-2,4-4,4,4,0,14,14,0,New Orleans Saints,3
2015-11-01,Pittsburgh Steelers,Cincinnati Bengals,10,16,2015,8,domingo,Regular Season,4-4,4,4,0,13,10,3,7-0,7,0,0,3,3,0,Cincinnati Bengals,7
2015-11-01,Los Angeles Rams,San Francisco 49ers,27,6,2015,8,domingo,Regular Season,4-3,4,3,0,10,12,-2,2-6,2,6,0,31,27,4,Los Angeles Rams,15
2015-11-01,Kansas City Chiefs,Detroit Lions,45,10,2015,8,domingo,Regular Season,3-5,3,5,0,20,22,-2,1-7,1,7,0,30,31,-1,Kansas City Chiefs,9
2015-10-29,New England Patriots,Miami Dolphins,36,7,2015,8,quinta,Regular Season,7-0,7,0,0,1,1,0,3-4,3,4,0,17,13,4,New England Patriots,12
2015-10-26,Arizona Cardinals,Baltimore Ravens,26,18,2015,7,segunda,Regular Season,5-2,5,2,0,6,4,2,1-6,1,6,0,26,28,-2,Arizona Cardinals,24
2015-10-25,Carolina Panthers,Philadelphia Eagles,27,16,2015,7,domingo,Regular Season,6-0,6,0,0,5,6,-1,3-4,3,4,0,15,9,6,Carolina Panthers,3
2015-10-25,New York Giants,Dallas Cowboys,27,20,2015,7,domingo,Regular Season,4-3,4,3,0,14,14,0,2-4,2,4,0,20,16,4,New York Giants,2
2015-10-25,Los Angeles Chargers,Oakland Raiders,29,37,2015,7,domingo,Regular Season,2-5,2,5,0,21,13,8,3-3,3,3,0,16,23,-7,Oakland Raiders,10
2015-10-25,Detroit Lions,Minnesota Vikings,19,28,2015,7,domingo,Regular Season,1-6,1,6,0,31,24,7,4-2,4,2,0,11,15,-4,Minnesota Vikings,9
2015-10-25,Indianapolis Colts,New Orleans Saints,21,27,2015,7,domingo,Regular Season,3-4,3,4,0,18,11,7,3-4,3,4,0,17,20,-3,New Orleans Saints,9
2015-10-25,Kansas City Chiefs,Pittsburgh Steelers,23,13,2015,7,domingo,Regular Season,2-5,2,5,0,22,29,-7,4-3,4,3,0,10,10,0,Kansas City Chiefs,19
2015-10-25,Miami Dolphins,Houston Texans,44,26,2015,7,domingo,Regular Season,3-3,3,3,0,13,21,-8,2-5,2,5,0,29,26,3,Miami Dolphins,5
2015-10-25,New England Patriots,New York Jets,30,23,2015,7,domingo,Regular Season,6-0,6,0,0,1,1,0,4-2,4,2,0,8,8,0,New England Patriots,7
2015-10-25,Los Angeles Rams,Cleveland Browns,24,6,2015,7,domingo,Regular Season,3-3,3,3,0,12,18,-6,2-5,2,5,0,24,27,-3,Los Angeles Rams,9
2015-10-25,Tennessee Titans,Atlanta Falcons,7,10,2015,7,domingo,Regular Season,1-5,1,5,0,30,30,0,6-1,6,1,0,7,7,0,Atlanta Falcons,23
2015-10-25,Washington Redskins,Tampa Bay Buccaneers,31,30,2015,7,domingo,Regular Season,3-4,3,4,0,23,22,1,2-4,2,4,0,28,31,-3,Washington Redskins,9
2015-10-25,Jacksonville Jaguars,Buffalo Bills,34,31,2015,7,domingo,Regular Season,2-5,2,5,0,32,32,0,3-4,3,4,0,19,17,2,Jacksonville Jaguars,15
2015-10-22,San Francisco 49ers,Seattle Seahawks,3,20,2015,7,quinta,Regular Season,2-5,2,5,0,27,19,8,3-4,3,4,0,9,12,-3,Seattle Seahawks,7
2015-10-19,Philadelphia Eagles,New York Giants,27,7,2015,6,segunda,Regular Season,3-3,3,3,0,9,15,-6,3-3,3,3,0,14,12,2,Philadelphia Eagles,3
2015-10-18,Indianapolis Colts,New England Patriots,27,34,2015,6,domingo,Regular Season,3-3,3,3,0,11,13,-2,5-0,5,0,0,1,1,0,New England Patriots,12
2015-10-18,Green Bay Packers,Los Angeles Chargers,27,20,2015,6,domingo,Regular Season,6-0,6,0,0,2,2,0,2-4,2,4,0,13,14,-1,Green Bay Packers,12
2015-10-18,San Francisco 49ers,Baltimore Ravens,25,20,2015,6,domingo,Regular Season,2-4,2,4,0,19,25,-6,1-5,1,5,0,28,23,5,San Francisco 49ers,2
2015-10-18,Seattle Seahawks,Carolina Panthers,23,27,2015,6,domingo,Regular Season,2-4,2,4,0,12,8,4,5-0,5,0,0,6,7,-1,Carolina Panthers,1
2015-10-18,Buffalo Bills,Cincinnati Bengals,21,34,2015,6,domingo,Regular Season,3-3,3,3,0,17,10,7,6-0,6,0,0,5,5,0,Cincinnati Bengals,5
2015-10-18,Cleveland Browns,Denver Broncos,23,26,2015,6,domingo,Regular Season,2-4,2,4,0,27,20,7,6-0,6,0,0,3,4,-1,Denver Broncos,16
2015-10-18,Detroit Lions,Chicago Bears,37,34,2015,6,domingo,Regular Season,1-5,1,5,0,24,31,-7,2-4,2,4,0,25,24,1,Detroit Lions,7
2015-10-18,Jacksonville Jaguars,Houston Texans,20,31,2015,6,domingo,Regular Season,1-5,1,5,0,32,32,0,2-4,2,4,0,26,30,-4,Houston Texans,2
2015-10-18,Minnesota Vikings,Kansas City Chiefs,16,10,2015,6,domingo,Regular Season,3-2,3,2,0,15,16,-1,1-5,1,5,0,29,19,10,Minnesota Vikings,3
2015-10-18,New York Jets,Washington Redskins,34,20,2015,6,domingo,Regular Season,4-1,4,1,0,8,11,-3,2-4,2,4,0,22,21,1,New York Jets,10
2015-10-18,Pittsburgh Steelers,Arizona Cardinals,25,13,2015,6,domingo,Regular Season,4-2,4,2,0,10,9,1,4-2,4,2,0,4,6,-2,Pittsburgh Steelers,3
2015-10-18,Tennessee Titans,Miami Dolphins,10,38,2015,6,domingo,Regular Season,1-4,1,4,0,30,27,3,2-3,2,3,0,21,29,-8,Miami Dolphins,2
2015-10-15,New Orleans Saints,Atlanta Falcons,31,21,2015,6,quinta,Regular Season,2-4,2,4,0,20,26,-6,5-1,5,1,0,7,3,4,New Orleans Saints,23
2015-10-12,Los Angeles Chargers,Pittsburgh Steelers,20,24,2015,5,segunda,Regular Season,2-3,2,3,0,14,17,-3,3-2,3,2,0,9,10,-1,Pittsburgh Steelers,7
2015-10-11,New York Giants,San Francisco 49ers,30,27,2015,5,domingo,Regular Season,3-2,3,2,0,12,15,-3,1-4,1,4,0,25,27,-2,New York Giants,12
2015-10-11,Dallas Cowboys,New England Patriots,6,30,2015,5,domingo,Regular Season,2-3,2,3,0,18,13,5,4-0,4,0,0,1,1,0,New England Patriots,12
2015-10-11,Oakland Raiders,Denver Broncos,10,16,2015,5,domingo,Regular Season,2-3,2,3,0,22,20,2,5-0,5,0,0,4,3,1,Denver Broncos,17
2015-10-11,Detroit Lions,Arizona Cardinals,17,42,2015,5,domingo,Regular Season,0-5,0,5,0,31,26,5,4-1,4,1,0,6,4,2,Arizona Cardinals,22
2015-10-11,Atlanta Falcons,Washington Redskins,25,19,2015,5,domingo,Regular Season,5-0,5,0,0,3,6,-3,2-3,2,3,0,21,24,-3,Atlanta Falcons,18
2015-10-11,Baltimore Ravens,Cleveland Browns,30,33,2015,5,domingo,Regular Season,1-4,1,4,0,23,19,4,2-3,2,3,0,20,25,-5,Cleveland Browns,6
2015-10-11,Cincinnati Bengals,Seattle Seahawks,27,24,2015,5,domingo,Regular Season,5-0,5,0,0,5,5,0,2-3,2,3,0,8,7,1,Cincinnati Bengals,2
2015-10-11,Green Bay Packers,Los Angeles Rams,24,10,2015,5,domingo,Regular Season,5-0,5,0,0,2,2,0,2-3,2,3,0,17,11,6,Green Bay Packers,9
2015-10-11,Kansas City Chiefs,Chicago Bears,17,18,2015,5,domingo,Regular Season,1-4,1,4,0,19,18,1,2-3,2,3,0,24,29,-5,Chicago Bears,11
2015-10-11,Philadelphia Eagles,New Orleans Saints,39,17,2015,5,domingo,Regular Season,2-3,2,3,0,15,22,-7,1-4,1,4,0,26,21,5,Philadelphia Eagles,1
2015-10-11,Tampa Bay Buccaneers,Jacksonville Jaguars,38,31,2015,5,domingo,Regular Season,2-3,2,3,0,28,32,-4,1-4,1,4,0,32,31,1,Tampa Bay Buccaneers,1
2015-10-11,Tennessee Titans,Buffalo Bills,13,14,2015,5,domingo,Regular Season,1-3,1,3,0,27,23,4,3-2,3,2,0,10,12,-2,Buffalo Bills,11
2015-10-08,Houston Texans,Indianapolis Colts,20,27,2015,5,quinta,Regular Season,1-4,1,4,0,30,28,2,3-2,3,2,0,13,16,-3,Indianapolis Colts,12
2015-10-05,Seattle Seahawks,Detroit Lions,13,10,2015,4,segunda,Regular Season,2-2,2,2,0,7,7,0,0-4,0,4,0,26,25,1,Seattle Seahawks,18
2015-10-04,New Orleans Saints,Dallas Cowboys,26,20,2015,4,domingo,Regular Season,1-3,1,3,0,21,31,-10,2-2,2,2,0,13,11,2,New Orleans Saints,20
2015-10-04,Arizona Cardinals,Los Angeles Rams,22,24,2015,4,domingo,Regular Season,3-1,3,1,0,4,2,2,2-2,2,2,0,11,19,-8,Los Angeles Rams,17
2015-10-04,Denver Broncos,Minnesota Vikings,23,20,2015,4,domingo,Regular Season,4-0,4,0,0,3,4,-1,2-2,2,2,0,14,13,1,Denver Broncos,9
2015-10-04,San Francisco 49ers,Green Bay Packers,3,17,2015,4,domingo,Regular Season,1-3,1,3,0,27,28,-1,4-0,4,0,0,2,3,-1,Green Bay Packers,25
2015-10-04,Los Angeles Chargers,Cleveland Browns,30,27,2015,4,domingo,Regular Season,2-2,2,2,0,17,18,-1,1-3,1,3,0,25,26,-1,Los Angeles Chargers,8
2015-10-04,Atlanta Falcons,Houston Texans,48,21,2015,4,domingo,Regular Season,4-0,4,0,0,6,6,0,1-3,1,3,0,28,21,7,Atlanta Falcons,15
2015-10-04,Buffalo Bills,New York Giants,10,24,2015,4,domingo,Regular Season,2-2,2,2,0,12,10,2,2-2,2,2,0,15,16,-1,New York Giants,6
2015-10-04,Chicago Bears,Oakland Raiders,22,20,2015,4,domingo,Regular Season,1-3,1,3,0,29,32,-3,2-2,2,2,0,20,20,0,Chicago Bears,12
2015-10-04,Cincinnati Bengals,Kansas City Chiefs,36,21,2015,4,domingo,Regular Season,4-0,4,0,0,5,5,0,1-3,1,3,0,18,12,6,Cincinnati Bengals,7
2015-10-04,Indianapolis Colts,Jacksonville Jaguars,16,13,2015,4,domingo,Regular Season,2-2,2,2,0,16,14,2,1-3,1,3,0,31,29,2,Indianapolis Colts,15
2015-10-04,Tampa Bay Buccaneers,Carolina Panthers,23,37,2015,4,domingo,Regular Season,1-3,1,3,0,32,30,2,4-0,4,0,0,8,9,-1,Carolina Panthers,21
2015-10-04,Washington Redskins,Philadelphia Eagles,23,20,2015,4,domingo,Regular Season,2-2,2,2,0,24,27,-3,1-3,1,3,0,22,17,5,Washington Redskins,10
2015-10-03,Miami Dolphins,New York Jets,14,27,2015,4,sábado,Regular Season,1-3,1,3,0,30,23,7,3-1,3,1,0,9,15,-6,New York Jets,8
2015-10-01,Pittsburgh Steelers,Baltimore Ravens,20,23,2015,4,quinta,Regular Season,2-2,2,2,0,10,8,2,1-3,1,3,0,19,22,-3,Baltimore Ravens,14
2015-09-28,Green Bay Packers,Kansas City Chiefs,38,28,2015,3,segunda,Regular Season,3-0,3,0,0,3,2,1,1-2,1,2,0,12,10,2,Green Bay Packers,8
2015-09-27,Detroit Lions,Denver Broncos,12,24,2015,3,domingo,Regular Season,0-3,0,3,0,25,24,1,3-0,3,0,0,4,5,-1,Denver Broncos,19
2015-09-27,Miami Dolphins,Buffalo Bills,14,41,2015,3,domingo,Regular Season,1-2,1,2,0,23,15,8,2-1,2,1,0,10,8,2,Buffalo Bills,7
2015-09-27,Seattle Seahawks,Chicago Bears,26,0,2015,3,domingo,Regular Season,1-2,1,2,0,7,7,0,0-3,0,3,0,32,32,0,Seattle Seahawks,25
2015-09-27,Arizona Cardinals,San Francisco 49ers,47,7,2015,3,domingo,Regular Season,3-0,3,0,0,2,3,-1,1-2,1,2,0,28,20,8,Arizona Cardinals,17
2015-09-27,Baltimore Ravens,Cincinnati Bengals,24,28,2015,3,domingo,Regular Season,0-3,0,3,0,22,17,5,3-0,3,0,0,5,6,-1,Cincinnati Bengals,11
2015-09-27,Carolina Panthers,New Orleans Saints,27,22,2015,3,domingo,Regular Season,3-0,3,0,0,9,14,-5,0-3,0,3,0,31,30,1,Carolina Panthers,16
2015-09-27,Cleveland Browns,Oakland Raiders,20,27,2015,3,domingo,Regular Season,1-2,1,2,0,26,21,5,2-1,2,1,0,20,28,-8,Oakland Raiders,7
2015-09-27,Dallas Cowboys,Atlanta Falcons,28,39,2015,3,domingo,Regular Season,2-1,2,1,0,11,12,-1,3-0,3,0,0,6,11,-5,Atlanta Falcons,1
2015-09-27,Houston Texans,Tampa Bay Buccaneers,19,9,2015,3,domingo,Regular Season,1-2,1,2,0,21,25,-4,1-2,1,2,0,30,29,1,Houston Texans,4
2015-09-27,Minnesota Vikings,Los Angeles Chargers,31,14,2015,3,domingo,Regular Season,2-1,2,1,0,13,16,-3,1-2,1,2,0,18,13,5,Minnesota Vikings,3
2015-09-27,New England Patriots,Jacksonville Jaguars,51,17,2015,3,domingo,Regular Season,3-0,3,0,0,1,1,0,1-2,1,2,0,29,31,-2,New England Patriots,30
2015-09-27,New York Jets,Philadelphia Eagles,17,24,2015,3,domingo,Regular Season,2-1,2,1,0,15,9,6,1-2,1,2,0,17,22,-5,Philadelphia Eagles,13
2015-09-27,Los Angeles Rams,Pittsburgh Steelers,6,12,2015,3,domingo,Regular Season,1-2,1,2,0,19,19,0,2-1,2,1,0,8,4,4,Pittsburgh Steelers,15
2015-09-27,Tennessee Titans,Indianapolis Colts,33,35,2015,3,domingo,Regular Season,1-2,1,2,0,24,27,-3,1-2,1,2,0,14,18,-4,Indianapolis Colts,9
2015-09-24,New York Giants,Washington Redskins,32,21,2015,3,quinta,Regular Season,1-2,1,2,0,16,26,-10,1-2,1,2,0,27,23,4,New York Giants,3
2015-09-21,Indianapolis Colts,New York Jets,7,20,2015,2,segunda,Regular Season,0-2,0,2,0,18,11,7,2-0,2,0,0,9,21,-12,New York Jets,10
2015-09-20,Green Bay Packers,Seattle Seahawks,27,17,2015,2,domingo,Regular Season,2-0,2,0,0,2,2,0,0-2,0,2,0,7,3,4,Green Bay Packers,1
2015-09-20,Philadelphia Eagles,Dallas Cowboys,10,20,2015,2,domingo,Regular Season,0-2,0,2,0,22,15,7,2-0,2,0,0,12,5,7,Dallas Cowboys,10
2015-09-20,Jacksonville Jaguars,Miami Dolphins,23,20,2015,2,domingo,Regular Season,1-1,1,1,0,31,30,1,1-1,1,1,0,15,16,-1,Jacksonville Jaguars,14
2015-09-20,Oakland Raiders,Baltimore Ravens,37,33,2015,2,domingo,Regular Season,1-1,1,1,0,28,31,-3,0-2,0,2,0,17,12,5,Oakland Raiders,19
2015-09-20,Buffalo Bills,New England Patriots,32,40,2015,2,domingo,Regular Season,1-1,1,1,0,8,9,-1,2-0,2,0,0,1,1,0,New England Patriots,8
2015-09-20,Carolina Panthers,Houston Texans,24,17,2015,2,domingo,Regular Season,2-0,2,0,0,14,18,-4,0-2,0,2,0,25,26,-1,Carolina Panthers,8
2015-09-20,Chicago Bears,Arizona Cardinals,23,48,2015,2,domingo,Regular Season,0-2,0,2,0,32,27,5,2-0,2,0,0,3,6,-3,Arizona Cardinals,21
2015-09-20,Cincinnati Bengals,Los Angeles Chargers,24,19,2015,2,domingo,Regular Season,2-0,2,0,0,6,8,-2,1-1,1,1,0,13,10,3,Cincinnati Bengals,2
2015-09-20,Cleveland Browns,Tennessee Titans,28,14,2015,2,domingo,Regular Season,1-1,1,1,0,21,28,-7,1-1,1,1,0,27,23,4,Cleveland Browns,5
2015-09-20,Minnesota Vikings,Detroit Lions,26,16,2015,2,domingo,Regular Season,1-1,1,1,0,16,25,-9,0-2,0,2,0,24,20,4,Minnesota Vikings,5
2015-09-20,New Orleans Saints,Tampa Bay Buccaneers,19,26,2015,2,domingo,Regular Season,0-2,0,2,0,30,22,8,1-1,1,1,0,29,32,-3,Tampa Bay Buccaneers,10
2015-09-20,New York Giants,Atlanta Falcons,20,24,2015,2,domingo,Regular Season,0-2,0,2,0,26,24,2,2-0,2,0,0,11,17,-6,Atlanta Falcons,7
2015-09-20,Pittsburgh Steelers,San Francisco 49ers,43,18,2015,2,domingo,Regular Season,1-1,1,1,0,4,13,-9,1-1,1,1,0,20,19,1,Pittsburgh Steelers,6
2015-09-20,Washington Redskins,Los Angeles Rams,24,10,2015,2,domingo,Regular Season,1-1,1,1,0,23,29,-6,1-1,1,1,0,19,14,5,Washington Redskins,15
2015-09-17,Kansas City Chiefs,Denver Broncos,24,31,2015,2,quinta,Regular Season,1-1,1,1,0,10,7,3,2-0,2,0,0,5,4,1,Denver Broncos,3
2015-09-14,San Francisco 49ers,Minnesota Vikings,20,3,2015,1,segunda,Regular Season,1-0,1,0,0,19,24,-5,0-1,0,1,0,25,17,8,San Francisco 49ers,7
2015-09-14,Atlanta Falcons,Philadelphia Eagles,26,24,2015,1,segunda,Regular Season,1-0,1,0,0,17,23,-6,0-1,0,1,0,15,9,6,Atlanta Falcons,14
2015-09-13,Dallas Cowboys,New York Giants,27,26,2015,1,domingo,Regular Season,1-0,1,0,0,5,6,-1,0-1,0,1,0,24,21,3,Dallas Cowboys,15
2015-09-13,Denver Broncos,Baltimore Ravens,19,13,2015,1,domingo,Regular Season,1-0,1,0,0,4,5,-1,0-1,0,1,0,12,8,4,Denver Broncos,3
2015-09-13,Oakland Raiders,Cincinnati Bengals,13,33,2015,1,domingo,Regular Season,0-1,0,1,0,31,28,3,1-0,1,0,0,8,11,-3,Cincinnati Bengals,17
2015-09-13,Tampa Bay Buccaneers,Tennessee Titans,14,42,2015,1,domingo,Regular Season,0-1,0,1,0,32,29,3,1-0,1,0,0,23,30,-7,Tennessee Titans,1
2015-09-13,Arizona Cardinals,New Orleans Saints,31,19,2015,1,domingo,Regular Season,1-0,1,0,0,6,10,-4,0-1,0,1,0,22,16,6,Arizona Cardinals,6
2015-09-13,Los Angeles Chargers,Detroit Lions,33,28,2015,1,domingo,Regular Season,1-0,1,0,0,10,13,-3,0-1,0,1,0,20,12,8,Los Angeles Chargers,1
2015-09-13,Buffalo Bills,Indianapolis Colts,27,14,2015,1,domingo,Regular Season,1-0,1,0,0,9,18,-9,0-1,0,1,0,11,4,7,Buffalo Bills,14
2015-09-13,Chicago Bears,Green Bay Packers,23,31,2015,1,domingo,Regular Season,0-1,0,1,0,27,25,2,1-0,1,0,0,2,3,-1,Green Bay Packers,22
2015-09-13,Houston Texans,Kansas City Chiefs,20,27,2015,1,domingo,Regular Season,0-1,0,1,0,26,20,6,1-0,1,0,0,7,14,-7,Kansas City Chiefs,6
2015-09-13,Jacksonville Jaguars,Carolina Panthers,9,20,2015,1,domingo,Regular Season,0-1,0,1,0,30,31,-1,1-0,1,0,0,18,19,-1,Carolina Panthers,12
2015-09-13,New York Jets,Cleveland Browns,31,10,2015,1,domingo,Regular Season,1-0,1,0,0,21,26,-5,0-1,0,1,0,28,27,1,New York Jets,1
2015-09-13,Los Angeles Rams,Seattle Seahawks,34,31,2015,1,domingo,Regular Season,1-0,1,0,0,14,22,-8,0-1,0,1,0,3,1,2,Los Angeles Rams,21
2015-09-13,Washington Redskins,Miami Dolphins,10,17,2015,1,domingo,Regular Season,0-1,0,1,0,29,32,-3,1-0,1,0,0,16,15,1,Miami Dolphins,17
2015-09-10,New England Patriots,Pittsburgh Steelers,28,21,2015,1,quinta,Regular Season,1-0,1,0,0,1,2,-1,0-1,0,1,0,13,7,6,New England Patriots,5
2014-12-28,Pittsburgh Steelers,Cincinnati Bengals,27,17,2014,17,domingo,Regular Season,11-5,11,5,0,6,7,-1,10-5,10,5,0,9,8,1,Pittsburgh Steelers,1
2014-12-28,Denver Broncos,Oakland Raiders,47,14,2014,17,domingo,Regular Season,12-4,12,4,0,4,5,-1,3-13,3,13,0,29,28,1,Denver Broncos,23
2014-12-28,San Francisco 49ers,Arizona Cardinals,20,17,2014,17,domingo,Regular Season,8-8,8,8,0,18,18,0,11-5,11,5,0,10,9,1,San Francisco 49ers,9
2014-12-28,Seattle Seahawks,Los Angeles Rams,20,6,2014,17,domingo,Regular Season,12-4,12,4,0,1,2,-1,6-10,6,10,0,22,25,-3,Seattle Seahawks,23
2014-12-28,Atlanta Falcons,Carolina Panthers,3,34,2014,17,domingo,Regular Season,6-10,6,10,0,25,20,5,7-8,7,8,0,15,19,-4,Carolina Panthers,1
2014-12-28,Baltimore Ravens,Cleveland Browns,20,10,2014,17,domingo,Regular Season,10-6,10,6,0,11,12,-1,7-9,7,9,0,23,21,2,Baltimore Ravens,9
2014-12-28,Green Bay Packers,Detroit Lions,30,20,2014,17,domingo,Regular Season,12-4,12,4,0,3,3,0,11-5,11,5,0,7,6,1,Green Bay Packers,3
2014-12-28,Houston Texans,Jacksonville Jaguars,23,17,2014,17,domingo,Regular Season,9-7,9,7,0,14,15,-1,3-13,3,13,0,30,30,0,Houston Texans,15
2014-12-28,Kansas City Chiefs,Los Angeles Chargers,19,7,2014,17,domingo,Regular Season,9-7,9,7,0,13,14,-1,9-7,9,7,0,16,11,5,Kansas City Chiefs,3
2014-12-28,Miami Dolphins,New York Jets,24,37,2014,17,domingo,Regular Season,8-8,8,8,0,19,16,3,4-12,4,12,0,27,29,-2,New York Jets,13
2014-12-28,Minnesota Vikings,Chicago Bears,13,9,2014,17,domingo,Regular Season,7-9,7,9,0,20,23,-3,5-11,5,11,0,26,26,0,Minnesota Vikings,3
2014-12-28,New England Patriots,Buffalo Bills,9,17,2014,17,domingo,Regular Season,12-4,12,4,0,2,1,1,9-7,9,7,0,17,17,0,Buffalo Bills,16
2014-12-28,New York Giants,Philadelphia Eagles,26,34,2014,17,domingo,Regular Season,6-10,6,10,0,24,22,2,10-6,10,6,0,12,13,-1,Philadelphia Eagles,9
2014-12-28,Tampa Bay Buccaneers,New Orleans Saints,20,23,2014,17,domingo,Regular Season,2-14,2,14,0,31,31,0,7-9,7,9,0,21,24,-3,New Orleans Saints,7
2014-12-28,Tennessee Titans,Indianapolis Colts,10,27,2014,17,domingo,Regular Season,2-14,2,14,0,32,32,0,11-5,11,5,0,8,10,-2,Indianapolis Colts,22
2014-12-28,Washington Redskins,Dallas Cowboys,17,44,2014,17,domingo,Regular Season,4-12,4,12,0,28,27,1,12-4,12,4,0,5,4,1,Dallas Cowboys,23
2014-12-22,Cincinnati Bengals,Denver Broncos,37,28,2014,16,segunda,Regular Season,10-4,10,4,0,8,11,-3,11-4,11,4,0,5,2,3,Cincinnati Bengals,9
2014-12-21,Arizona Cardinals,Seattle Seahawks,6,35,2014,16,domingo,Regular Season,11-4,11,4,0,9,5,4,11-4,11,4,0,2,3,-1,Seattle Seahawks,2
2014-12-21,Dallas Cowboys,Indianapolis Colts,42,7,2014,16,domingo,Regular Season,11-4,11,4,0,4,6,-2,10-5,10,5,0,10,7,3,Dallas Cowboys,1
2014-12-21,Oakland Raiders,Buffalo Bills,26,24,2014,16,domingo,Regular Season,3-12,3,12,0,28,31,-3,8-7,8,7,0,17,15,2,Oakland Raiders,16
2014-12-21,Los Angeles Rams,New York Giants,27,37,2014,16,domingo,Regular Season,6-9,6,9,0,25,20,5,6-9,6,9,0,22,25,-3,New York Giants,5
2014-12-21,Carolina Panthers,Cleveland Browns,17,13,2014,16,domingo,Regular Season,6-8,6,8,0,19,22,-3,7-8,7,8,0,21,21,0,Carolina Panthers,1
2014-12-21,Chicago Bears,Detroit Lions,14,20,2014,16,domingo,Regular Season,5-10,5,10,0,26,26,0,11-4,11,4,0,6,8,-2,Detroit Lions,18
2014-12-21,Houston Texans,Baltimore Ravens,25,13,2014,16,domingo,Regular Season,8-7,8,7,0,15,18,-3,9-6,9,6,0,12,12,0,Houston Texans,6
2014-12-21,Miami Dolphins,Minnesota Vikings,37,35,2014,16,domingo,Regular Season,8-7,8,7,0,16,16,0,6-9,6,9,0,23,23,0,Miami Dolphins,7
2014-12-21,New Orleans Saints,Atlanta Falcons,14,30,2014,16,domingo,Regular Season,6-9,6,9,0,24,19,5,6-9,6,9,0,20,24,-4,Atlanta Falcons,5
2014-12-21,New York Jets,New England Patriots,16,17,2014,16,domingo,Regular Season,3-12,3,12,0,29,27,2,12-3,12,3,0,1,1,0,New England Patriots,26
2014-12-21,Pittsburgh Steelers,Kansas City Chiefs,20,12,2014,16,domingo,Regular Season,10-5,10,5,0,7,10,-3,8-7,8,7,0,14,13,1,Pittsburgh Steelers,3
2014-12-21,Tampa Bay Buccaneers,Green Bay Packers,3,20,2014,16,domingo,Regular Season,2-13,2,13,0,31,29,2,11-4,11,4,0,3,4,-1,Green Bay Packers,25
2014-12-20,San Francisco 49ers,Los Angeles Chargers,35,38,2014,16,sábado,Regular Season,7-8,7,8,0,18,17,1,9-6,9,6,0,11,14,-3,Los Angeles Chargers,3
2014-12-20,Washington Redskins,Philadelphia Eagles,27,24,2014,16,sábado,Regular Season,4-11,4,11,0,27,28,-1,9-6,9,6,0,13,9,4,Washington Redskins,19
2014-12-18,Jacksonville Jaguars,Tennessee Titans,21,13,2014,16,quinta,Regular Season,3-12,3,12,0,30,30,0,2-13,2,13,0,32,32,0,Jacksonville Jaguars,2
2014-12-15,Chicago Bears,New Orleans Saints,15,31,2014,15,segunda,Regular Season,5-9,5,9,0,26,25,1,6-8,6,8,0,19,23,-4,New Orleans Saints,2
2014-12-14,Philadelphia Eagles,Dallas Cowboys,27,38,2014,15,domingo,Regular Season,9-5,9,5,0,9,7,2,10-4,10,4,0,6,8,-2,Dallas Cowboys,1
2014-12-14,Detroit Lions,Minnesota Vikings,16,14,2014,15,domingo,Regular Season,10-4,10,4,0,8,9,-1,6-8,6,8,0,23,22,1,Detroit Lions,13
2014-12-14,Seattle Seahawks,San Francisco 49ers,17,7,2014,15,domingo,Regular Season,10-4,10,4,0,3,4,-1,7-7,7,7,0,17,16,1,Seattle Seahawks,12
2014-12-14,Los Angeles Chargers,Denver Broncos,10,22,2014,15,domingo,Regular Season,8-6,8,6,0,14,11,3,11-3,11,3,0,2,3,-1,Denver Broncos,8
2014-12-14,Tennessee Titans,New York Jets,11,16,2014,15,domingo,Regular Season,2-12,2,12,0,32,32,0,3-11,3,11,0,27,28,-1,New York Jets,4
2014-12-14,Atlanta Falcons,Pittsburgh Steelers,20,27,2014,15,domingo,Regular Season,5-9,5,9,0,24,21,3,9-5,9,5,0,10,10,0,Pittsburgh Steelers,11
2014-12-14,Baltimore Ravens,Jacksonville Jaguars,20,12,2014,15,domingo,Regular Season,9-5,9,5,0,12,12,0,2-12,2,12,0,30,31,-1,Baltimore Ravens,19
2014-12-14,Buffalo Bills,Green Bay Packers,21,13,2014,15,domingo,Regular Season,8-6,8,6,0,15,17,-2,10-4,10,4,0,4,1,3,Buffalo Bills,16
2014-12-14,Carolina Panthers,Tampa Bay Buccaneers,19,17,2014,15,domingo,Regular Season,5-8,5,8,0,22,24,-2,2-12,2,12,0,29,30,-1,Carolina Panthers,6
2014-12-14,Cleveland Browns,Cincinnati Bengals,0,30,2014,15,domingo,Regular Season,7-7,7,7,0,21,19,2,9-4,9,4,0,11,13,-2,Cincinnati Bengals,6
2014-12-14,Indianapolis Colts,Houston Texans,17,10,2014,15,domingo,Regular Season,10-4,10,4,0,7,6,1,7-7,7,7,0,18,18,0,Indianapolis Colts,12
2014-12-14,Kansas City Chiefs,Oakland Raiders,31,13,2014,15,domingo,Regular Season,8-6,8,6,0,13,14,-1,2-12,2,12,0,31,29,2,Kansas City Chiefs,15
2014-12-14,New England Patriots,Miami Dolphins,41,13,2014,15,domingo,Regular Season,11-3,11,3,0,1,2,-1,7-7,7,7,0,16,15,1,New England Patriots,13
2014-12-14,New York Giants,Washington Redskins,24,13,2014,15,domingo,Regular Season,5-9,5,9,0,25,26,-1,3-11,3,11,0,28,27,1,New York Giants,1
2014-12-11,Los Angeles Rams,Arizona Cardinals,6,12,2014,15,quinta,Regular Season,6-8,6,8,0,20,20,0,11-3,11,3,0,5,5,0,Arizona Cardinals,15
2014-12-08,Green Bay Packers,Atlanta Falcons,43,37,2014,14,segunda,Regular Season,10-3,10,3,0,1,1,0,5-8,5,8,0,21,22,-1,Green Bay Packers,21
2014-12-07,Los Angeles Chargers,New England Patriots,14,23,2014,14,domingo,Regular Season,8-5,8,5,0,11,9,2,10-3,10,3,0,2,2,0,New England Patriots,7
2014-12-07,Oakland Raiders,San Francisco 49ers,24,13,2014,14,domingo,Regular Season,2-11,2,11,0,29,32,-3,7-6,7,6,0,16,12,4,Oakland Raiders,20
2014-12-07,Philadelphia Eagles,Seattle Seahawks,14,24,2014,14,domingo,Regular Season,9-4,9,4,0,7,4,3,9-4,9,4,0,4,5,-1,Seattle Seahawks,1
2014-12-07,Arizona Cardinals,Kansas City Chiefs,17,14,2014,14,domingo,Regular Season,10-3,10,3,0,5,7,-2,7-6,7,6,0,14,14,0,Arizona Cardinals,7
2014-12-07,Denver Broncos,Buffalo Bills,24,17,2014,14,domingo,Regular Season,10-3,10,3,0,3,3,0,7-6,7,6,0,17,17,0,Denver Broncos,14
2014-12-07,Cincinnati Bengals,Pittsburgh Steelers,21,42,2014,14,domingo,Regular Season,8-4,8,4,0,13,10,3,8-5,8,5,0,10,16,-6,Pittsburgh Steelers,6
2014-12-07,Cleveland Browns,Indianapolis Colts,24,25,2014,14,domingo,Regular Season,7-6,7,6,0,19,18,1,9-4,9,4,0,6,6,0,Indianapolis Colts,12
2014-12-07,Detroit Lions,Tampa Bay Buccaneers,34,17,2014,14,domingo,Regular Season,9-4,9,4,0,9,11,-2,2-11,2,11,0,30,28,2,Detroit Lions,17
2014-12-07,Jacksonville Jaguars,Houston Texans,13,27,2014,14,domingo,Regular Season,2-11,2,11,0,31,31,0,7-6,7,6,0,18,20,-2,Houston Texans,11
2014-12-07,Miami Dolphins,Baltimore Ravens,13,28,2014,14,domingo,Regular Season,7-6,7,6,0,15,15,0,8-5,8,5,0,12,13,-1,Baltimore Ravens,2
2014-12-07,Minnesota Vikings,New York Jets,30,24,2014,14,domingo,Regular Season,6-7,6,7,0,22,24,-2,2-11,2,11,0,28,29,-1,Minnesota Vikings,5
2014-12-07,New Orleans Saints,Carolina Panthers,10,41,2014,14,domingo,Regular Season,5-8,5,8,0,23,19,4,4-8,4,8,0,24,25,-1,Carolina Panthers,6
2014-12-07,Tennessee Titans,New York Giants,7,36,2014,14,domingo,Regular Season,2-11,2,11,0,32,30,2,4-9,4,9,0,26,26,0,New York Giants,4
2014-12-07,Washington Redskins,Los Angeles Rams,0,24,2014,14,domingo,Regular Season,3-10,3,10,0,27,27,0,6-7,6,7,0,20,21,-1,Los Angeles Rams,6
2014-12-04,Chicago Bears,Dallas Cowboys,28,41,2014,14,quinta,Regular Season,5-8,5,8,0,25,23,2,9-4,9,4,0,8,8,0,Dallas Cowboys,15
2014-12-01,New York Jets,Miami Dolphins,13,16,2014,13,segunda,Regular Season,2-10,2,10,0,29,30,-1,7-5,7,5,0,15,17,-2,Miami Dolphins,13
2014-11-30,Kansas City Chiefs,Denver Broncos,16,29,2014,13,domingo,Regular Season,7-5,7,5,0,14,12,2,9-3,9,3,0,3,3,0,Denver Broncos,9
2014-11-30,Green Bay Packers,New England Patriots,26,21,2014,13,domingo,Regular Season,9-3,9,3,0,1,2,-1,9-3,9,3,0,2,1,1,Green Bay Packers,1
2014-11-30,Atlanta Falcons,Arizona Cardinals,29,18,2014,13,domingo,Regular Season,5-7,5,7,0,22,22,0,9-3,9,3,0,7,4,3,Atlanta Falcons,18
2014-11-30,Baltimore Ravens,Los Angeles Chargers,33,34,2014,13,domingo,Regular Season,7-5,7,5,0,13,11,2,8-4,8,4,0,9,15,-6,Los Angeles Chargers,4
2014-11-30,Buffalo Bills,Cleveland Browns,26,10,2014,13,domingo,Regular Season,7-5,7,5,0,17,18,-1,7-5,7,5,0,18,16,2,Buffalo Bills,2
2014-11-30,Houston Texans,Tennessee Titans,45,21,2014,13,domingo,Regular Season,6-6,6,6,0,20,20,0,2-10,2,10,0,30,28,2,Houston Texans,8
2014-11-30,Indianapolis Colts,Washington Redskins,49,27,2014,13,domingo,Regular Season,8-4,8,4,0,6,8,-2,3-9,3,9,0,27,27,0,Indianapolis Colts,19
2014-11-30,Jacksonville Jaguars,New York Giants,25,24,2014,13,domingo,Regular Season,2-10,2,10,0,31,32,-1,3-9,3,9,0,26,26,0,Jacksonville Jaguars,6
2014-11-30,Minnesota Vikings,Carolina Panthers,31,13,2014,13,domingo,Regular Season,5-7,5,7,0,24,24,0,3-8,3,8,0,25,25,0,Minnesota Vikings,1
2014-11-30,Pittsburgh Steelers,New Orleans Saints,32,35,2014,13,domingo,Regular Season,7-5,7,5,0,16,14,2,5-7,5,7,0,19,21,-2,New Orleans Saints,7
2014-11-30,Los Angeles Rams,Oakland Raiders,52,0,2014,13,domingo,Regular Season,5-7,5,7,0,21,23,-2,1-11,1,11,0,32,31,1,Los Angeles Rams,8
2014-11-30,Tampa Bay Buccaneers,Cincinnati Bengals,13,14,2014,13,domingo,Regular Season,2-10,2,10,0,28,29,-1,8-3,8,3,0,10,10,0,Cincinnati Bengals,19
2014-11-27,San Francisco 49ers,Seattle Seahawks,3,19,2014,13,quinta,Regular Season,7-5,7,5,0,12,9,3,8-4,8,4,0,5,7,-2,Seattle Seahawks,2
2014-11-27,Dallas Cowboys,Philadelphia Eagles,10,33,2014,13,quinta,Regular Season,8-4,8,4,0,8,5,3,9-3,9,3,0,4,6,-2,Philadelphia Eagles,1
2014-11-27,Detroit Lions,Chicago Bears,34,17,2014,13,quinta,Regular Season,8-4,8,4,0,11,13,-2,5-7,5,7,0,23,19,4,Detroit Lions,6
2014-11-24,New Orleans Saints,Baltimore Ravens,27,34,2014,12,segunda,Regular Season,4-7,4,7,0,21,20,1,7-4,7,4,0,11,14,-3,Baltimore Ravens,6
2014-11-24,Buffalo Bills,New York Jets,38,3,2014,12,segunda,Regular Season,6-5,6,5,0,18,19,-1,2-9,2,9,0,30,28,2,Buffalo Bills,9
2014-11-23,New York Giants,Dallas Cowboys,28,31,2014,12,domingo,Regular Season,3-8,3,8,0,26,26,0,8-3,8,3,0,5,6,-1,Dallas Cowboys,20
2014-11-23,Denver Broncos,Miami Dolphins,39,36,2014,12,domingo,Regular Season,8-3,8,3,0,3,4,-1,6-5,6,5,0,17,15,2,Denver Broncos,11
2014-11-23,San Francisco 49ers,Washington Redskins,17,13,2014,12,domingo,Regular Season,7-4,7,4,0,9,10,-1,3-8,3,8,0,27,29,-2,San Francisco 49ers,19
2014-11-23,Los Angeles Chargers,Los Angeles Rams,27,24,2014,12,domingo,Regular Season,7-4,7,4,0,15,16,-1,4-7,4,7,0,23,22,1,Los Angeles Chargers,6
2014-11-23,Seattle Seahawks,Arizona Cardinals,19,3,2014,12,domingo,Regular Season,7-4,7,4,0,7,11,-4,9-2,9,2,0,4,2,2,Seattle Seahawks,9
2014-11-23,Atlanta Falcons,Cleveland Browns,24,26,2014,12,domingo,Regular Season,4-7,4,7,0,22,21,1,7-4,7,4,0,16,17,-1,Cleveland Browns,4
2014-11-23,Chicago Bears,Tampa Bay Buccaneers,21,13,2014,12,domingo,Regular Season,5-6,5,6,0,19,23,-4,2-9,2,9,0,29,30,-1,Chicago Bears,7
2014-11-23,Houston Texans,Cincinnati Bengals,13,22,2014,12,domingo,Regular Season,5-6,5,6,0,20,18,2,7-3,7,3,0,10,13,-3,Cincinnati Bengals,5
2014-11-23,Indianapolis Colts,Jacksonville Jaguars,23,3,2014,12,domingo,Regular Season,7-4,7,4,0,8,9,-1,1-10,1,10,0,32,31,1,Indianapolis Colts,22
2014-11-23,Minnesota Vikings,Green Bay Packers,21,24,2014,12,domingo,Regular Season,4-7,4,7,0,24,24,0,8-3,8,3,0,2,3,-1,Green Bay Packers,21
2014-11-23,New England Patriots,Detroit Lions,34,9,2014,12,domingo,Regular Season,9-2,9,2,0,1,1,0,7-4,7,4,0,13,7,6,New England Patriots,6
2014-11-23,Philadelphia Eagles,Tennessee Titans,43,24,2014,12,domingo,Regular Season,8-3,8,3,0,6,8,-2,2-9,2,9,0,28,27,1,Philadelphia Eagles,19
2014-11-20,Oakland Raiders,Kansas City Chiefs,24,20,2014,12,quinta,Regular Season,1-10,1,10,0,31,32,-1,7-4,7,4,0,12,5,7,Oakland Raiders,27
2014-11-17,Tennessee Titans,Pittsburgh Steelers,24,27,2014,11,segunda,Regular Season,2-8,2,8,0,27,29,-2,7-4,7,4,0,12,14,-2,Pittsburgh Steelers,15
2014-11-16,Indianapolis Colts,New England Patriots,20,42,2014,11,domingo,Regular Season,6-4,6,4,0,9,7,2,8-2,8,2,0,1,1,0,New England Patriots,6
2014-11-16,Arizona Cardinals,Detroit Lions,14,6,2014,11,domingo,Regular Season,9-1,9,1,0,2,2,0,7-3,7,3,0,7,6,1,Arizona Cardinals,4
2014-11-16,Green Bay Packers,Philadelphia Eagles,53,20,2014,11,domingo,Regular Season,7-3,7,3,0,3,5,-2,7-3,7,3,0,8,4,4,Green Bay Packers,1
2014-11-16,Los Angeles Chargers,Oakland Raiders,13,6,2014,11,domingo,Regular Season,6-4,6,4,0,16,15,1,0-10,0,10,0,32,32,0,Los Angeles Chargers,17
2014-11-16,Carolina Panthers,Atlanta Falcons,17,19,2014,11,domingo,Regular Season,3-7,3,7,0,25,22,3,4-6,4,6,0,21,23,-2,Atlanta Falcons,1
2014-11-16,Chicago Bears,Minnesota Vikings,21,13,2014,11,domingo,Regular Season,4-6,4,6,0,23,27,-4,4-6,4,6,0,24,21,3,Chicago Bears,6
2014-11-16,Cleveland Browns,Houston Texans,7,23,2014,11,domingo,Regular Season,6-4,6,4,0,17,11,6,5-5,5,5,0,18,20,-2,Houston Texans,9
2014-11-16,Kansas City Chiefs,Seattle Seahawks,24,20,2014,11,domingo,Regular Season,7-3,7,3,0,5,10,-5,6-4,6,4,0,11,9,2,Kansas City Chiefs,1
2014-11-16,New Orleans Saints,Cincinnati Bengals,10,27,2014,11,domingo,Regular Season,4-6,4,6,0,20,19,1,6-3,6,3,0,13,16,-3,Cincinnati Bengals,3
2014-11-16,New York Giants,San Francisco 49ers,10,16,2014,11,domingo,Regular Season,3-7,3,7,0,26,24,2,6-4,6,4,0,10,12,-2,San Francisco 49ers,12
2014-11-16,Los Angeles Rams,Denver Broncos,22,7,2014,11,domingo,Regular Season,4-6,4,6,0,22,25,-3,7-3,7,3,0,4,3,1,Los Angeles Rams,22
2014-11-16,Washington Redskins,Tampa Bay Buccaneers,7,27,2014,11,domingo,Regular Season,3-7,3,7,0,29,26,3,2-8,2,8,0,30,30,0,Tampa Bay Buccaneers,4
2014-11-13,Miami Dolphins,Buffalo Bills,22,9,2014,11,quinta,Regular Season,6-4,6,4,0,15,17,-2,5-5,5,5,0,19,18,1,Miami Dolphins,1
2014-11-10,Philadelphia Eagles,Carolina Panthers,45,21,2014,10,segunda,Regular Season,7-2,7,2,0,4,4,0,3-6,3,6,0,22,22,0,Philadelphia Eagles,18
2014-11-09,Green Bay Packers,Chicago Bears,55,14,2014,10,domingo,Regular Season,6-3,6,3,0,5,8,-3,3-6,3,6,0,27,21,6,Green Bay Packers,13
2014-11-09,Arizona Cardinals,Los Angeles Rams,31,14,2014,10,domingo,Regular Season,8-1,8,1,0,2,2,0,3-6,3,6,0,25,25,0,Arizona Cardinals,23
2014-11-09,Seattle Seahawks,New York Giants,38,17,2014,10,domingo,Regular Season,6-3,6,3,0,9,10,-1,3-6,3,6,0,24,24,0,Seattle Seahawks,14
2014-11-09,Oakland Raiders,Denver Broncos,17,41,2014,10,domingo,Regular Season,0-9,0,9,0,32,32,0,7-2,7,2,0,3,3,0,Denver Broncos,29
2014-11-09,Baltimore Ravens,Tennessee Titans,21,7,2014,10,domingo,Regular Season,6-4,6,4,0,13,14,-1,2-7,2,7,0,29,28,1,Baltimore Ravens,14
2014-11-09,Buffalo Bills,Kansas City Chiefs,13,17,2014,10,domingo,Regular Season,5-4,5,4,0,18,18,0,6-3,6,3,0,10,12,-2,Kansas City Chiefs,6
2014-11-09,Detroit Lions,Miami Dolphins,20,16,2014,10,domingo,Regular Season,7-2,7,2,0,6,6,0,5-4,5,4,0,17,13,4,Detroit Lions,7
2014-11-09,Jacksonville Jaguars,Dallas Cowboys,17,31,2014,10,domingo,Regular Season,1-9,1,9,0,31,31,0,7-3,7,3,0,8,9,-1,Dallas Cowboys,22
2014-11-09,New Orleans Saints,San Francisco 49ers,24,27,2014,10,domingo,Regular Season,4-5,4,5,0,19,15,4,5-4,5,4,0,12,16,-4,San Francisco 49ers,1
2014-11-09,New York Jets,Pittsburgh Steelers,20,13,2014,10,domingo,Regular Season,2-8,2,8,0,28,30,-2,6-4,6,4,0,14,7,7,New York Jets,23
2014-11-09,Tampa Bay Buccaneers,Atlanta Falcons,17,27,2014,10,domingo,Regular Season,1-8,1,8,0,30,29,1,3-6,3,6,0,23,27,-4,Atlanta Falcons,2
2014-11-06,Cincinnati Bengals,Cleveland Browns,3,24,2014,10,quinta,Regular Season,5-3,5,3,0,16,11,5,6-3,6,3,0,11,19,-8,Cleveland Browns,8
2014-11-03,New York Giants,Indianapolis Colts,24,40,2014,9,segunda,Regular Season,3-5,3,5,0,24,22,2,6-3,6,3,0,5,9,-4,Indianapolis Colts,13
2014-11-02,Pittsburgh Steelers,Baltimore Ravens,43,23,2014,9,domingo,Regular Season,6-3,6,3,0,7,14,-7,5-4,5,4,0,14,13,1,Pittsburgh Steelers,1
2014-11-02,New England Patriots,Denver Broncos,43,21,2014,9,domingo,Regular Season,7-2,7,2,0,1,3,-2,6-2,6,2,0,3,1,2,New England Patriots,2
2014-11-02,Seattle Seahawks,Oakland Raiders,30,24,2014,9,domingo,Regular Season,5-3,5,3,0,10,10,0,0-8,0,8,0,32,32,0,Seattle Seahawks,22
2014-11-02,San Francisco 49ers,Los Angeles Rams,10,13,2014,9,domingo,Regular Season,4-4,4,4,0,16,11,5,3-5,3,5,0,25,27,-2,Los Angeles Rams,16
2014-11-02,Cincinnati Bengals,Jacksonville Jaguars,33,23,2014,9,domingo,Regular Season,5-2,5,2,0,11,12,-1,1-8,1,8,0,31,31,0,Cincinnati Bengals,19
2014-11-02,Cleveland Browns,Tampa Bay Buccaneers,22,17,2014,9,domingo,Regular Season,5-3,5,3,0,19,19,0,1-7,1,7,0,29,29,0,Cleveland Browns,10
2014-11-02,Dallas Cowboys,Arizona Cardinals,17,28,2014,9,domingo,Regular Season,6-3,6,3,0,9,4,5,7-1,7,1,0,2,2,0,Arizona Cardinals,2
2014-11-02,Houston Texans,Philadelphia Eagles,21,31,2014,9,domingo,Regular Season,4-5,4,5,0,20,21,-1,6-2,6,2,0,4,5,-1,Philadelphia Eagles,16
2014-11-02,Kansas City Chiefs,New York Jets,24,10,2014,9,domingo,Regular Season,5-3,5,3,0,12,15,-3,1-8,1,8,0,30,30,0,Kansas City Chiefs,15
2014-11-02,Miami Dolphins,Los Angeles Chargers,37,0,2014,9,domingo,Regular Season,5-3,5,3,0,13,18,-5,5-4,5,4,0,17,8,9,Miami Dolphins,10
2014-11-02,Minnesota Vikings,Washington Redskins,29,26,2014,9,domingo,Regular Season,4-5,4,5,0,23,25,-2,3-6,3,6,0,26,24,2,Minnesota Vikings,1
2014-10-30,Carolina Panthers,New Orleans Saints,10,28,2014,9,quinta,Regular Season,3-5,3,5,0,22,20,2,4-4,4,4,0,15,17,-2,New Orleans Saints,3
2014-10-27,Dallas Cowboys,Washington Redskins,17,20,2014,8,segunda,Regular Season,6-2,6,2,0,4,2,2,3-5,3,5,0,24,26,-2,Washington Redskins,24
2014-10-26,New Orleans Saints,Green Bay Packers,44,23,2014,8,domingo,Regular Season,3-4,3,4,0,17,22,-5,5-3,5,3,0,7,6,1,New Orleans Saints,16
2014-10-26,Cleveland Browns,Oakland Raiders,23,13,2014,8,domingo,Regular Season,4-3,4,3,0,19,20,-1,0-7,0,7,0,32,32,0,Cleveland Browns,12
2014-10-26,Pittsburgh Steelers,Indianapolis Colts,51,34,2014,8,domingo,Regular Season,5-3,5,3,0,14,15,-1,5-3,5,3,0,9,4,5,Pittsburgh Steelers,11
2014-10-26,Arizona Cardinals,Philadelphia Eagles,24,20,2014,8,domingo,Regular Season,6-1,6,1,0,2,5,-3,5-2,5,2,0,5,3,2,Arizona Cardinals,2
2014-10-26,Carolina Panthers,Seattle Seahawks,9,13,2014,8,domingo,Regular Season,3-4,3,4,0,20,17,3,4-3,4,3,0,10,11,-1,Seattle Seahawks,6
2014-10-26,Cincinnati Bengals,Baltimore Ravens,27,24,2014,8,domingo,Regular Season,4-2,4,2,0,12,13,-1,5-3,5,3,0,13,9,4,Cincinnati Bengals,4
2014-10-26,Jacksonville Jaguars,Miami Dolphins,13,27,2014,8,domingo,Regular Season,1-7,1,7,0,31,31,0,4-3,4,3,0,18,18,0,Miami Dolphins,13
2014-10-26,Kansas City Chiefs,Los Angeles Rams,34,7,2014,8,domingo,Regular Season,4-3,4,3,0,15,14,1,2-5,2,5,0,27,24,3,Kansas City Chiefs,10
2014-10-26,New England Patriots,Chicago Bears,51,23,2014,8,domingo,Regular Season,6-2,6,2,0,3,8,-5,3-5,3,5,0,23,19,4,New England Patriots,11
2014-10-26,New York Jets,Buffalo Bills,23,43,2014,8,domingo,Regular Season,1-7,1,7,0,30,29,1,5-3,5,3,0,16,16,0,Buffalo Bills,13
2014-10-26,Tampa Bay Buccaneers,Minnesota Vikings,13,19,2014,8,domingo,Regular Season,1-6,1,6,0,29,30,-1,3-5,3,5,0,25,27,-2,Minnesota Vikings,3
2014-10-26,Tennessee Titans,Houston Texans,16,30,2014,8,domingo,Regular Season,2-6,2,6,0,28,28,0,4-4,4,4,0,21,23,-2,Houston Texans,5
2014-10-26,Atlanta Falcons,Detroit Lions,21,22,2014,8,domingo,Regular Season,2-6,2,6,0,26,25,1,6-2,6,2,0,6,10,-4,Detroit Lions,15
2014-10-23,Denver Broncos,Los Angeles Chargers,35,21,2014,8,quinta,Regular Season,6-1,6,1,0,1,1,0,5-3,5,3,0,8,7,1,Denver Broncos,6
2014-10-20,Pittsburgh Steelers,Houston Texans,30,23,2014,7,segunda,Regular Season,4-3,4,3,0,15,22,-7,3-4,3,4,0,23,19,4,Pittsburgh Steelers,3
2014-10-19,Denver Broncos,San Francisco 49ers,42,17,2014,7,domingo,Regular Season,5-1,5,1,0,1,1,0,4-3,4,3,0,12,7,5,Denver Broncos,6
2014-10-19,Dallas Cowboys,New York Giants,31,21,2014,7,domingo,Regular Season,6-1,6,1,0,2,3,-1,3-4,3,4,0,21,20,1,Dallas Cowboys,17
2014-10-19,Oakland Raiders,Arizona Cardinals,13,24,2014,7,domingo,Regular Season,0-6,0,6,0,32,31,1,5-1,5,1,0,5,6,-1,Arizona Cardinals,25
2014-10-19,Los Angeles Chargers,Kansas City Chiefs,20,23,2014,7,domingo,Regular Season,5-2,5,2,0,7,2,5,3-3,3,3,0,14,18,-4,Kansas City Chiefs,16
2014-10-19,Baltimore Ravens,Atlanta Falcons,29,7,2014,7,domingo,Regular Season,5-2,5,2,0,9,12,-3,2-5,2,5,0,25,24,1,Baltimore Ravens,12
2014-10-19,Buffalo Bills,Minnesota Vikings,17,16,2014,7,domingo,Regular Season,4-3,4,3,0,16,21,-5,2-5,2,5,0,27,27,0,Buffalo Bills,6
2014-10-19,Chicago Bears,Miami Dolphins,14,27,2014,7,domingo,Regular Season,3-4,3,4,0,19,16,3,3-3,3,3,0,18,23,-5,Miami Dolphins,7
2014-10-19,Detroit Lions,New Orleans Saints,24,23,2014,7,domingo,Regular Season,5-2,5,2,0,10,13,-3,2-4,2,4,0,22,17,5,Detroit Lions,4
2014-10-19,Green Bay Packers,Carolina Panthers,38,17,2014,7,domingo,Regular Season,5-2,5,2,0,6,9,-3,3-3,3,3,0,17,14,3,Green Bay Packers,5
2014-10-19,Indianapolis Colts,Cincinnati Bengals,27,0,2014,7,domingo,Regular Season,5-2,5,2,0,4,8,-4,3-2,3,2,0,13,11,2,Indianapolis Colts,3
2014-10-19,Jacksonville Jaguars,Cleveland Browns,24,6,2014,7,domingo,Regular Season,1-6,1,6,0,31,32,-1,3-3,3,3,0,20,15,5,Jacksonville Jaguars,17
2014-10-19,Los Angeles Rams,Seattle Seahawks,28,26,2014,7,domingo,Regular Season,2-4,2,4,0,24,26,-2,3-3,3,3,0,11,5,6,Los Angeles Rams,21
2014-10-19,Washington Redskins,Tennessee Titans,19,17,2014,7,domingo,Regular Season,2-5,2,5,0,26,28,-2,2-5,2,5,0,28,25,3,Washington Redskins,3
2014-10-16,New England Patriots,New York Jets,27,25,2014,7,quinta,Regular Season,5-2,5,2,0,8,10,-2,1-6,1,6,0,29,29,0,New England Patriots,19
2014-10-13,Los Angeles Rams,San Francisco 49ers,17,31,2014,6,segunda,Regular Season,1-4,1,4,0,26,28,-2,4-2,4,2,0,7,7,0,San Francisco 49ers,21
2014-10-12,Philadelphia Eagles,New York Giants,27,0,2014,6,domingo,Regular Season,5-1,5,1,0,4,4,0,3-3,3,3,0,20,13,7,Philadelphia Eagles,9
2014-10-12,Arizona Cardinals,Washington Redskins,30,20,2014,6,domingo,Regular Season,4-1,4,1,0,6,10,-4,1-5,1,5,0,28,26,2,Arizona Cardinals,16
2014-10-12,Seattle Seahawks,Dallas Cowboys,23,30,2014,6,domingo,Regular Season,3-2,3,2,0,5,1,4,5-1,5,1,0,3,6,-3,Dallas Cowboys,5
2014-10-12,Oakland Raiders,Los Angeles Chargers,28,31,2014,6,domingo,Regular Season,0-5,0,5,0,31,32,-1,5-1,5,1,0,2,3,-1,Los Angeles Chargers,29
2014-10-12,Atlanta Falcons,Chicago Bears,13,27,2014,6,domingo,Regular Season,2-4,2,4,0,24,21,3,3-3,3,3,0,16,22,-6,Chicago Bears,1
2014-10-12,Buffalo Bills,New England Patriots,22,37,2014,6,domingo,Regular Season,3-3,3,3,0,21,18,3,4-2,4,2,0,10,11,-1,New England Patriots,7
2014-10-12,Cincinnati Bengals,Carolina Panthers,37,37,2014,6,domingo,Regular Season,3-1,3,1,0,11,5,6,3-2,3,2,0,14,15,-1,Draw,10
2014-10-12,Cleveland Browns,Pittsburgh Steelers,31,10,2014,6,domingo,Regular Season,3-2,3,2,0,15,23,-8,3-3,3,3,0,22,16,6,Cleveland Browns,7
2014-10-12,Miami Dolphins,Green Bay Packers,24,27,2014,6,domingo,Regular Season,2-3,2,3,0,23,24,-1,4-2,4,2,0,9,9,0,Green Bay Packers,15
2014-10-12,Minnesota Vikings,Detroit Lions,3,17,2014,6,domingo,Regular Season,2-4,2,4,0,27,25,2,4-2,4,2,0,13,14,-1,Detroit Lions,11
2014-10-12,New York Jets,Denver Broncos,17,31,2014,6,domingo,Regular Season,1-5,1,5,0,29,30,-1,4-1,4,1,0,1,2,-1,Denver Broncos,28
2014-10-12,Tampa Bay Buccaneers,Baltimore Ravens,17,48,2014,6,domingo,Regular Season,1-5,1,5,0,30,27,3,4-2,4,2,0,12,12,0,Baltimore Ravens,15
2014-10-12,Tennessee Titans,Jacksonville Jaguars,16,14,2014,6,domingo,Regular Season,2-4,2,4,0,25,29,-4,0-6,0,6,0,32,31,1,Tennessee Titans,2
2014-10-09,Houston Texans,Indianapolis Colts,28,33,2014,6,quinta,Regular Season,3-3,3,3,0,19,17,2,4-2,4,2,0,8,8,0,Indianapolis Colts,9
2014-10-06,Washington Redskins,Seattle Seahawks,17,27,2014,5,segunda,Regular Season,1-4,1,4,0,26,27,-1,3-1,3,1,0,1,1,0,Seattle Seahawks,26
2014-10-05,New England Patriots,Cincinnati Bengals,43,17,2014,5,domingo,Regular Season,3-2,3,2,0,11,16,-5,3-1,3,1,0,5,2,3,New England Patriots,14
2014-10-05,Los Angeles Chargers,New York Jets,31,0,2014,5,domingo,Regular Season,4-1,4,1,0,3,5,-2,1-4,1,4,0,30,26,4,Los Angeles Chargers,21
2014-10-05,San Francisco 49ers,Kansas City Chiefs,22,17,2014,5,domingo,Regular Season,3-2,3,2,0,7,9,-2,2-3,2,3,0,19,14,5,San Francisco 49ers,5
2014-10-05,Denver Broncos,Arizona Cardinals,41,20,2014,5,domingo,Regular Season,3-1,3,1,0,2,3,-1,3-1,3,1,0,10,4,6,Denver Broncos,1
2014-10-05,Carolina Panthers,Chicago Bears,31,24,2014,5,domingo,Regular Season,3-2,3,2,0,15,20,-5,2-3,2,3,0,22,15,7,Carolina Panthers,5
2014-10-05,Dallas Cowboys,Houston Texans,20,17,2014,5,domingo,Regular Season,4-1,4,1,0,6,10,-4,3-2,3,2,0,17,13,4,Dallas Cowboys,3
2014-10-05,Detroit Lions,Buffalo Bills,14,17,2014,5,domingo,Regular Season,3-2,3,2,0,14,8,6,3-2,3,2,0,18,23,-5,Buffalo Bills,15
2014-10-05,Indianapolis Colts,Baltimore Ravens,20,13,2014,5,domingo,Regular Season,3-2,3,2,0,8,11,-3,3-2,3,2,0,12,7,5,Indianapolis Colts,4
2014-10-05,Jacksonville Jaguars,Pittsburgh Steelers,9,17,2014,5,domingo,Regular Season,0-5,0,5,0,31,31,0,3-2,3,2,0,16,18,-2,Pittsburgh Steelers,13
2014-10-05,New Orleans Saints,Tampa Bay Buccaneers,37,31,2014,5,domingo,Regular Season,2-3,2,3,0,20,21,-1,1-4,1,4,0,27,29,-2,New Orleans Saints,8
2014-10-05,New York Giants,Atlanta Falcons,30,20,2014,5,domingo,Regular Season,3-2,3,2,0,13,19,-6,2-3,2,3,0,21,17,4,New York Giants,2
2014-10-05,Philadelphia Eagles,Los Angeles Rams,34,28,2014,5,domingo,Regular Season,4-1,4,1,0,4,6,-2,1-3,1,3,0,28,30,-2,Philadelphia Eagles,24
2014-10-05,Tennessee Titans,Cleveland Browns,28,29,2014,5,domingo,Regular Season,1-4,1,4,0,29,28,1,2-2,2,2,0,23,25,-2,Cleveland Browns,3
2014-10-02,Green Bay Packers,Minnesota Vikings,42,10,2014,5,quinta,Regular Season,3-2,3,2,0,9,12,-3,2-3,2,3,0,25,24,1,Green Bay Packers,12
2014-09-29,Kansas City Chiefs,New England Patriots,41,14,2014,4,segunda,Regular Season,2-2,2,2,0,14,22,-8,2-2,2,2,0,16,7,9,Kansas City Chiefs,15
2014-09-28,Dallas Cowboys,New Orleans Saints,38,17,2014,4,domingo,Regular Season,3-1,3,1,0,10,18,-8,1-3,1,3,0,21,15,6,Dallas Cowboys,3
2014-09-28,Minnesota Vikings,Atlanta Falcons,41,28,2014,4,domingo,Regular Season,2-2,2,2,0,24,29,-5,2-2,2,2,0,17,9,8,Minnesota Vikings,20
2014-09-28,San Francisco 49ers,Philadelphia Eagles,26,21,2014,4,domingo,Regular Season,2-2,2,2,0,9,16,-7,3-1,3,1,0,6,4,2,San Francisco 49ers,12
2014-09-28,Los Angeles Chargers,Jacksonville Jaguars,33,14,2014,4,domingo,Regular Season,3-1,3,1,0,5,6,-1,0-4,0,4,0,31,32,-1,Los Angeles Chargers,26
2014-09-28,Baltimore Ravens,Carolina Panthers,38,10,2014,4,domingo,Regular Season,3-1,3,1,0,7,13,-6,2-2,2,2,0,20,10,10,Baltimore Ravens,3
2014-09-28,Chicago Bears,Green Bay Packers,17,38,2014,4,domingo,Regular Season,2-2,2,2,0,15,8,7,2-2,2,2,0,12,17,-5,Green Bay Packers,9
2014-09-28,Houston Texans,Buffalo Bills,23,17,2014,4,domingo,Regular Season,3-1,3,1,0,13,20,-7,2-2,2,2,0,23,19,4,Houston Texans,1
2014-09-28,Indianapolis Colts,Tennessee Titans,41,17,2014,4,domingo,Regular Season,2-2,2,2,0,11,14,-3,1-3,1,3,0,28,27,1,Indianapolis Colts,13
2014-09-28,New York Jets,Detroit Lions,17,24,2014,4,domingo,Regular Season,1-3,1,3,0,26,21,5,3-1,3,1,0,8,12,-4,Detroit Lions,9
2014-09-28,Oakland Raiders,Miami Dolphins,14,38,2014,4,domingo,Regular Season,0-4,0,4,0,32,30,2,2-2,2,2,0,22,25,-3,Miami Dolphins,5
2014-09-28,Pittsburgh Steelers,Tampa Bay Buccaneers,24,27,2014,4,domingo,Regular Season,2-2,2,2,0,18,11,7,1-3,1,3,0,29,31,-2,Tampa Bay Buccaneers,20
2014-09-25,Washington Redskins,New York Giants,14,45,2014,4,quinta,Regular Season,1-3,1,3,0,27,23,4,2-2,2,2,0,19,26,-7,New York Giants,3
2014-09-22,New York Jets,Chicago Bears,19,27,2014,3,segunda,Regular Season,1-2,1,2,0,21,21,0,2-1,2,1,0,8,11,-3,Chicago Bears,10
2014-09-21,Carolina Panthers,Pittsburgh Steelers,19,37,2014,3,domingo,Regular Season,2-1,2,1,0,10,6,4,2-1,2,1,0,11,19,-8,Pittsburgh Steelers,13
2014-09-21,Miami Dolphins,Kansas City Chiefs,15,34,2014,3,domingo,Regular Season,1-2,1,2,0,25,20,5,1-2,1,2,0,22,27,-5,Kansas City Chiefs,7
2014-09-21,Seattle Seahawks,Denver Broncos,26,20,2014,3,domingo,Regular Season,2-1,2,1,0,1,2,-1,2-1,2,1,0,3,1,2,Seattle Seahawks,1
2014-09-21,Arizona Cardinals,San Francisco 49ers,23,14,2014,3,domingo,Regular Season,3-0,3,0,0,5,9,-4,1-2,1,2,0,16,7,9,Arizona Cardinals,2
2014-09-21,Buffalo Bills,Los Angeles Chargers,10,22,2014,3,domingo,Regular Season,2-1,2,1,0,19,12,7,2-1,2,1,0,6,10,-4,Los Angeles Chargers,2
2014-09-21,Cincinnati Bengals,Tennessee Titans,33,7,2014,3,domingo,Regular Season,3-0,3,0,0,2,3,-1,1-2,1,2,0,27,24,3,Cincinnati Bengals,21
2014-09-21,Cleveland Browns,Baltimore Ravens,21,23,2014,3,domingo,Regular Season,1-2,1,2,0,24,23,1,2-1,2,1,0,13,13,0,Baltimore Ravens,10
2014-09-21,Detroit Lions,Green Bay Packers,19,7,2014,3,domingo,Regular Season,2-1,2,1,0,12,18,-6,1-2,1,2,0,17,8,9,Detroit Lions,10
2014-09-21,Jacksonville Jaguars,Indianapolis Colts,14,44,2014,3,domingo,Regular Season,0-3,0,3,0,32,31,1,1-2,1,2,0,14,15,-1,Indianapolis Colts,16
2014-09-21,New England Patriots,Oakland Raiders,16,9,2014,3,domingo,Regular Season,2-1,2,1,0,7,5,2,0-3,0,3,0,30,32,-2,New England Patriots,27
2014-09-21,New Orleans Saints,Minnesota Vikings,20,9,2014,3,domingo,Regular Season,1-2,1,2,0,15,16,-1,1-2,1,2,0,29,26,3,New Orleans Saints,10
2014-09-21,New York Giants,Houston Texans,30,17,2014,3,domingo,Regular Season,1-2,1,2,0,26,30,-4,2-1,2,1,0,20,14,6,New York Giants,16
2014-09-21,Philadelphia Eagles,Washington Redskins,37,34,2014,3,domingo,Regular Season,3-0,3,0,0,4,4,0,1-2,1,2,0,23,25,-2,Philadelphia Eagles,21
2014-09-21,Los Angeles Rams,Dallas Cowboys,31,34,2014,3,domingo,Regular Season,1-2,1,2,0,28,28,0,2-1,2,1,0,18,22,-4,Dallas Cowboys,6
2014-09-18,Atlanta Falcons,Tampa Bay Buccaneers,56,14,2014,3,quinta,Regular Season,2-1,2,1,0,9,17,-8,0-3,0,3,0,31,29,2,Atlanta Falcons,12
2014-09-15,Indianapolis Colts,Philadelphia Eagles,27,30,2014,2,segunda,Regular Season,0-2,0,2,0,15,10,5,2-0,2,0,0,4,4,0,Philadelphia Eagles,6
2014-09-14,San Francisco 49ers,Chicago Bears,20,28,2014,2,domingo,Regular Season,1-1,1,1,0,7,3,4,1-1,1,1,0,11,18,-7,Chicago Bears,15
2014-09-14,Denver Broncos,Kansas City Chiefs,24,17,2014,2,domingo,Regular Season,2-0,2,0,0,1,2,-1,0-2,0,2,0,27,25,2,Denver Broncos,23
2014-09-14,Green Bay Packers,New York Jets,31,24,2014,2,domingo,Regular Season,1-1,1,1,0,8,8,0,1-1,1,1,0,21,21,0,Green Bay Packers,13
2014-09-14,Oakland Raiders,Houston Texans,14,30,2014,2,domingo,Regular Season,0-2,0,2,0,32,31,1,2-0,2,0,0,14,22,-8,Houston Texans,9
2014-09-14,Los Angeles Chargers,Seattle Seahawks,30,21,2014,2,domingo,Regular Season,1-1,1,1,0,10,16,-6,1-1,1,1,0,2,1,1,Los Angeles Chargers,15
2014-09-14,Tampa Bay Buccaneers,Los Angeles Rams,17,19,2014,2,domingo,Regular Season,0-2,0,2,0,29,24,5,1-1,1,1,0,28,32,-4,Los Angeles Rams,8
2014-09-14,Buffalo Bills,Miami Dolphins,29,10,2014,2,domingo,Regular Season,2-0,2,0,0,12,23,-11,1-1,1,1,0,20,15,5,Buffalo Bills,8
2014-09-14,Carolina Panthers,Detroit Lions,24,7,2014,2,domingo,Regular Season,2-0,2,0,0,6,11,-5,1-1,1,1,0,18,13,5,Carolina Panthers,2
2014-09-14,Cincinnati Bengals,Atlanta Falcons,24,10,2014,2,domingo,Regular Season,2-0,2,0,0,3,5,-2,1-1,1,1,0,17,9,8,Cincinnati Bengals,4
2014-09-14,Cleveland Browns,New Orleans Saints,26,24,2014,2,domingo,Regular Season,1-1,1,1,0,23,29,-6,0-2,0,2,0,16,6,10,Cleveland Browns,23
2014-09-14,Minnesota Vikings,New England Patriots,7,30,2014,2,domingo,Regular Season,1-1,1,1,0,26,17,9,1-1,1,1,0,5,7,-2,New England Patriots,10
2014-09-14,New York Giants,Arizona Cardinals,14,25,2014,2,domingo,Regular Season,0-2,0,2,0,30,26,4,2-0,2,0,0,9,14,-5,Arizona Cardinals,12
2014-09-14,Tennessee Titans,Dallas Cowboys,10,26,2014,2,domingo,Regular Season,1-1,1,1,0,24,19,5,1-1,1,1,0,22,27,-5,Dallas Cowboys,8
2014-09-14,Washington Redskins,Jacksonville Jaguars,41,10,2014,2,domingo,Regular Season,1-1,1,1,0,25,28,-3,0-2,0,2,0,31,30,1,Washington Redskins,2
2014-09-11,Baltimore Ravens,Pittsburgh Steelers,26,6,2014,2,quinta,Regular Season,1-1,1,1,0,13,20,-7,1-1,1,1,0,19,12,7,Baltimore Ravens,8
2014-09-08,Arizona Cardinals,Los Angeles Chargers,18,17,2014,1,segunda,Regular Season,1-0,1,0,0,14,14,0,0-1,0,1,0,16,11,5,Arizona Cardinals,3
2014-09-08,Detroit Lions,New York Giants,35,14,2014,1,segunda,Regular Season,1-0,1,0,0,13,18,-5,0-1,0,1,0,26,20,6,Detroit Lions,2
2014-09-07,Denver Broncos,Indianapolis Colts,31,24,2014,1,domingo,Regular Season,1-0,1,0,0,2,2,0,0-1,0,1,0,10,8,2,Denver Broncos,6
2014-09-07,Dallas Cowboys,San Francisco 49ers,17,28,2014,1,domingo,Regular Season,0-1,0,1,0,27,23,4,1-0,1,0,0,3,4,-1,San Francisco 49ers,19
2014-09-07,Tampa Bay Buccaneers,Carolina Panthers,14,20,2014,1,domingo,Regular Season,0-1,0,1,0,24,19,5,1-0,1,0,0,11,15,-4,Carolina Panthers,4
2014-09-07,Atlanta Falcons,New Orleans Saints,37,34,2014,1,domingo,Regular Season,1-0,1,0,0,9,17,-8,0-1,0,1,0,6,5,1,Atlanta Falcons,12
2014-09-07,Baltimore Ravens,Cincinnati Bengals,16,23,2014,1,domingo,Regular Season,0-1,0,1,0,20,12,8,1-0,1,0,0,5,9,-4,Cincinnati Bengals,3
2014-09-07,Chicago Bears,Buffalo Bills,20,23,2014,1,domingo,Regular Season,0-1,0,1,0,18,10,8,1-0,1,0,0,23,29,-6,Buffalo Bills,19
2014-09-07,Houston Texans,Washington Redskins,17,6,2014,1,domingo,Regular Season,1-0,1,0,0,22,27,-5,0-1,0,1,0,28,25,3,Houston Texans,2
2014-09-07,Kansas City Chiefs,Tennessee Titans,10,26,2014,1,domingo,Regular Season,0-1,0,1,0,25,16,9,1-0,1,0,0,19,28,-9,Tennessee Titans,12
2014-09-07,Miami Dolphins,New England Patriots,33,20,2014,1,domingo,Regular Season,1-0,1,0,0,15,22,-7,0-1,0,1,0,7,3,4,Miami Dolphins,19
2014-09-07,New York Jets,Oakland Raiders,19,14,2014,1,domingo,Regular Season,1-0,1,0,0,21,21,0,0-1,0,1,0,31,32,-1,New York Jets,11
2014-09-07,Philadelphia Eagles,Jacksonville Jaguars,34,17,2014,1,domingo,Regular Season,1-0,1,0,0,4,7,-3,0-1,0,1,0,30,31,-1,Philadelphia Eagles,24
2014-09-07,Pittsburgh Steelers,Cleveland Browns,30,27,2014,1,domingo,Regular Season,1-0,1,0,0,12,13,-1,0-1,0,1,0,29,30,-1,Pittsburgh Steelers,17
2014-09-07,Los Angeles Rams,Minnesota Vikings,6,34,2014,1,domingo,Regular Season,0-1,0,1,0,32,24,8,1-0,1,0,0,17,26,-9,Minnesota Vikings,2
2014-09-04,Seattle Seahawks,Green Bay Packers,36,16,2014,1,quinta,Regular Season,1-0,1,0,0,1,1,0,0-1,0,1,0,8,6,2,Seattle Seahawks,5
2013-12-29,Atlanta Falcons,Carolina Panthers,20,21,2013,17,domingo,Regular Season,4-12,4,12,0,26,27,-1,12-4,12,4,0,3,3,0,Carolina Panthers,24
2013-12-29,Chicago Bears,Green Bay Packers,28,33,2013,17,domingo,Regular Season,8-8,8,8,0,15,13,2,8-7,8,7,0,13,17,-4,Green Bay Packers,4
2013-12-29,Tennessee Titans,Houston Texans,16,10,2013,17,domingo,Regular Season,7-9,7,9,0,22,21,1,2-14,2,14,0,32,32,0,Tennessee Titans,11
2013-12-29,Pittsburgh Steelers,Cleveland Browns,20,7,2013,17,domingo,Regular Season,8-8,8,8,0,14,18,-4,4-12,4,12,0,28,28,0,Pittsburgh Steelers,10
2013-12-29,New York Giants,Washington Redskins,20,6,2013,17,domingo,Regular Season,7-9,7,9,0,23,24,-1,3-13,3,13,0,31,31,0,New York Giants,7
2013-12-29,Cincinnati Bengals,Baltimore Ravens,34,17,2013,17,domingo,Regular Season,11-5,11,5,0,7,7,0,8-8,8,8,0,16,14,2,Cincinnati Bengals,7
2013-12-29,Indianapolis Colts,Jacksonville Jaguars,30,10,2013,17,domingo,Regular Season,11-5,11,5,0,8,8,0,4-12,4,12,0,29,29,0,Indianapolis Colts,21
2013-12-29,Dallas Cowboys,Philadelphia Eagles,22,24,2013,17,domingo,Regular Season,8-8,8,8,0,17,15,2,10-6,10,6,0,11,11,0,Philadelphia Eagles,4
2013-12-29,Miami Dolphins,New York Jets,7,20,2013,17,domingo,Regular Season,8-8,8,8,0,18,16,2,8-8,8,8,0,19,22,-3,New York Jets,6
2013-12-29,Minnesota Vikings,Detroit Lions,14,13,2013,17,domingo,Regular Season,5-10,5,10,0,24,25,-1,7-9,7,9,0,21,20,1,Minnesota Vikings,5
2013-12-29,New England Patriots,Buffalo Bills,34,20,2013,17,domingo,Regular Season,12-4,12,4,0,5,5,0,6-10,6,10,0,25,23,2,New England Patriots,18
2013-12-29,New Orleans Saints,Tampa Bay Buccaneers,42,17,2013,17,domingo,Regular Season,11-5,11,5,0,6,6,0,4-12,4,12,0,27,26,1,New Orleans Saints,20
2013-12-29,Oakland Raiders,Denver Broncos,14,34,2013,17,domingo,Regular Season,4-12,4,12,0,30,30,0,13-3,13,3,0,2,2,0,Denver Broncos,28
2013-12-29,Arizona Cardinals,San Francisco 49ers,20,23,2013,17,domingo,Regular Season,10-6,10,6,0,9,9,0,12-4,12,4,0,4,4,0,San Francisco 49ers,5
2013-12-29,Los Angeles Chargers,Kansas City Chiefs,27,24,2013,17,domingo,Regular Season,9-7,9,7,0,12,12,0,11-5,11,5,0,10,10,0,Los Angeles Chargers,2
2013-12-29,Seattle Seahawks,Los Angeles Rams,27,9,2013,17,domingo,Regular Season,13-3,13,3,0,1,1,0,7-9,7,9,0,20,19,1,Seattle Seahawks,18
2013-12-23,San Francisco 49ers,Atlanta Falcons,34,24,2013,16,segunda,Regular Season,11-4,11,4,0,4,3,1,4-11,4,11,0,27,28,-1,San Francisco 49ers,25
2013-12-22,Buffalo Bills,Miami Dolphins,19,0,2013,16,domingo,Regular Season,6-9,6,9,0,23,25,-2,8-7,8,7,0,16,14,2,Buffalo Bills,11
2013-12-22,Carolina Panthers,New Orleans Saints,17,13,2013,16,domingo,Regular Season,11-4,11,4,0,3,4,-1,10-5,10,5,0,6,5,1,Carolina Panthers,1
2013-12-22,Washington Redskins,Dallas Cowboys,23,24,2013,16,domingo,Regular Season,3-12,3,12,0,31,31,0,8-7,8,7,0,15,18,-3,Dallas Cowboys,13
2013-12-22,Los Angeles Rams,Tampa Bay Buccaneers,23,13,2013,16,domingo,Regular Season,7-8,7,8,0,19,20,-1,4-11,4,11,0,26,24,2,Los Angeles Rams,4
2013-12-22,Philadelphia Eagles,Chicago Bears,54,11,2013,16,domingo,Regular Season,9-6,9,6,0,11,11,0,8-7,8,7,0,13,13,0,Philadelphia Eagles,2
2013-12-22,New York Jets,Cleveland Browns,24,13,2013,16,domingo,Regular Season,7-8,7,8,0,22,22,0,4-11,4,11,0,28,27,1,New York Jets,5
2013-12-22,Kansas City Chiefs,Indianapolis Colts,7,23,2013,16,domingo,Regular Season,11-4,11,4,0,10,6,4,10-5,10,5,0,8,10,-2,Indianapolis Colts,4
2013-12-22,Cincinnati Bengals,Minnesota Vikings,42,14,2013,16,domingo,Regular Season,10-5,10,5,0,7,9,-2,4-10,4,10,0,25,23,2,Cincinnati Bengals,14
2013-12-22,Houston Texans,Denver Broncos,13,37,2013,16,domingo,Regular Season,2-13,2,13,0,32,32,0,12-3,12,3,0,2,2,0,Denver Broncos,30
2013-12-22,Jacksonville Jaguars,Tennessee Titans,16,20,2013,16,domingo,Regular Season,4-11,4,11,0,29,29,0,6-9,6,9,0,21,21,0,Tennessee Titans,8
2013-12-22,Seattle Seahawks,Arizona Cardinals,10,17,2013,16,domingo,Regular Season,12-3,12,3,0,1,1,0,10-5,10,5,0,9,8,1,Arizona Cardinals,7
2013-12-22,Detroit Lions,New York Giants,20,23,2013,16,domingo,Regular Season,7-8,7,8,0,20,17,3,6-9,6,9,0,24,26,-2,New York Giants,9
2013-12-22,Los Angeles Chargers,Oakland Raiders,26,13,2013,16,domingo,Regular Season,8-7,8,7,0,12,15,-3,4-11,4,11,0,30,30,0,Los Angeles Chargers,15
2013-12-22,Green Bay Packers,Pittsburgh Steelers,31,38,2013,16,domingo,Regular Season,7-7,7,7,0,17,16,1,7-8,7,8,0,18,19,-1,Pittsburgh Steelers,3
2013-12-22,Baltimore Ravens,New England Patriots,7,41,2013,16,domingo,Regular Season,8-7,8,7,0,14,12,2,11-4,11,4,0,5,7,-2,New England Patriots,5
2013-12-16,Detroit Lions,Baltimore Ravens,16,18,2013,15,segunda,Regular Season,7-7,7,7,0,17,12,5,8-6,8,6,0,12,14,-2,Baltimore Ravens,2
2013-12-15,Atlanta Falcons,Washington Redskins,27,26,2013,15,domingo,Regular Season,4-10,4,10,0,28,30,-2,3-11,3,11,0,31,31,0,Atlanta Falcons,1
2013-12-15,Tampa Bay Buccaneers,San Francisco 49ers,14,33,2013,15,domingo,Regular Season,4-10,4,10,0,24,24,0,10-4,10,4,0,3,5,-2,San Francisco 49ers,19
2013-12-15,Tennessee Titans,Arizona Cardinals,34,37,2013,15,domingo,Regular Season,5-9,5,9,0,21,22,-1,9-5,9,5,0,8,10,-2,Arizona Cardinals,12
2013-12-15,Los Angeles Rams,New Orleans Saints,27,16,2013,15,domingo,Regular Season,6-8,6,8,0,20,20,0,10-4,10,4,0,5,3,2,Los Angeles Rams,17
2013-12-15,New York Giants,Seattle Seahawks,0,23,2013,15,domingo,Regular Season,5-9,5,9,0,26,23,3,12-2,12,2,0,1,1,0,Seattle Seahawks,22
2013-12-15,Cleveland Browns,Chicago Bears,31,38,2013,15,domingo,Regular Season,4-10,4,10,0,27,25,2,8-6,8,6,0,13,13,0,Chicago Bears,12
2013-12-15,Indianapolis Colts,Houston Texans,25,3,2013,15,domingo,Regular Season,9-5,9,5,0,10,11,-1,2-12,2,12,0,32,32,0,Indianapolis Colts,21
2013-12-15,Jacksonville Jaguars,Buffalo Bills,20,27,2013,15,domingo,Regular Season,4-10,4,10,0,29,29,0,5-9,5,9,0,25,26,-1,Buffalo Bills,3
2013-12-15,Miami Dolphins,New England Patriots,24,20,2013,15,domingo,Regular Season,8-6,8,6,0,14,16,-2,10-4,10,4,0,7,4,3,Miami Dolphins,12
2013-12-15,Minnesota Vikings,Philadelphia Eagles,48,30,2013,15,domingo,Regular Season,4-9,4,9,0,23,27,-4,8-6,8,6,0,11,9,2,Minnesota Vikings,18
2013-12-15,Carolina Panthers,New York Jets,30,20,2013,15,domingo,Regular Season,10-4,10,4,0,4,6,-2,6-8,6,8,0,22,21,1,Carolina Panthers,15
2013-12-15,Oakland Raiders,Kansas City Chiefs,31,56,2013,15,domingo,Regular Season,4-10,4,10,0,30,28,2,11-3,11,3,0,6,7,-1,Kansas City Chiefs,21
2013-12-15,Dallas Cowboys,Green Bay Packers,36,37,2013,15,domingo,Regular Season,7-7,7,7,0,18,15,3,7-6,7,6,0,16,18,-2,Green Bay Packers,3
2013-12-15,Pittsburgh Steelers,Cincinnati Bengals,30,20,2013,15,domingo,Regular Season,6-8,6,8,0,19,19,0,9-5,9,5,0,9,8,1,Pittsburgh Steelers,11
2013-12-12,Denver Broncos,Los Angeles Chargers,20,27,2013,15,quinta,Regular Season,11-3,11,3,0,2,2,0,7-7,7,7,0,15,17,-2,Los Angeles Chargers,15
2013-12-09,Chicago Bears,Dallas Cowboys,45,28,2013,14,segunda,Regular Season,7-6,7,6,0,13,15,-2,7-6,7,6,0,15,11,4,Chicago Bears,4
2013-12-08,New Orleans Saints,Carolina Panthers,31,13,2013,14,domingo,Regular Season,10-3,10,3,0,3,5,-2,9-4,9,4,0,6,3,3,New Orleans Saints,2
2013-12-08,Arizona Cardinals,Los Angeles Rams,30,10,2013,14,domingo,Regular Season,8-5,8,5,0,10,13,-3,5-8,5,8,0,20,20,0,Arizona Cardinals,7
2013-12-08,Los Angeles Chargers,New York Giants,37,14,2013,14,domingo,Regular Season,6-7,6,7,0,17,16,1,5-8,5,8,0,23,22,1,Los Angeles Chargers,6
2013-12-08,San Francisco 49ers,Seattle Seahawks,19,17,2013,14,domingo,Regular Season,9-4,9,4,0,5,6,-1,11-2,11,2,0,1,1,0,San Francisco 49ers,5
2013-12-08,Denver Broncos,Tennessee Titans,51,28,2013,14,domingo,Regular Season,11-2,11,2,0,2,2,0,5-8,5,8,0,22,21,1,Denver Broncos,19
2013-12-08,Baltimore Ravens,Minnesota Vikings,29,26,2013,14,domingo,Regular Season,7-6,7,6,0,14,14,0,3-9,3,9,0,27,28,-1,Baltimore Ravens,14
2013-12-08,Cincinnati Bengals,Indianapolis Colts,42,28,2013,14,domingo,Regular Season,9-4,9,4,0,8,8,0,8-5,8,5,0,11,9,2,Cincinnati Bengals,1
2013-12-08,Green Bay Packers,Atlanta Falcons,22,21,2013,14,domingo,Regular Season,6-6,6,6,0,18,19,-1,3-10,3,10,0,30,29,1,Green Bay Packers,10
2013-12-08,New England Patriots,Cleveland Browns,27,26,2013,14,domingo,Regular Season,10-3,10,3,0,4,4,0,4-9,4,9,0,25,27,-2,New England Patriots,23
2013-12-08,New York Jets,Oakland Raiders,37,27,2013,14,domingo,Regular Season,6-7,6,7,0,21,23,-2,4-9,4,9,0,28,25,3,New York Jets,2
2013-12-08,Philadelphia Eagles,Detroit Lions,34,20,2013,14,domingo,Regular Season,8-5,8,5,0,9,10,-1,7-6,7,6,0,12,12,0,Philadelphia Eagles,2
2013-12-08,Pittsburgh Steelers,Miami Dolphins,28,34,2013,14,domingo,Regular Season,5-8,5,8,0,19,18,1,7-6,7,6,0,16,17,-1,Miami Dolphins,1
2013-12-08,Tampa Bay Buccaneers,Buffalo Bills,27,6,2013,14,domingo,Regular Season,4-9,4,9,0,24,26,-2,4-9,4,9,0,26,24,2,Tampa Bay Buccaneers,2
2013-12-08,Washington Redskins,Kansas City Chiefs,10,45,2013,14,domingo,Regular Season,3-10,3,10,0,31,30,1,10-3,10,3,0,7,7,0,Kansas City Chiefs,23
2013-12-05,Jacksonville Jaguars,Houston Texans,27,20,2013,14,quinta,Regular Season,4-9,4,9,0,29,31,-2,2-11,2,11,0,32,32,0,Jacksonville Jaguars,1
2013-12-02,Seattle Seahawks,New Orleans Saints,34,7,2013,13,segunda,Regular Season,11-1,11,1,0,1,1,0,9-3,9,3,0,5,2,3,Seattle Seahawks,1
2013-12-01,Indianapolis Colts,Tennessee Titans,22,14,2013,13,domingo,Regular Season,8-4,8,4,0,9,10,-1,5-7,5,7,0,21,20,1,Indianapolis Colts,10
2013-12-01,Kansas City Chiefs,Denver Broncos,28,35,2013,13,domingo,Regular Season,9-3,9,3,0,7,6,1,10-2,10,2,0,2,3,-1,Denver Broncos,3
2013-12-01,Cleveland Browns,Jacksonville Jaguars,28,32,2013,13,domingo,Regular Season,4-8,4,8,0,27,25,2,3-9,3,9,0,31,31,0,Jacksonville Jaguars,6
2013-12-01,Carolina Panthers,Tampa Bay Buccaneers,27,6,2013,13,domingo,Regular Season,9-3,9,3,0,3,5,-2,3-9,3,9,0,26,27,-1,Carolina Panthers,22
2013-12-01,Minnesota Vikings,Chicago Bears,23,20,2013,13,domingo,Regular Season,3-8,3,8,0,28,28,0,6-6,6,6,0,15,14,1,Minnesota Vikings,14
2013-12-01,Philadelphia Eagles,Arizona Cardinals,24,21,2013,13,domingo,Regular Season,7-5,7,5,0,10,11,-1,7-5,7,5,0,13,9,4,Philadelphia Eagles,2
2013-12-01,New York Jets,Miami Dolphins,3,23,2013,13,domingo,Regular Season,5-7,5,7,0,23,22,1,6-6,6,6,0,17,21,-4,Miami Dolphins,1
2013-12-01,Buffalo Bills,Atlanta Falcons,31,34,2013,13,domingo,Regular Season,4-8,4,8,0,24,24,0,3-9,3,9,0,29,30,-1,Atlanta Falcons,6
2013-12-01,San Francisco 49ers,Los Angeles Rams,23,13,2013,13,domingo,Regular Season,8-4,8,4,0,6,7,-1,5-7,5,7,0,20,19,1,San Francisco 49ers,12
2013-12-01,Houston Texans,New England Patriots,31,34,2013,13,domingo,Regular Season,2-10,2,10,0,32,32,0,9-3,9,3,0,4,4,0,New England Patriots,28
2013-12-01,Los Angeles Chargers,Cincinnati Bengals,10,17,2013,13,domingo,Regular Season,5-7,5,7,0,16,15,1,8-4,8,4,0,8,8,0,Cincinnati Bengals,7
2013-12-01,Washington Redskins,New York Giants,17,24,2013,13,domingo,Regular Season,3-9,3,9,0,30,29,1,5-7,5,7,0,22,23,-1,New York Giants,6
2013-11-28,Baltimore Ravens,Pittsburgh Steelers,22,20,2013,13,quinta,Regular Season,6-6,6,6,0,14,18,-4,5-7,5,7,0,18,16,2,Baltimore Ravens,2
2013-11-28,Dallas Cowboys,Oakland Raiders,31,24,2013,13,quinta,Regular Season,7-5,7,5,0,11,12,-1,4-8,4,8,0,25,26,-1,Dallas Cowboys,14
2013-11-28,Detroit Lions,Green Bay Packers,40,10,2013,13,quinta,Regular Season,7-5,7,5,0,12,13,-1,5-6,5,6,0,19,17,2,Detroit Lions,4
2013-11-25,Washington Redskins,San Francisco 49ers,6,27,2013,12,segunda,Regular Season,3-8,3,8,0,29,27,2,7-4,7,4,0,7,9,-2,San Francisco 49ers,18
2013-11-24,New England Patriots,Denver Broncos,34,31,2013,12,domingo,Regular Season,8-3,8,3,0,4,6,-2,9-2,9,2,0,3,1,2,New England Patriots,5
2013-11-24,New York Giants,Dallas Cowboys,21,24,2013,12,domingo,Regular Season,4-7,4,7,0,23,22,1,6-5,6,5,0,12,14,-2,Dallas Cowboys,8
2013-11-24,Arizona Cardinals,Indianapolis Colts,40,11,2013,12,domingo,Regular Season,7-4,7,4,0,9,13,-4,7-4,7,4,0,10,7,3,Arizona Cardinals,6
2013-11-24,Oakland Raiders,Tennessee Titans,19,23,2013,12,domingo,Regular Season,4-7,4,7,0,26,26,0,5-6,5,6,0,20,24,-4,Tennessee Titans,2
2013-11-24,Baltimore Ravens,New York Jets,19,3,2013,12,domingo,Regular Season,5-6,5,6,0,18,20,-2,5-6,5,6,0,22,16,6,Baltimore Ravens,4
2013-11-24,Cleveland Browns,Pittsburgh Steelers,11,27,2013,12,domingo,Regular Season,4-7,4,7,0,25,23,2,5-6,5,6,0,16,19,-3,Pittsburgh Steelers,4
2013-11-24,Detroit Lions,Tampa Bay Buccaneers,21,24,2013,12,domingo,Regular Season,6-5,6,5,0,13,11,2,3-8,3,8,0,27,28,-1,Tampa Bay Buccaneers,17
2013-11-24,Green Bay Packers,Minnesota Vikings,26,26,2013,12,domingo,Regular Season,5-5,5,5,0,17,15,2,2-8,2,8,0,28,31,-3,Draw,16
2013-11-24,Houston Texans,Jacksonville Jaguars,6,13,2013,12,domingo,Regular Season,2-9,2,9,0,32,29,3,2-9,2,9,0,31,32,-1,Jacksonville Jaguars,3
2013-11-24,Kansas City Chiefs,Los Angeles Chargers,38,41,2013,12,domingo,Regular Season,9-2,9,2,0,6,3,3,5-6,5,6,0,15,18,-3,Los Angeles Chargers,15
2013-11-24,Miami Dolphins,Carolina Panthers,16,20,2013,12,domingo,Regular Season,5-6,5,6,0,21,17,4,8-3,8,3,0,5,5,0,Carolina Panthers,12
2013-11-24,Los Angeles Rams,Chicago Bears,42,21,2013,12,domingo,Regular Season,5-6,5,6,0,19,21,-2,6-5,6,5,0,14,10,4,Los Angeles Rams,11
2013-11-21,Atlanta Falcons,New Orleans Saints,13,17,2013,12,quinta,Regular Season,2-9,2,9,0,30,30,0,9-2,9,2,0,2,4,-2,New Orleans Saints,26
2013-11-18,Carolina Panthers,New England Patriots,24,20,2013,11,segunda,Regular Season,7-3,7,3,0,5,6,-1,7-3,7,3,0,6,5,1,Carolina Panthers,1
2013-11-17,Tampa Bay Buccaneers,Atlanta Falcons,41,28,2013,11,domingo,Regular Season,2-8,2,8,0,28,31,-3,2-8,2,8,0,30,29,1,Tampa Bay Buccaneers,2
2013-11-17,Buffalo Bills,New York Jets,37,14,2013,11,domingo,Regular Season,4-7,4,7,0,25,26,-1,5-5,5,5,0,16,12,4,Buffalo Bills,14
2013-11-17,Pittsburgh Steelers,Detroit Lions,37,27,2013,11,domingo,Regular Season,4-6,4,6,0,19,24,-5,6-4,6,4,0,11,9,2,Pittsburgh Steelers,15
2013-11-17,Philadelphia Eagles,Washington Redskins,24,16,2013,11,domingo,Regular Season,6-5,6,5,0,12,14,-2,3-7,3,7,0,27,23,4,Philadelphia Eagles,9
2013-11-17,Miami Dolphins,Los Angeles Chargers,20,16,2013,11,domingo,Regular Season,5-5,5,5,0,17,22,-5,4-6,4,6,0,18,17,1,Miami Dolphins,5
2013-11-17,Chicago Bears,Baltimore Ravens,23,20,2013,11,domingo,Regular Season,6-4,6,4,0,10,11,-1,4-6,4,6,0,20,18,2,Chicago Bears,7
2013-11-17,Cincinnati Bengals,Cleveland Browns,41,20,2013,11,domingo,Regular Season,7-4,7,4,0,8,10,-2,4-6,4,6,0,23,19,4,Cincinnati Bengals,9
2013-11-17,Houston Texans,Oakland Raiders,23,28,2013,11,domingo,Regular Season,2-8,2,8,0,29,28,1,4-6,4,6,0,26,27,-1,Oakland Raiders,1
2013-11-17,Jacksonville Jaguars,Arizona Cardinals,14,27,2013,11,domingo,Regular Season,1-9,1,9,0,32,32,0,6-4,6,4,0,13,16,-3,Arizona Cardinals,16
2013-11-17,Denver Broncos,Kansas City Chiefs,27,17,2013,11,domingo,Regular Season,9-1,9,1,0,1,2,-1,9-1,9,1,0,3,1,2,Denver Broncos,1
2013-11-17,Seattle Seahawks,Minnesota Vikings,41,20,2013,11,domingo,Regular Season,10-1,10,1,0,2,3,-1,2-8,2,8,0,31,30,1,Seattle Seahawks,27
2013-11-17,New Orleans Saints,San Francisco 49ers,23,20,2013,11,domingo,Regular Season,8-2,8,2,0,4,4,0,6-4,6,4,0,9,8,1,New Orleans Saints,4
2013-11-17,New York Giants,Green Bay Packers,27,13,2013,11,domingo,Regular Season,4-6,4,6,0,22,25,-3,5-5,5,5,0,15,13,2,New York Giants,12
2013-11-14,Tennessee Titans,Indianapolis Colts,27,30,2013,11,quinta,Regular Season,4-6,4,6,0,24,21,3,7-3,7,3,0,7,7,0,Indianapolis Colts,14
2013-11-11,Tampa Bay Buccaneers,Miami Dolphins,22,19,2013,10,segunda,Regular Season,1-8,1,8,0,31,31,0,4-5,4,5,0,22,19,3,Tampa Bay Buccaneers,12
2013-11-10,Tennessee Titans,Jacksonville Jaguars,27,29,2013,10,domingo,Regular Season,4-5,4,5,0,21,16,5,1-8,1,8,0,32,32,0,Jacksonville Jaguars,16
2013-11-10,Green Bay Packers,Philadelphia Eagles,13,27,2013,10,domingo,Regular Season,5-4,5,4,0,13,11,2,5-5,5,5,0,14,20,-6,Philadelphia Eagles,9
2013-11-10,Pittsburgh Steelers,Buffalo Bills,23,10,2013,10,domingo,Regular Season,3-6,3,6,0,24,27,-3,3-7,3,7,0,26,23,3,Pittsburgh Steelers,4
2013-11-10,New York Giants,Oakland Raiders,24,20,2013,10,domingo,Regular Season,3-6,3,6,0,25,29,-4,3-6,3,6,0,27,24,3,New York Giants,5
2013-11-10,Indianapolis Colts,Los Angeles Rams,8,38,2013,10,domingo,Regular Season,6-3,6,3,0,7,2,5,4-6,4,6,0,20,25,-5,Los Angeles Rams,23
2013-11-10,Atlanta Falcons,Seattle Seahawks,10,33,2013,10,domingo,Regular Season,2-7,2,7,0,29,26,3,9-1,9,1,0,3,4,-1,Seattle Seahawks,22
2013-11-10,Baltimore Ravens,Cincinnati Bengals,20,17,2013,10,domingo,Regular Season,4-5,4,5,0,18,21,-3,6-4,6,4,0,10,8,2,Baltimore Ravens,13
2013-11-10,Chicago Bears,Detroit Lions,19,21,2013,10,domingo,Regular Season,5-4,5,4,0,11,9,2,6-3,6,3,0,9,10,-1,Detroit Lions,1
2013-11-10,San Francisco 49ers,Carolina Panthers,9,10,2013,10,domingo,Regular Season,6-3,6,3,0,8,5,3,6-3,6,3,0,6,12,-6,Carolina Panthers,7
2013-11-10,Arizona Cardinals,Houston Texans,27,24,2013,10,domingo,Regular Season,5-4,5,4,0,16,17,-1,2-7,2,7,0,28,28,0,Arizona Cardinals,11
2013-11-10,Los Angeles Chargers,Denver Broncos,20,28,2013,10,domingo,Regular Season,4-5,4,5,0,17,15,2,8-1,8,1,0,2,3,-1,Denver Broncos,12
2013-11-10,New Orleans Saints,Dallas Cowboys,49,17,2013,10,domingo,Regular Season,7-2,7,2,0,4,6,-2,5-5,5,5,0,15,13,2,New Orleans Saints,7
2013-11-07,Minnesota Vikings,Washington Redskins,34,27,2013,10,quinta,Regular Season,2-7,2,7,0,30,30,0,3-6,3,6,0,23,22,1,Minnesota Vikings,8
2013-11-04,Green Bay Packers,Chicago Bears,20,27,2013,9,segunda,Regular Season,5-3,5,3,0,11,8,3,5-3,5,3,0,9,14,-5,Chicago Bears,6
2013-11-03,Carolina Panthers,Atlanta Falcons,34,10,2013,9,domingo,Regular Season,5-3,5,3,0,12,12,0,2-6,2,6,0,26,23,3,Carolina Panthers,11
2013-11-03,Dallas Cowboys,Minnesota Vikings,27,23,2013,9,domingo,Regular Season,5-4,5,4,0,13,13,0,1-7,1,7,0,30,30,0,Dallas Cowboys,17
2013-11-03,New York Jets,New Orleans Saints,26,20,2013,9,domingo,Regular Season,5-4,5,4,0,14,16,-2,6-2,6,2,0,6,5,1,New York Jets,11
2013-11-03,Los Angeles Rams,Tennessee Titans,21,28,2013,9,domingo,Regular Season,3-6,3,6,0,25,25,0,4-4,4,4,0,16,18,-2,Tennessee Titans,7
2013-11-03,Buffalo Bills,Kansas City Chiefs,13,23,2013,9,domingo,Regular Season,3-6,3,6,0,23,20,3,9-0,9,0,0,1,1,0,Kansas City Chiefs,19
2013-11-03,Washington Redskins,Los Angeles Chargers,30,24,2013,9,domingo,Regular Season,3-5,3,5,0,22,24,-2,4-4,4,4,0,15,11,4,Washington Redskins,13
2013-11-03,Oakland Raiders,Philadelphia Eagles,20,49,2013,9,domingo,Regular Season,3-5,3,5,0,24,22,2,4-5,4,5,0,20,26,-6,Philadelphia Eagles,4
2013-11-03,Seattle Seahawks,Tampa Bay Buccaneers,27,24,2013,9,domingo,Regular Season,8-1,8,1,0,4,4,0,0-8,0,8,0,31,31,0,Seattle Seahawks,27
2013-11-03,Cleveland Browns,Baltimore Ravens,24,18,2013,9,domingo,Regular Season,4-5,4,5,0,18,21,-3,3-5,3,5,0,21,15,6,Cleveland Browns,6
2013-11-03,New England Patriots,Pittsburgh Steelers,55,31,2013,9,domingo,Regular Season,7-2,7,2,0,7,9,-2,2-6,2,6,0,27,27,0,New England Patriots,18
2013-11-03,Houston Texans,Indianapolis Colts,24,27,2013,9,domingo,Regular Season,2-6,2,6,0,28,28,0,6-2,6,2,0,2,3,-1,Indianapolis Colts,25
2013-10-31,Miami Dolphins,Cincinnati Bengals,22,20,2013,9,quinta,Regular Season,4-4,4,4,0,19,19,0,6-3,6,3,0,8,7,1,Miami Dolphins,12
2013-10-28,Los Angeles Rams,Seattle Seahawks,9,14,2013,8,segunda,Regular Season,3-5,3,5,0,25,27,-2,7-1,7,1,0,4,4,0,Seattle Seahawks,23
2013-10-27,Jacksonville Jaguars,San Francisco 49ers,10,42,2013,8,domingo,Regular Season,0-8,0,8,0,32,32,0,6-2,6,2,0,6,6,0,San Francisco 49ers,26
2013-10-27,Detroit Lions,Dallas Cowboys,31,30,2013,8,domingo,Regular Season,5-3,5,3,0,10,11,-1,4-4,4,4,0,13,10,3,Detroit Lions,1
2013-10-27,Philadelphia Eagles,New York Giants,7,15,2013,8,domingo,Regular Season,3-5,3,5,0,26,19,7,2-6,2,6,0,29,29,0,New York Giants,10
2013-10-27,Kansas City Chiefs,Cleveland Browns,23,17,2013,8,domingo,Regular Season,8-0,8,0,0,1,1,0,3-5,3,5,0,21,22,-1,Kansas City Chiefs,21
2013-10-27,New Orleans Saints,Buffalo Bills,35,17,2013,8,domingo,Regular Season,6-1,6,1,0,5,5,0,3-5,3,5,0,20,21,-1,New Orleans Saints,16
2013-10-27,New England Patriots,Miami Dolphins,27,17,2013,8,domingo,Regular Season,6-2,6,2,0,9,8,1,3-4,3,4,0,19,16,3,New England Patriots,8
2013-10-27,Cincinnati Bengals,New York Jets,49,9,2013,8,domingo,Regular Season,6-2,6,2,0,7,7,0,4-4,4,4,0,16,15,1,Cincinnati Bengals,8
2013-10-27,Oakland Raiders,Pittsburgh Steelers,21,18,2013,8,domingo,Regular Season,3-4,3,4,0,22,28,-6,2-5,2,5,0,27,25,2,Oakland Raiders,3
2013-10-27,Denver Broncos,Washington Redskins,45,21,2013,8,domingo,Regular Season,7-1,7,1,0,2,3,-1,2-5,2,5,0,24,23,1,Denver Broncos,20
2013-10-27,Arizona Cardinals,Atlanta Falcons,27,13,2013,8,domingo,Regular Season,4-4,4,4,0,17,24,-7,2-5,2,5,0,23,20,3,Arizona Cardinals,4
2013-10-27,Minnesota Vikings,Green Bay Packers,31,44,2013,8,domingo,Regular Season,1-6,1,6,0,30,30,0,5-2,5,2,0,8,9,-1,Green Bay Packers,21
2013-10-24,Tampa Bay Buccaneers,Carolina Panthers,13,31,2013,8,quinta,Regular Season,0-7,0,7,0,31,31,0,4-3,4,3,0,12,18,-6,Carolina Panthers,13
2013-10-21,New York Giants,Minnesota Vikings,23,7,2013,7,segunda,Regular Season,1-6,1,6,0,29,31,-2,1-5,1,5,0,30,29,1,New York Giants,2
2013-10-20,New York Jets,New England Patriots,30,27,2013,7,domingo,Regular Season,4-3,4,3,0,15,20,-5,5-2,5,2,0,8,5,3,New York Jets,15
2013-10-20,Jacksonville Jaguars,Los Angeles Chargers,6,24,2013,7,domingo,Regular Season,0-7,0,7,0,32,32,0,4-3,4,3,0,12,15,-3,Los Angeles Chargers,17
2013-10-20,Kansas City Chiefs,Houston Texans,17,16,2013,7,domingo,Regular Season,7-0,7,0,0,1,2,-1,2-5,2,5,0,26,22,4,Kansas City Chiefs,20
2013-10-20,Detroit Lions,Cincinnati Bengals,24,27,2013,7,domingo,Regular Season,4-3,4,3,0,11,11,0,5-2,5,2,0,7,8,-1,Cincinnati Bengals,3
2013-10-20,Miami Dolphins,Buffalo Bills,21,23,2013,7,domingo,Regular Season,3-3,3,3,0,16,14,2,3-4,3,4,0,21,25,-4,Buffalo Bills,11
2013-10-20,Washington Redskins,Chicago Bears,45,41,2013,7,domingo,Regular Season,2-4,2,4,0,23,28,-5,4-3,4,3,0,13,10,3,Washington Redskins,18
2013-10-20,Philadelphia Eagles,Dallas Cowboys,3,17,2013,7,domingo,Regular Season,3-4,3,4,0,19,17,2,4-3,4,3,0,10,13,-3,Dallas Cowboys,4
2013-10-20,Carolina Panthers,Los Angeles Rams,30,15,2013,7,domingo,Regular Season,3-3,3,3,0,18,24,-6,3-4,3,4,0,27,19,8,Carolina Panthers,5
2013-10-20,Atlanta Falcons,Tampa Bay Buccaneers,31,23,2013,7,domingo,Regular Season,2-4,2,4,0,20,23,-3,0-6,0,6,0,31,30,1,Atlanta Falcons,7
2013-10-20,Tennessee Titans,San Francisco 49ers,17,31,2013,7,domingo,Regular Season,3-4,3,4,0,17,16,1,5-2,5,2,0,6,7,-1,San Francisco 49ers,9
2013-10-20,Green Bay Packers,Cleveland Browns,31,13,2013,7,domingo,Regular Season,4-2,4,2,0,9,9,0,3-4,3,4,0,22,18,4,Green Bay Packers,9
2013-10-20,Pittsburgh Steelers,Baltimore Ravens,19,16,2013,7,domingo,Regular Season,2-4,2,4,0,25,27,-2,3-4,3,4,0,14,12,2,Pittsburgh Steelers,15
2013-10-20,Indianapolis Colts,Denver Broncos,39,33,2013,7,domingo,Regular Season,5-2,5,2,0,2,6,-4,6-1,6,1,0,3,1,2,Indianapolis Colts,5
2013-10-17,Arizona Cardinals,Seattle Seahawks,22,34,2013,7,quinta,Regular Season,3-4,3,4,0,24,21,3,6-1,6,1,0,4,4,0,Seattle Seahawks,17
2013-10-14,Los Angeles Chargers,Indianapolis Colts,19,9,2013,6,segunda,Regular Season,3-3,3,3,0,15,20,-5,4-2,4,2,0,6,4,2,Los Angeles Chargers,16
2013-10-13,Kansas City Chiefs,Oakland Raiders,24,7,2013,6,domingo,Regular Season,6-0,6,0,0,2,3,-1,2-4,2,4,0,26,24,2,Kansas City Chiefs,21
2013-10-13,Tampa Bay Buccaneers,Philadelphia Eagles,20,31,2013,6,domingo,Regular Season,0-5,0,5,0,30,30,0,3-3,3,3,0,17,21,-4,Philadelphia Eagles,9
2013-10-13,Baltimore Ravens,Green Bay Packers,17,19,2013,6,domingo,Regular Season,3-3,3,3,0,12,9,3,3-2,3,2,0,9,11,-2,Green Bay Packers,2
2013-10-13,Cleveland Browns,Detroit Lions,17,31,2013,6,domingo,Regular Season,3-3,3,3,0,18,16,2,4-2,4,2,0,11,12,-1,Detroit Lions,4
2013-10-13,Minnesota Vikings,Carolina Panthers,10,35,2013,6,domingo,Regular Season,1-4,1,4,0,29,28,1,2-3,2,3,0,24,26,-2,Carolina Panthers,2
2013-10-13,Houston Texans,Los Angeles Rams,13,38,2013,6,domingo,Regular Season,2-4,2,4,0,22,17,5,3-3,3,3,0,19,25,-6,Los Angeles Rams,8
2013-10-13,New York Jets,Pittsburgh Steelers,6,19,2013,6,domingo,Regular Season,3-3,3,3,0,20,18,2,1-4,1,4,0,27,29,-2,Pittsburgh Steelers,11
2013-10-13,Buffalo Bills,Cincinnati Bengals,24,27,2013,6,domingo,Regular Season,2-4,2,4,0,25,23,2,4-2,4,2,0,8,8,0,Cincinnati Bengals,15
2013-10-13,Seattle Seahawks,Tennessee Titans,20,13,2013,6,domingo,Regular Season,5-1,5,1,0,4,5,-1,3-3,3,3,0,16,14,2,Seattle Seahawks,9
2013-10-13,Denver Broncos,Jacksonville Jaguars,35,19,2013,6,domingo,Regular Season,6-0,6,0,0,1,1,0,0-6,0,6,0,32,32,0,Denver Broncos,31
2013-10-13,San Francisco 49ers,Arizona Cardinals,32,20,2013,6,domingo,Regular Season,4-2,4,2,0,7,7,0,3-3,3,3,0,21,19,2,San Francisco 49ers,12
2013-10-13,New England Patriots,New Orleans Saints,30,27,2013,6,domingo,Regular Season,5-1,5,1,0,5,6,-1,5-1,5,1,0,3,2,1,New England Patriots,4
2013-10-13,Dallas Cowboys,Washington Redskins,31,16,2013,6,domingo,Regular Season,3-3,3,3,0,13,15,-2,1-4,1,4,0,28,27,1,Dallas Cowboys,12
2013-10-10,Chicago Bears,New York Giants,27,21,2013,6,quinta,Regular Season,4-2,4,2,0,10,10,0,0-6,0,6,0,31,31,0,Chicago Bears,21
2013-10-07,Atlanta Falcons,New York Jets,28,30,2013,5,segunda,Regular Season,1-4,1,4,0,22,16,6,3-2,3,2,0,18,22,-4,New York Jets,6
2013-10-06,Tennessee Titans,Kansas City Chiefs,17,26,2013,5,domingo,Regular Season,3-2,3,2,0,14,13,1,5-0,5,0,0,3,5,-2,Kansas City Chiefs,8
2013-10-06,Miami Dolphins,Baltimore Ravens,23,26,2013,5,domingo,Regular Season,3-2,3,2,0,13,7,6,3-2,3,2,0,9,14,-5,Baltimore Ravens,7
2013-10-06,Los Angeles Rams,Jacksonville Jaguars,34,20,2013,5,domingo,Regular Season,2-3,2,3,0,25,26,-1,0-5,0,5,0,32,32,0,Los Angeles Rams,6
2013-10-06,Cincinnati Bengals,New England Patriots,13,6,2013,5,domingo,Regular Season,3-2,3,2,0,8,11,-3,4-1,4,1,0,6,4,2,Cincinnati Bengals,7
2013-10-06,Indianapolis Colts,Seattle Seahawks,34,28,2013,5,domingo,Regular Season,4-1,4,1,0,4,6,-2,4-1,4,1,0,5,2,3,Indianapolis Colts,4
2013-10-06,Green Bay Packers,Detroit Lions,22,9,2013,5,domingo,Regular Season,2-2,2,2,0,11,12,-1,3-2,3,2,0,12,10,2,Green Bay Packers,2
2013-10-06,Chicago Bears,New Orleans Saints,18,26,2013,5,domingo,Regular Season,3-2,3,2,0,10,9,1,5-0,5,0,0,2,3,-1,New Orleans Saints,6
2013-10-06,New York Giants,Philadelphia Eagles,21,36,2013,5,domingo,Regular Season,0-5,0,5,0,31,30,1,2-3,2,3,0,21,27,-6,Philadelphia Eagles,3
2013-10-06,Arizona Cardinals,Carolina Panthers,22,6,2013,5,domingo,Regular Season,3-2,3,2,0,19,19,0,1-3,1,3,0,26,21,5,Arizona Cardinals,2
2013-10-06,Oakland Raiders,Los Angeles Chargers,27,17,2013,5,domingo,Regular Season,2-3,2,3,0,24,28,-4,2-3,2,3,0,20,17,3,Oakland Raiders,11
2013-10-06,Dallas Cowboys,Denver Broncos,48,51,2013,5,domingo,Regular Season,2-3,2,3,0,15,18,-3,5-0,5,0,0,1,1,0,Denver Broncos,17
2013-10-06,San Francisco 49ers,Houston Texans,34,3,2013,5,domingo,Regular Season,3-2,3,2,0,7,8,-1,2-3,2,3,0,17,15,2,San Francisco 49ers,7
2013-10-03,Cleveland Browns,Buffalo Bills,37,24,2013,5,quinta,Regular Season,3-2,3,2,0,16,20,-4,2-3,2,3,0,23,23,0,Cleveland Browns,3
2013-09-30,New Orleans Saints,Miami Dolphins,38,17,2013,4,segunda,Regular Season,4-0,4,0,0,3,3,0,3-1,3,1,0,7,7,0,New Orleans Saints,4
2013-09-29,Minnesota Vikings,Pittsburgh Steelers,34,27,2013,4,domingo,Regular Season,1-3,1,3,0,24,26,-2,0-4,0,4,0,29,28,1,Minnesota Vikings,2
2013-09-29,Buffalo Bills,Baltimore Ravens,23,20,2013,4,domingo,Regular Season,2-2,2,2,0,23,24,-1,2-2,2,2,0,14,11,3,Buffalo Bills,13
2013-09-29,Cleveland Browns,Cincinnati Bengals,17,6,2013,4,domingo,Regular Season,2-2,2,2,0,20,25,-5,2-2,2,2,0,11,6,5,Cleveland Browns,19
2013-09-29,Jacksonville Jaguars,Indianapolis Colts,3,37,2013,4,domingo,Regular Season,0-4,0,4,0,32,32,0,3-1,3,1,0,6,9,-3,Indianapolis Colts,23
2013-09-29,Houston Texans,Seattle Seahawks,20,23,2013,4,domingo,Regular Season,2-2,2,2,0,15,13,2,4-0,4,0,0,2,1,1,Seattle Seahawks,12
2013-09-29,Tampa Bay Buccaneers,Arizona Cardinals,10,13,2013,4,domingo,Regular Season,0-4,0,4,0,31,31,0,2-2,2,2,0,19,22,-3,Arizona Cardinals,9
2013-09-29,Detroit Lions,Chicago Bears,40,32,2013,4,domingo,Regular Season,3-1,3,1,0,10,16,-6,3-1,3,1,0,9,4,5,Detroit Lions,12
2013-09-29,Kansas City Chiefs,New York Giants,31,7,2013,4,domingo,Regular Season,4-0,4,0,0,5,8,-3,0-4,0,4,0,30,29,1,Kansas City Chiefs,21
2013-09-29,Tennessee Titans,New York Jets,38,13,2013,4,domingo,Regular Season,3-1,3,1,0,13,17,-4,2-2,2,2,0,22,18,4,Tennessee Titans,1
2013-09-29,Los Angeles Chargers,Dallas Cowboys,30,21,2013,4,domingo,Regular Season,2-2,2,2,0,17,19,-2,2-2,2,2,0,18,15,3,Los Angeles Chargers,4
2013-09-29,Oakland Raiders,Washington Redskins,14,24,2013,4,domingo,Regular Season,1-3,1,3,0,28,30,-2,1-3,1,3,0,25,27,-2,Washington Redskins,3
2013-09-29,Denver Broncos,Philadelphia Eagles,52,20,2013,4,domingo,Regular Season,4-0,4,0,0,1,2,-1,1-3,1,3,0,27,23,4,Denver Broncos,21
2013-09-29,Atlanta Falcons,New England Patriots,23,30,2013,4,domingo,Regular Season,1-3,1,3,0,16,14,2,4-0,4,0,0,4,5,-1,New England Patriots,9
2013-09-26,Los Angeles Rams,San Francisco 49ers,11,35,2013,4,quinta,Regular Season,1-3,1,3,0,26,20,6,2-2,2,2,0,8,10,-2,San Francisco 49ers,10
2013-09-23,Denver Broncos,Oakland Raiders,37,21,2013,3,segunda,Regular Season,3-0,3,0,0,2,2,0,1-2,1,2,0,30,29,1,Denver Broncos,27
2013-09-22,Tennessee Titans,Los Angeles Chargers,20,17,2013,3,domingo,Regular Season,2-1,2,1,0,17,22,-5,1-2,1,2,0,19,16,3,Tennessee Titans,6
2013-09-22,Minnesota Vikings,Cleveland Browns,27,31,2013,3,domingo,Regular Season,0-3,0,3,0,26,23,3,1-2,1,2,0,25,31,-6,Cleveland Browns,8
2013-09-22,New England Patriots,Tampa Bay Buccaneers,23,3,2013,3,domingo,Regular Season,3-0,3,0,0,5,7,-2,0-3,0,3,0,31,30,1,New England Patriots,23
2013-09-22,Baltimore Ravens,Houston Texans,30,9,2013,3,domingo,Regular Season,2-1,2,1,0,11,11,0,2-1,2,1,0,13,4,9,Baltimore Ravens,7
2013-09-22,Dallas Cowboys,Los Angeles Rams,31,7,2013,3,domingo,Regular Season,2-1,2,1,0,15,15,0,1-2,1,2,0,20,17,3,Dallas Cowboys,2
2013-09-22,New Orleans Saints,Arizona Cardinals,31,7,2013,3,domingo,Regular Season,3-0,3,0,0,3,8,-5,1-2,1,2,0,22,21,1,New Orleans Saints,13
2013-09-22,Washington Redskins,Detroit Lions,20,27,2013,3,domingo,Regular Season,0-3,0,3,0,27,24,3,2-1,2,1,0,16,18,-2,Detroit Lions,6
2013-09-22,Cincinnati Bengals,Green Bay Packers,34,30,2013,3,domingo,Regular Season,2-1,2,1,0,6,10,-4,1-2,1,2,0,12,5,7,Cincinnati Bengals,5
2013-09-22,Carolina Panthers,New York Giants,38,0,2013,3,domingo,Regular Season,1-2,1,2,0,21,27,-6,0-3,0,3,0,29,20,9,Carolina Panthers,7
2013-09-22,Miami Dolphins,Atlanta Falcons,27,23,2013,3,domingo,Regular Season,3-0,3,0,0,7,12,-5,1-2,1,2,0,14,6,8,Miami Dolphins,6
2013-09-22,San Francisco 49ers,Indianapolis Colts,7,27,2013,3,domingo,Regular Season,1-2,1,2,0,10,3,7,2-1,2,1,0,9,14,-5,Indianapolis Colts,11
2013-09-22,Seattle Seahawks,Jacksonville Jaguars,45,17,2013,3,domingo,Regular Season,3-0,3,0,0,1,1,0,0-3,0,3,0,32,32,0,Seattle Seahawks,31
2013-09-22,New York Jets,Buffalo Bills,27,20,2013,3,domingo,Regular Season,2-1,2,1,0,18,28,-10,1-2,1,2,0,24,26,-2,New York Jets,2
2013-09-22,Pittsburgh Steelers,Chicago Bears,23,40,2013,3,domingo,Regular Season,0-3,0,3,0,28,25,3,3-0,3,0,0,4,9,-5,Chicago Bears,16
2013-09-19,Philadelphia Eagles,Kansas City Chiefs,16,26,2013,3,quinta,Regular Season,1-2,1,2,0,23,19,4,3-0,3,0,0,8,13,-5,Kansas City Chiefs,6
2013-09-16,Cincinnati Bengals,Pittsburgh Steelers,20,10,2013,2,segunda,Regular Season,1-1,1,1,0,10,10,0,0-2,0,2,0,25,23,2,Cincinnati Bengals,13
2013-09-15,Arizona Cardinals,Detroit Lions,25,21,2013,2,domingo,Regular Season,1-1,1,1,0,21,25,-4,1-1,1,1,0,18,18,0,Arizona Cardinals,7
2013-09-15,Atlanta Falcons,Los Angeles Rams,31,24,2013,2,domingo,Regular Season,1-1,1,1,0,6,4,2,1-1,1,1,0,17,15,2,Atlanta Falcons,11
2013-09-15,Baltimore Ravens,Cleveland Browns,14,6,2013,2,domingo,Regular Season,1-1,1,1,0,11,11,0,0-2,0,2,0,31,30,1,Baltimore Ravens,19
2013-09-15,Buffalo Bills,Carolina Panthers,24,23,2013,2,domingo,Regular Season,1-1,1,1,0,26,29,-3,0-2,0,2,0,27,24,3,Buffalo Bills,5
2013-09-15,Chicago Bears,Minnesota Vikings,31,30,2013,2,domingo,Regular Season,2-0,2,0,0,9,9,0,0-2,0,2,0,23,21,2,Chicago Bears,12
2013-09-15,Green Bay Packers,Washington Redskins,38,20,2013,2,domingo,Regular Season,1-1,1,1,0,5,7,-2,0-2,0,2,0,24,19,5,Green Bay Packers,12
2013-09-15,Houston Texans,Tennessee Titans,30,24,2013,2,domingo,Regular Season,2-0,2,0,0,4,6,-2,1-1,1,1,0,22,22,0,Houston Texans,16
2013-09-15,Indianapolis Colts,Miami Dolphins,20,24,2013,2,domingo,Regular Season,1-1,1,1,0,14,12,2,2-0,2,0,0,12,17,-5,Miami Dolphins,5
2013-09-15,Kansas City Chiefs,Dallas Cowboys,17,16,2013,2,domingo,Regular Season,2-0,2,0,0,13,20,-7,1-1,1,1,0,15,13,2,Kansas City Chiefs,7
2013-09-15,New York Giants,Denver Broncos,23,41,2013,2,domingo,Regular Season,0-2,0,2,0,20,16,4,2-0,2,0,0,2,3,-1,Denver Broncos,13
2013-09-15,Oakland Raiders,Jacksonville Jaguars,19,9,2013,2,domingo,Regular Season,1-1,1,1,0,29,31,-2,0-2,0,2,0,32,32,0,Oakland Raiders,1
2013-09-15,Philadelphia Eagles,Los Angeles Chargers,30,33,2013,2,domingo,Regular Season,1-1,1,1,0,19,14,5,1-1,1,1,0,16,26,-10,Los Angeles Chargers,12
2013-09-15,Seattle Seahawks,San Francisco 49ers,29,3,2013,2,domingo,Regular Season,2-0,2,0,0,1,2,-1,1-1,1,1,0,3,1,2,Seattle Seahawks,1
2013-09-15,Tampa Bay Buccaneers,New Orleans Saints,14,16,2013,2,domingo,Regular Season,0-2,0,2,0,30,28,2,2-0,2,0,0,8,8,0,New Orleans Saints,20
2013-09-12,New England Patriots,New York Jets,13,10,2013,2,quinta,Regular Season,2-0,2,0,0,7,5,2,1-1,1,1,0,28,27,1,New England Patriots,22
2013-09-09,Los Angeles Chargers,Houston Texans,28,31,2013,1,segunda,Regular Season,0-1,0,1,0,26,24,2,1-0,1,0,0,6,7,-1,Houston Texans,17
2013-09-09,Washington Redskins,Philadelphia Eagles,27,33,2013,1,segunda,Regular Season,0-1,0,1,0,19,10,9,1-0,1,0,0,14,25,-11,Philadelphia Eagles,15
2013-09-08,Buffalo Bills,New England Patriots,21,23,2013,1,domingo,Regular Season,0-1,0,1,0,29,30,-1,1-0,1,0,0,5,6,-1,New England Patriots,24
2013-09-08,Carolina Panthers,Seattle Seahawks,7,12,2013,1,domingo,Regular Season,0-1,0,1,0,24,23,1,1-0,1,0,0,2,1,1,Seattle Seahawks,22
2013-09-08,Chicago Bears,Cincinnati Bengals,24,21,2013,1,domingo,Regular Season,1-0,1,0,0,9,14,-5,0-1,0,1,0,10,9,1,Chicago Bears,5
2013-09-08,Cleveland Browns,Miami Dolphins,10,23,2013,1,domingo,Regular Season,0-1,0,1,0,30,28,2,1-0,1,0,0,17,20,-3,Miami Dolphins,8
2013-09-08,Dallas Cowboys,New York Giants,36,31,2013,1,domingo,Regular Season,1-0,1,0,0,13,18,-5,0-1,0,1,0,16,12,4,Dallas Cowboys,6
2013-09-08,Detroit Lions,Minnesota Vikings,34,24,2013,1,domingo,Regular Season,1-0,1,0,0,18,21,-3,0-1,0,1,0,21,17,4,Detroit Lions,4
2013-09-08,Indianapolis Colts,Oakland Raiders,21,17,2013,1,domingo,Regular Season,1-0,1,0,0,12,11,1,0-1,0,1,0,31,31,0,Indianapolis Colts,20
2013-09-08,Jacksonville Jaguars,Kansas City Chiefs,2,28,2013,1,domingo,Regular Season,0-1,0,1,0,32,29,3,1-0,1,0,0,20,19,1,Kansas City Chiefs,10
2013-09-08,New Orleans Saints,Atlanta Falcons,23,17,2013,1,domingo,Regular Season,1-0,1,0,0,8,13,-5,0-1,0,1,0,4,2,2,New Orleans Saints,11
2013-09-08,New York Jets,Tampa Bay Buccaneers,18,17,2013,1,domingo,Regular Season,1-0,1,0,0,27,32,-5,0-1,0,1,0,28,22,6,New York Jets,10
2013-09-08,Pittsburgh Steelers,Tennessee Titans,9,16,2013,1,domingo,Regular Season,0-1,0,1,0,23,16,7,1-0,1,0,0,22,27,-5,Tennessee Titans,11
2013-09-08,San Francisco 49ers,Green Bay Packers,34,28,2013,1,domingo,Regular Season,1-0,1,0,0,1,3,-2,0-1,0,1,0,7,5,2,San Francisco 49ers,2
2013-09-08,Los Angeles Rams,Arizona Cardinals,27,24,2013,1,domingo,Regular Season,1-0,1,0,0,15,15,0,0-1,0,1,0,25,26,-1,Los Angeles Rams,11
2013-09-05,Denver Broncos,Baltimore Ravens,49,27,2013,1,quinta,Regular Season,1-0,1,0,0,3,4,-1,0-1,0,1,0,11,8,3,Denver Broncos,4
2012-12-30,Washington Redskins,Dallas Cowboys,28,18,2012,17,domingo,Regular Season,10-6,10,6,0,8,9,-1,8-8,8,8,0,15,14,1,Washington Redskins,5
2012-12-30,Tennessee Titans,Jacksonville Jaguars,38,20,2012,17,domingo,Regular Season,6-10,6,10,0,26,27,-1,2-14,2,14,0,31,31,0,Tennessee Titans,4
2012-12-30,Seattle Seahawks,Los Angeles Rams,20,13,2012,17,domingo,Regular Season,11-5,11,5,0,5,6,-1,7-8,7,8,0,16,16,0,Seattle Seahawks,10
2012-12-30,San Francisco 49ers,Arizona Cardinals,27,13,2012,17,domingo,Regular Season,11-4,11,4,0,3,3,0,5-11,5,11,0,27,26,1,San Francisco 49ers,23
2012-12-30,Los Angeles Chargers,Oakland Raiders,24,21,2012,17,domingo,Regular Season,7-9,7,9,0,22,21,1,4-12,4,12,0,30,30,0,Los Angeles Chargers,9
2012-12-30,Pittsburgh Steelers,Cleveland Browns,24,10,2012,17,domingo,Regular Season,8-8,8,8,0,17,18,-1,5-11,5,11,0,24,24,0,Pittsburgh Steelers,6
2012-12-30,New York Giants,Philadelphia Eagles,42,7,2012,17,domingo,Regular Season,9-7,9,7,0,14,15,-1,4-12,4,12,0,29,29,0,New York Giants,14
2012-12-30,New Orleans Saints,Carolina Panthers,38,44,2012,17,domingo,Regular Season,7-9,7,9,0,19,17,2,7-9,7,9,0,18,20,-2,Carolina Panthers,3
2012-12-30,New England Patriots,Miami Dolphins,28,0,2012,17,domingo,Regular Season,12-4,12,4,0,4,5,-1,7-9,7,9,0,20,19,1,New England Patriots,14
2012-12-30,Minnesota Vikings,Green Bay Packers,37,34,2012,17,domingo,Regular Season,10-6,10,6,0,12,12,0,11-5,11,5,0,6,4,2,Minnesota Vikings,8
2012-12-30,Indianapolis Colts,Houston Texans,28,16,2012,17,domingo,Regular Season,11-5,11,5,0,7,8,-1,12-4,12,4,0,9,7,2,Indianapolis Colts,1
2012-12-30,Detroit Lions,Chicago Bears,24,26,2012,17,domingo,Regular Season,4-12,4,12,0,28,28,0,10-6,10,6,0,13,13,0,Chicago Bears,15
2012-12-30,Denver Broncos,Kansas City Chiefs,38,3,2012,17,domingo,Regular Season,13-3,13,3,0,1,1,0,2-14,2,14,0,32,32,0,Denver Broncos,31
2012-12-30,Cincinnati Bengals,Baltimore Ravens,23,17,2012,17,domingo,Regular Season,10-6,10,6,0,11,11,0,10-6,10,6,0,10,10,0,Cincinnati Bengals,1
2012-12-30,Buffalo Bills,New York Jets,28,9,2012,17,domingo,Regular Season,6-10,6,10,0,23,25,-2,6-10,6,10,0,25,23,2,Buffalo Bills,2
2012-12-30,Atlanta Falcons,Tampa Bay Buccaneers,17,22,2012,17,domingo,Regular Season,13-3,13,3,0,2,2,0,7-9,7,9,0,21,22,-1,Tampa Bay Buccaneers,20
2012-12-23,Tampa Bay Buccaneers,Los Angeles Rams,13,28,2012,16,domingo,Regular Season,6-9,6,9,0,22,20,2,7-7,7,7,0,16,17,-1,Los Angeles Rams,3
2012-12-23,Seattle Seahawks,San Francisco 49ers,42,13,2012,16,domingo,Regular Season,10-5,10,5,0,6,7,-1,10-4,10,4,0,3,1,2,Seattle Seahawks,6
2012-12-23,Pittsburgh Steelers,Cincinnati Bengals,10,13,2012,16,domingo,Regular Season,7-8,7,8,0,18,16,2,9-6,9,6,0,11,13,-2,Cincinnati Bengals,3
2012-12-23,Philadelphia Eagles,Washington Redskins,20,27,2012,16,domingo,Regular Season,4-11,4,11,0,29,29,0,9-6,9,6,0,9,8,1,Washington Redskins,21
2012-12-23,New York Jets,Los Angeles Chargers,17,27,2012,16,domingo,Regular Season,6-9,6,9,0,23,21,2,6-9,6,9,0,21,24,-3,Los Angeles Chargers,3
2012-12-23,Miami Dolphins,Buffalo Bills,24,10,2012,16,domingo,Regular Season,7-8,7,8,0,19,19,0,5-10,5,10,0,25,25,0,Miami Dolphins,6
2012-12-23,Kansas City Chiefs,Indianapolis Colts,13,20,2012,16,domingo,Regular Season,2-13,2,13,0,32,32,0,10-5,10,5,0,8,9,-1,Indianapolis Colts,23
2012-12-23,Jacksonville Jaguars,New England Patriots,16,23,2012,16,domingo,Regular Season,2-13,2,13,0,31,31,0,11-4,11,4,0,5,4,1,New England Patriots,27
2012-12-23,Houston Texans,Minnesota Vikings,6,23,2012,16,domingo,Regular Season,12-3,12,3,0,7,3,4,9-6,9,6,0,12,15,-3,Minnesota Vikings,12
2012-12-23,Green Bay Packers,Tennessee Titans,55,7,2012,16,domingo,Regular Season,11-4,11,4,0,4,6,-2,5-10,5,10,0,27,26,1,Green Bay Packers,20
2012-12-23,Denver Broncos,Cleveland Browns,34,12,2012,16,domingo,Regular Season,12-3,12,3,0,1,2,-1,5-10,5,10,0,24,22,2,Denver Broncos,20
2012-12-23,Dallas Cowboys,New Orleans Saints,31,34,2012,16,domingo,Regular Season,8-7,8,7,0,14,10,4,7-8,7,8,0,17,18,-1,New Orleans Saints,8
2012-12-23,Carolina Panthers,Oakland Raiders,17,6,2012,16,domingo,Regular Season,6-9,6,9,0,20,23,-3,4-11,4,11,0,30,30,0,Carolina Panthers,7
2012-12-23,Baltimore Ravens,New York Giants,33,14,2012,16,domingo,Regular Season,10-5,10,5,0,10,11,-1,8-7,8,7,0,15,12,3,Baltimore Ravens,1
2012-12-23,Arizona Cardinals,Chicago Bears,13,28,2012,16,domingo,Regular Season,5-10,5,10,0,26,27,-1,9-6,9,6,0,13,14,-1,Chicago Bears,13
2012-12-22,Detroit Lions,Atlanta Falcons,18,31,2012,16,sábado,Regular Season,4-11,4,11,0,28,28,0,13-2,13,2,0,2,5,-3,Atlanta Falcons,23
2012-12-17,Tennessee Titans,New York Jets,14,10,2012,15,segunda,Regular Season,5-9,5,9,0,26,28,-2,6-8,6,8,0,21,19,2,Tennessee Titans,9
2012-12-16,Los Angeles Rams,Minnesota Vikings,22,36,2012,15,domingo,Regular Season,6-7,6,7,0,17,17,0,8-6,8,6,0,15,16,-1,Minnesota Vikings,1
2012-12-16,Los Angeles Chargers,Carolina Panthers,7,31,2012,15,domingo,Regular Season,5-9,5,9,0,24,23,1,5-9,5,9,0,23,26,-3,Carolina Panthers,3
2012-12-16,Oakland Raiders,Kansas City Chiefs,15,0,2012,15,domingo,Regular Season,4-10,4,10,0,30,30,0,2-12,2,12,0,32,32,0,Oakland Raiders,2
2012-12-16,New Orleans Saints,Tampa Bay Buccaneers,41,0,2012,15,domingo,Regular Season,6-8,6,8,0,18,22,-4,6-8,6,8,0,20,18,2,New Orleans Saints,4
2012-12-16,New England Patriots,San Francisco 49ers,34,41,2012,15,domingo,Regular Season,10-4,10,4,0,4,1,3,10-3,10,3,0,1,4,-3,San Francisco 49ers,3
2012-12-16,Miami Dolphins,Jacksonville Jaguars,24,3,2012,15,domingo,Regular Season,6-8,6,8,0,19,21,-2,2-12,2,12,0,31,31,0,Miami Dolphins,10
2012-12-16,Houston Texans,Indianapolis Colts,29,17,2012,15,domingo,Regular Season,12-2,12,2,0,3,3,0,9-5,9,5,0,9,9,0,Houston Texans,6
2012-12-16,Dallas Cowboys,Pittsburgh Steelers,27,24,2012,15,domingo,Regular Season,8-6,8,6,0,10,13,-3,7-7,7,7,0,16,15,1,Dallas Cowboys,2
2012-12-16,Cleveland Browns,Washington Redskins,21,38,2012,15,domingo,Regular Season,5-9,5,9,0,22,20,2,8-6,8,6,0,8,12,-4,Washington Redskins,8
2012-12-16,Chicago Bears,Green Bay Packers,13,21,2012,15,domingo,Regular Season,8-6,8,6,0,14,11,3,10-4,10,4,0,6,6,0,Green Bay Packers,5
2012-12-16,Buffalo Bills,Seattle Seahawks,17,50,2012,15,domingo,Regular Season,5-9,5,9,0,25,24,1,9-5,9,5,0,7,10,-3,Seattle Seahawks,14
2012-12-16,Baltimore Ravens,Denver Broncos,17,34,2012,15,domingo,Regular Season,9-5,9,5,0,11,8,3,11-3,11,3,0,2,2,0,Denver Broncos,6
2012-12-16,Atlanta Falcons,New York Giants,34,0,2012,15,domingo,Regular Season,12-2,12,2,0,5,5,0,8-6,8,6,0,12,7,5,Atlanta Falcons,2
2012-12-16,Arizona Cardinals,Detroit Lions,38,10,2012,15,domingo,Regular Season,5-9,5,9,0,27,29,-2,4-10,4,10,0,28,25,3,Arizona Cardinals,4
2012-12-13,Philadelphia Eagles,Cincinnati Bengals,13,34,2012,15,quinta,Regular Season,4-10,4,10,0,29,27,2,8-6,8,6,0,13,14,-1,Cincinnati Bengals,13
2012-12-10,New England Patriots,Houston Texans,42,14,2012,14,segunda,Regular Season,10-3,10,3,0,1,3,-2,11-2,11,2,0,3,1,2,New England Patriots,2
2012-12-09,Washington Redskins,Baltimore Ravens,31,28,2012,14,domingo,Regular Season,7-6,7,6,0,12,14,-2,9-4,9,4,0,8,6,2,Washington Redskins,8
2012-12-09,Tampa Bay Buccaneers,Philadelphia Eagles,21,23,2012,14,domingo,Regular Season,6-7,6,7,0,18,15,3,4-9,4,9,0,27,30,-3,Philadelphia Eagles,15
2012-12-09,Seattle Seahawks,Arizona Cardinals,58,0,2012,14,domingo,Regular Season,8-5,8,5,0,10,12,-2,4-9,4,9,0,29,27,2,Seattle Seahawks,15
2012-12-09,San Francisco 49ers,Miami Dolphins,27,13,2012,14,domingo,Regular Season,9-3,9,3,0,4,4,0,5-8,5,8,0,21,20,1,San Francisco 49ers,16
2012-12-09,Pittsburgh Steelers,Los Angeles Chargers,24,34,2012,14,domingo,Regular Season,7-6,7,6,0,15,13,2,5-8,5,8,0,23,25,-2,Los Angeles Chargers,12
2012-12-09,New York Giants,New Orleans Saints,52,27,2012,14,domingo,Regular Season,8-5,8,5,0,7,10,-3,5-8,5,8,0,22,18,4,New York Giants,8
2012-12-09,Minnesota Vikings,Chicago Bears,21,14,2012,14,domingo,Regular Season,7-6,7,6,0,16,17,-1,8-5,8,5,0,11,8,3,Minnesota Vikings,9
2012-12-09,Jacksonville Jaguars,New York Jets,10,17,2012,14,domingo,Regular Season,2-11,2,11,0,31,32,-1,6-7,6,7,0,19,22,-3,New York Jets,10
2012-12-09,Indianapolis Colts,Tennessee Titans,27,23,2012,14,domingo,Regular Season,9-4,9,4,0,9,9,0,4-9,4,9,0,28,26,2,Indianapolis Colts,17
2012-12-09,Green Bay Packers,Detroit Lions,27,20,2012,14,domingo,Regular Season,9-4,9,4,0,6,7,-1,4-9,4,9,0,25,21,4,Green Bay Packers,14
2012-12-09,Cleveland Browns,Kansas City Chiefs,30,7,2012,14,domingo,Regular Season,5-8,5,8,0,20,24,-4,2-11,2,11,0,32,31,1,Cleveland Browns,7
2012-12-09,Cincinnati Bengals,Dallas Cowboys,19,20,2012,14,domingo,Regular Season,7-6,7,6,0,14,11,3,7-6,7,6,0,13,16,-3,Dallas Cowboys,5
2012-12-09,Carolina Panthers,Atlanta Falcons,30,20,2012,14,domingo,Regular Season,4-9,4,9,0,26,28,-2,11-2,11,2,0,5,2,3,Carolina Panthers,26
2012-12-09,Buffalo Bills,Los Angeles Rams,12,15,2012,14,domingo,Regular Season,5-8,5,8,0,24,23,1,6-6,6,6,0,17,19,-2,Los Angeles Rams,4
2012-12-06,Oakland Raiders,Denver Broncos,13,26,2012,14,quinta,Regular Season,3-10,3,10,0,30,29,1,10-3,10,3,0,2,5,-3,Denver Broncos,24
2012-12-03,Washington Redskins,New York Giants,17,16,2012,13,segunda,Regular Season,6-6,6,6,0,14,17,-3,7-5,7,5,0,10,8,2,Washington Redskins,9
2012-12-02,Tennessee Titans,Houston Texans,10,24,2012,13,domingo,Regular Season,4-8,4,8,0,26,26,0,11-1,11,1,0,1,1,0,Houston Texans,25
2012-12-02,Los Angeles Rams,San Francisco 49ers,16,13,2012,13,domingo,Regular Season,5-6,5,6,0,19,21,-2,8-3,8,3,0,4,3,1,Los Angeles Rams,18
2012-12-02,Los Angeles Chargers,Cincinnati Bengals,13,20,2012,13,domingo,Regular Season,4-8,4,8,0,25,22,3,7-5,7,5,0,11,11,0,Cincinnati Bengals,11
2012-12-02,Oakland Raiders,Cleveland Browns,17,20,2012,13,domingo,Regular Season,3-9,3,9,0,29,29,0,4-8,4,8,0,24,27,-3,Cleveland Browns,2
2012-12-02,New York Jets,Arizona Cardinals,7,6,2012,13,domingo,Regular Season,5-7,5,7,0,22,23,-1,4-8,4,8,0,27,25,2,New York Jets,2
2012-12-02,Miami Dolphins,New England Patriots,16,23,2012,13,domingo,Regular Season,5-7,5,7,0,20,18,2,9-3,9,3,0,3,5,-2,New England Patriots,13
2012-12-02,Kansas City Chiefs,Carolina Panthers,27,21,2012,13,domingo,Regular Season,2-10,2,10,0,31,32,-1,3-9,3,9,0,28,28,0,Kansas City Chiefs,4
2012-12-02,Green Bay Packers,Minnesota Vikings,23,14,2012,13,domingo,Regular Season,8-4,8,4,0,7,9,-2,6-6,6,6,0,17,16,1,Green Bay Packers,7
2012-12-02,Detroit Lions,Indianapolis Colts,33,35,2012,13,domingo,Regular Season,4-8,4,8,0,21,20,1,8-4,8,4,0,9,10,-1,Indianapolis Colts,10
2012-12-02,Denver Broncos,Tampa Bay Buccaneers,31,23,2012,13,domingo,Regular Season,9-3,9,3,0,5,7,-2,6-6,6,6,0,15,12,3,Denver Broncos,5
2012-12-02,Dallas Cowboys,Philadelphia Eagles,38,33,2012,13,domingo,Regular Season,6-6,6,6,0,16,19,-3,3-9,3,9,0,30,30,0,Dallas Cowboys,11
2012-12-02,Chicago Bears,Seattle Seahawks,17,23,2012,13,domingo,Regular Season,8-4,8,4,0,8,6,2,7-5,7,5,0,12,13,-1,Seattle Seahawks,7
2012-12-02,Buffalo Bills,Jacksonville Jaguars,34,18,2012,13,domingo,Regular Season,5-7,5,7,0,23,24,-1,2-10,2,10,0,32,31,1,Buffalo Bills,7
2012-12-02,Baltimore Ravens,Pittsburgh Steelers,20,23,2012,13,domingo,Regular Season,9-3,9,3,0,6,4,2,7-5,7,5,0,13,14,-1,Pittsburgh Steelers,10
2012-11-29,Atlanta Falcons,New Orleans Saints,23,13,2012,13,quinta,Regular Season,11-1,11,1,0,2,2,0,5-7,5,7,0,18,15,3,Atlanta Falcons,13
2012-11-26,Philadelphia Eagles,Carolina Panthers,22,30,2012,12,segunda,Regular Season,3-8,3,8,0,30,27,3,3-8,3,8,0,28,29,-1,Carolina Panthers,2
2012-11-25,Tampa Bay Buccaneers,Atlanta Falcons,23,24,2012,12,domingo,Regular Season,6-5,6,5,0,12,10,2,10-1,10,1,0,2,2,0,Atlanta Falcons,8
2012-11-25,Los Angeles Chargers,Baltimore Ravens,13,16,2012,12,domingo,Regular Season,4-7,4,7,0,22,21,1,9-2,9,2,0,4,5,-1,Baltimore Ravens,16
2012-11-25,New York Giants,Green Bay Packers,38,10,2012,12,domingo,Regular Season,7-4,7,4,0,8,9,-1,7-4,7,4,0,9,4,5,New York Giants,5
2012-11-25,New Orleans Saints,San Francisco 49ers,21,31,2012,12,domingo,Regular Season,5-6,5,6,0,15,13,2,8-2,8,2,0,3,3,0,San Francisco 49ers,10
2012-11-25,Miami Dolphins,Seattle Seahawks,24,21,2012,12,domingo,Regular Season,5-6,5,6,0,18,20,-2,6-5,6,5,0,13,12,1,Miami Dolphins,8
2012-11-25,Kansas City Chiefs,Denver Broncos,9,17,2012,12,domingo,Regular Season,1-10,1,10,0,32,32,0,8-3,8,3,0,7,7,0,Denver Broncos,25
2012-11-25,Jacksonville Jaguars,Tennessee Titans,24,19,2012,12,domingo,Regular Season,2-9,2,9,0,31,31,0,4-7,4,7,0,26,23,3,Jacksonville Jaguars,8
2012-11-25,Indianapolis Colts,Buffalo Bills,20,13,2012,12,domingo,Regular Season,7-4,7,4,0,10,15,-5,4-7,4,7,0,24,24,0,Indianapolis Colts,9
2012-11-25,Cleveland Browns,Pittsburgh Steelers,20,14,2012,12,domingo,Regular Season,3-8,3,8,0,27,30,-3,6-5,6,5,0,14,11,3,Cleveland Browns,19
2012-11-25,Cincinnati Bengals,Oakland Raiders,34,10,2012,12,domingo,Regular Season,6-5,6,5,0,11,17,-6,3-8,3,8,0,29,28,1,Cincinnati Bengals,11
2012-11-25,Chicago Bears,Minnesota Vikings,28,10,2012,12,domingo,Regular Season,8-3,8,3,0,6,6,0,6-5,6,5,0,16,14,2,Chicago Bears,8
2012-11-25,Arizona Cardinals,Los Angeles Rams,17,31,2012,12,domingo,Regular Season,4-7,4,7,0,25,25,0,4-6,4,6,0,21,26,-5,Los Angeles Rams,1
2012-11-22,New York Jets,New England Patriots,19,49,2012,12,quinta,Regular Season,4-7,4,7,0,23,22,1,8-3,8,3,0,5,8,-3,New England Patriots,14
2012-11-22,Detroit Lions,Houston Texans,31,34,2012,12,quinta,Regular Season,4-7,4,7,0,20,19,1,10-1,10,1,0,1,1,0,Houston Texans,18
2012-11-22,Dallas Cowboys,Washington Redskins,31,38,2012,12,quinta,Regular Season,5-6,5,6,0,19,16,3,5-6,5,6,0,17,18,-1,Washington Redskins,2
2012-11-19,San Francisco 49ers,Chicago Bears,32,7,2012,11,segunda,Regular Season,7-2,7,2,0,3,4,-1,7-3,7,3,0,6,3,3,San Francisco 49ers,1
2012-11-18,Washington Redskins,Philadelphia Eagles,31,6,2012,11,domingo,Regular Season,4-6,4,6,0,18,21,-3,3-7,3,7,0,27,24,3,Washington Redskins,3
2012-11-18,Los Angeles Rams,New York Jets,13,27,2012,11,domingo,Regular Season,3-6,3,6,0,26,23,3,4-6,4,6,0,22,26,-4,New York Jets,3
2012-11-18,Pittsburgh Steelers,Baltimore Ravens,10,13,2012,11,domingo,Regular Season,6-4,6,4,0,11,9,2,8-2,8,2,0,5,5,0,Baltimore Ravens,4
2012-11-18,Oakland Raiders,New Orleans Saints,17,38,2012,11,domingo,Regular Season,3-7,3,7,0,28,28,0,5-5,5,5,0,13,16,-3,New Orleans Saints,12
2012-11-18,New England Patriots,Indianapolis Colts,59,24,2012,11,domingo,Regular Season,7-3,7,3,0,8,8,0,6-4,6,4,0,15,11,4,New England Patriots,3
2012-11-18,Kansas City Chiefs,Cincinnati Bengals,6,28,2012,11,domingo,Regular Season,1-9,1,9,0,32,32,0,5-5,5,5,0,17,19,-2,Cincinnati Bengals,13
2012-11-18,Houston Texans,Jacksonville Jaguars,43,37,2012,11,domingo,Regular Season,9-1,9,1,0,1,1,0,1-9,1,9,0,31,31,0,Houston Texans,30
2012-11-18,Detroit Lions,Green Bay Packers,20,24,2012,11,domingo,Regular Season,4-6,4,6,0,19,17,2,7-3,7,3,0,4,6,-2,Green Bay Packers,11
2012-11-18,Denver Broncos,Los Angeles Chargers,30,23,2012,11,domingo,Regular Season,7-3,7,3,0,7,7,0,4-6,4,6,0,21,20,1,Denver Broncos,13
2012-11-18,Dallas Cowboys,Cleveland Browns,23,20,2012,11,domingo,Regular Season,5-5,5,5,0,16,15,1,2-8,2,8,0,30,30,0,Dallas Cowboys,15
2012-11-18,Carolina Panthers,Tampa Bay Buccaneers,21,27,2012,11,domingo,Regular Season,2-8,2,8,0,29,29,0,6-4,6,4,0,10,13,-3,Tampa Bay Buccaneers,16
2012-11-18,Atlanta Falcons,Arizona Cardinals,23,19,2012,11,domingo,Regular Season,9-1,9,1,0,2,2,0,4-6,4,6,0,25,22,3,Atlanta Falcons,20
2012-11-15,Buffalo Bills,Miami Dolphins,19,14,2012,11,quinta,Regular Season,4-6,4,6,0,24,27,-3,4-6,4,6,0,20,18,2,Buffalo Bills,9
2012-11-12,Pittsburgh Steelers,Kansas City Chiefs,16,13,2012,10,segunda,Regular Season,6-3,6,3,0,9,10,-1,1-8,1,8,0,32,32,0,Pittsburgh Steelers,22
2012-11-11,Tampa Bay Buccaneers,Los Angeles Chargers,34,24,2012,10,domingo,Regular Season,5-4,5,4,0,13,13,0,4-5,4,5,0,20,17,3,Tampa Bay Buccaneers,4
2012-11-11,Seattle Seahawks,New York Jets,28,7,2012,10,domingo,Regular Season,6-4,6,4,0,12,12,0,3-6,3,6,0,26,25,1,Seattle Seahawks,13
2012-11-11,San Francisco 49ers,Los Angeles Rams,24,24,2012,10,domingo,Regular Season,6-2,6,2,0,4,4,0,3-5,3,5,0,23,24,-1,Draw,20
2012-11-11,Philadelphia Eagles,Dallas Cowboys,23,38,2012,10,domingo,Regular Season,3-6,3,6,0,24,21,3,4-5,4,5,0,15,18,-3,Dallas Cowboys,3
2012-11-11,New Orleans Saints,Atlanta Falcons,31,27,2012,10,domingo,Regular Season,4-5,4,5,0,16,22,-6,8-1,8,1,0,2,1,1,New Orleans Saints,21
2012-11-11,New England Patriots,Buffalo Bills,37,31,2012,10,domingo,Regular Season,6-3,6,3,0,8,9,-1,3-6,3,6,0,27,28,-1,New England Patriots,19
2012-11-11,Minnesota Vikings,Detroit Lions,34,24,2012,10,domingo,Regular Season,6-4,6,4,0,14,16,-2,4-5,4,5,0,17,14,3,Minnesota Vikings,2
2012-11-11,Miami Dolphins,Tennessee Titans,3,37,2012,10,domingo,Regular Season,4-5,4,5,0,18,15,3,4-6,4,6,0,25,27,-2,Tennessee Titans,12
2012-11-11,Cincinnati Bengals,New York Giants,31,13,2012,10,domingo,Regular Season,4-5,4,5,0,19,23,-4,6-4,6,4,0,10,5,5,Cincinnati Bengals,18
2012-11-11,Chicago Bears,Houston Texans,6,13,2012,10,domingo,Regular Season,7-2,7,2,0,3,3,0,8-1,8,1,0,1,2,-1,Houston Texans,1
2012-11-11,Carolina Panthers,Denver Broncos,14,36,2012,10,domingo,Regular Season,2-7,2,7,0,29,29,0,6-3,6,3,0,7,8,-1,Denver Broncos,21
2012-11-11,Baltimore Ravens,Oakland Raiders,55,20,2012,10,domingo,Regular Season,7-2,7,2,0,5,7,-2,3-6,3,6,0,28,26,2,Baltimore Ravens,19
2012-11-08,Jacksonville Jaguars,Indianapolis Colts,10,27,2012,10,quinta,Regular Season,1-8,1,8,0,31,31,0,6-3,6,3,0,11,11,0,Indianapolis Colts,20
2012-11-05,New Orleans Saints,Philadelphia Eagles,28,13,2012,9,segunda,Regular Season,3-5,3,5,0,22,26,-4,3-5,3,5,0,21,18,3,New Orleans Saints,8
2012-11-04,Washington Redskins,Carolina Panthers,13,21,2012,9,domingo,Regular Season,3-6,3,6,0,19,19,0,2-6,2,6,0,29,30,-1,Carolina Panthers,11
2012-11-04,Tennessee Titans,Chicago Bears,20,51,2012,9,domingo,Regular Season,3-6,3,6,0,27,27,0,7-1,7,1,0,3,5,-2,Chicago Bears,22
2012-11-04,Seattle Seahawks,Minnesota Vikings,30,20,2012,9,domingo,Regular Season,5-4,5,4,0,12,13,-1,5-4,5,4,0,16,11,5,Seattle Seahawks,2
2012-11-04,Oakland Raiders,Tampa Bay Buccaneers,32,42,2012,9,domingo,Regular Season,3-5,3,5,0,26,24,2,4-4,4,4,0,13,21,-8,Tampa Bay Buccaneers,3
2012-11-04,New York Giants,Pittsburgh Steelers,20,24,2012,9,domingo,Regular Season,6-3,6,3,0,5,2,3,5-3,5,3,0,10,10,0,Pittsburgh Steelers,8
2012-11-04,Jacksonville Jaguars,Detroit Lions,14,31,2012,9,domingo,Regular Season,1-7,1,7,0,31,31,0,4-4,4,4,0,14,17,-3,Detroit Lions,14
2012-11-04,Indianapolis Colts,Miami Dolphins,23,20,2012,9,domingo,Regular Season,5-3,5,3,0,11,15,-4,4-4,4,4,0,15,12,3,Indianapolis Colts,3
2012-11-04,Houston Texans,Buffalo Bills,21,9,2012,9,domingo,Regular Season,7-1,7,1,0,2,3,-1,3-5,3,5,0,28,28,0,Houston Texans,25
2012-11-04,Green Bay Packers,Arizona Cardinals,31,17,2012,9,domingo,Regular Season,6-3,6,3,0,6,6,0,4-5,4,5,0,20,16,4,Green Bay Packers,10
2012-11-04,Cleveland Browns,Baltimore Ravens,15,25,2012,9,domingo,Regular Season,2-7,2,7,0,30,29,1,6-2,6,2,0,7,7,0,Baltimore Ravens,22
2012-11-04,Cincinnati Bengals,Denver Broncos,23,31,2012,9,domingo,Regular Season,3-5,3,5,0,23,22,1,5-3,5,3,0,8,9,-1,Denver Broncos,13
2012-11-04,Atlanta Falcons,Dallas Cowboys,19,13,2012,9,domingo,Regular Season,8-0,8,0,0,1,1,0,3-5,3,5,0,18,14,4,Atlanta Falcons,13
2012-11-01,Los Angeles Chargers,Kansas City Chiefs,31,13,2012,9,quinta,Regular Season,4-4,4,4,0,17,20,-3,1-7,1,7,0,32,32,0,Los Angeles Chargers,12
2012-10-29,Arizona Cardinals,San Francisco 49ers,3,24,2012,8,segunda,Regular Season,4-4,4,4,0,16,14,2,6-2,6,2,0,4,4,0,San Francisco 49ers,10
2012-10-28,Tennessee Titans,Indianapolis Colts,13,19,2012,8,domingo,Regular Season,3-5,3,5,0,27,25,2,4-3,4,3,0,15,23,-8,Indianapolis Colts,2
2012-10-28,Los Angeles Rams,New England Patriots,7,45,2012,8,domingo,Regular Season,3-5,3,5,0,23,21,2,5-3,5,3,0,8,8,0,New England Patriots,13
2012-10-28,Pittsburgh Steelers,Washington Redskins,27,12,2012,8,domingo,Regular Season,4-3,4,3,0,10,10,0,3-5,3,5,0,19,18,1,Pittsburgh Steelers,8
2012-10-28,Philadelphia Eagles,Atlanta Falcons,17,30,2012,8,domingo,Regular Season,3-4,3,4,0,18,13,5,7-0,7,0,0,1,1,0,Atlanta Falcons,12
2012-10-28,New York Jets,Miami Dolphins,9,30,2012,8,domingo,Regular Season,3-5,3,5,0,25,24,1,4-3,4,3,0,12,16,-4,Miami Dolphins,8
2012-10-28,Kansas City Chiefs,Oakland Raiders,16,26,2012,8,domingo,Regular Season,1-6,1,6,0,32,32,0,3-4,3,4,0,24,28,-4,Oakland Raiders,4
2012-10-28,Green Bay Packers,Jacksonville Jaguars,24,15,2012,8,domingo,Regular Season,5-3,5,3,0,6,7,-1,1-6,1,6,0,31,31,0,Green Bay Packers,24
2012-10-28,Detroit Lions,Seattle Seahawks,28,24,2012,8,domingo,Regular Season,3-4,3,4,0,17,19,-2,4-4,4,4,0,13,11,2,Detroit Lions,8
2012-10-28,Denver Broncos,New Orleans Saints,34,14,2012,8,domingo,Regular Season,4-3,4,3,0,9,12,-3,2-5,2,5,0,26,20,6,Denver Broncos,8
2012-10-28,Dallas Cowboys,New York Giants,24,29,2012,8,domingo,Regular Season,3-4,3,4,0,14,15,-1,6-2,6,2,0,2,2,0,New York Giants,13
2012-10-28,Cleveland Browns,Los Angeles Chargers,7,6,2012,8,domingo,Regular Season,2-6,2,6,0,29,30,-1,3-4,3,4,0,20,17,3,Cleveland Browns,13
2012-10-28,Chicago Bears,Carolina Panthers,23,22,2012,8,domingo,Regular Season,6-1,6,1,0,5,5,0,1-6,1,6,0,30,29,1,Chicago Bears,24
2012-10-25,Minnesota Vikings,Tampa Bay Buccaneers,17,36,2012,8,quinta,Regular Season,5-3,5,3,0,11,9,2,3-4,3,4,0,21,26,-5,Tampa Bay Buccaneers,17
2012-10-22,Chicago Bears,Detroit Lions,13,7,2012,7,segunda,Regular Season,5-1,5,1,0,5,6,-1,2-4,2,4,0,19,19,0,Chicago Bears,13
2012-10-21,Tampa Bay Buccaneers,New Orleans Saints,28,35,2012,7,domingo,Regular Season,2-4,2,4,0,26,22,4,2-4,2,4,0,20,24,-4,New Orleans Saints,2
2012-10-21,Los Angeles Rams,Green Bay Packers,20,30,2012,7,domingo,Regular Season,3-4,3,4,0,21,20,1,4-3,4,3,0,7,8,-1,Green Bay Packers,12
2012-10-21,Oakland Raiders,Jacksonville Jaguars,26,23,2012,7,domingo,Regular Season,2-4,2,4,0,28,29,-1,1-5,1,5,0,31,31,0,Oakland Raiders,2
2012-10-21,New York Giants,Washington Redskins,27,23,2012,7,domingo,Regular Season,5-2,5,2,0,2,3,-1,3-4,3,4,0,18,15,3,New York Giants,12
2012-10-21,New England Patriots,New York Jets,29,26,2012,7,domingo,Regular Season,4-3,4,3,0,8,7,1,3-4,3,4,0,24,23,1,New England Patriots,16
2012-10-21,Minnesota Vikings,Arizona Cardinals,21,14,2012,7,domingo,Regular Season,5-2,5,2,0,9,10,-1,4-3,4,3,0,14,11,3,Minnesota Vikings,1
2012-10-21,Indianapolis Colts,Cleveland Browns,17,13,2012,7,domingo,Regular Season,3-3,3,3,0,23,26,-3,1-6,1,6,0,30,30,0,Indianapolis Colts,4
2012-10-21,Houston Texans,Baltimore Ravens,43,13,2012,7,domingo,Regular Season,6-1,6,1,0,3,2,1,5-2,5,2,0,6,4,2,Houston Texans,2
2012-10-21,Cincinnati Bengals,Pittsburgh Steelers,17,24,2012,7,domingo,Regular Season,3-4,3,4,0,22,21,1,3-3,3,3,0,10,14,-4,Pittsburgh Steelers,7
2012-10-21,Carolina Panthers,Dallas Cowboys,14,19,2012,7,domingo,Regular Season,1-5,1,5,0,29,28,1,3-3,3,3,0,15,18,-3,Dallas Cowboys,10
2012-10-21,Buffalo Bills,Tennessee Titans,34,35,2012,7,domingo,Regular Season,3-4,3,4,0,27,25,2,3-4,3,4,0,25,27,-2,Tennessee Titans,2
2012-10-18,San Francisco 49ers,Seattle Seahawks,13,6,2012,7,quinta,Regular Season,5-2,5,2,0,4,5,-1,4-3,4,3,0,11,9,2,San Francisco 49ers,4
2012-10-15,Los Angeles Chargers,Denver Broncos,24,35,2012,6,segunda,Regular Season,3-3,3,3,0,16,14,2,3-3,3,3,0,12,17,-5,Denver Broncos,3
2012-10-14,Washington Redskins,Minnesota Vikings,38,26,2012,6,domingo,Regular Season,3-3,3,3,0,15,21,-6,4-2,4,2,0,10,8,2,Washington Redskins,13
2012-10-14,Tampa Bay Buccaneers,Kansas City Chiefs,38,10,2012,6,domingo,Regular Season,2-3,2,3,0,22,23,-1,1-5,1,5,0,32,30,2,Tampa Bay Buccaneers,7
2012-10-14,Seattle Seahawks,New England Patriots,24,23,2012,6,domingo,Regular Season,4-2,4,2,0,9,16,-7,3-3,3,3,0,7,5,2,Seattle Seahawks,11
2012-10-14,San Francisco 49ers,New York Giants,3,26,2012,6,domingo,Regular Season,4-2,4,2,0,5,3,2,4-2,4,2,0,3,7,-4,New York Giants,4
2012-10-14,Philadelphia Eagles,Detroit Lions,23,26,2012,6,domingo,Regular Season,3-3,3,3,0,13,11,2,2-3,2,3,0,19,20,-1,Detroit Lions,9
2012-10-14,New York Jets,Indianapolis Colts,35,9,2012,6,domingo,Regular Season,3-3,3,3,0,23,25,-2,2-3,2,3,0,26,22,4,New York Jets,3
2012-10-14,Miami Dolphins,Los Angeles Rams,17,14,2012,6,domingo,Regular Season,3-3,3,3,0,17,19,-2,3-3,3,3,0,20,18,2,Miami Dolphins,1
2012-10-14,Houston Texans,Green Bay Packers,24,42,2012,6,domingo,Regular Season,5-1,5,1,0,2,1,1,3-3,3,3,0,8,12,-4,Green Bay Packers,11
2012-10-14,Cleveland Browns,Cincinnati Bengals,34,24,2012,6,domingo,Regular Season,1-5,1,5,0,30,32,-2,3-3,3,3,0,21,15,6,Cleveland Browns,17
2012-10-14,Baltimore Ravens,Dallas Cowboys,31,29,2012,6,domingo,Regular Season,5-1,5,1,0,4,4,0,2-3,2,3,0,18,13,5,Baltimore Ravens,9
2012-10-14,Atlanta Falcons,Oakland Raiders,23,20,2012,6,domingo,Regular Season,6-0,6,0,0,1,2,-1,1-4,1,4,0,29,29,0,Atlanta Falcons,27
2012-10-14,Arizona Cardinals,Buffalo Bills,16,19,2012,6,domingo,Regular Season,4-2,4,2,0,11,9,2,3-3,3,3,0,25,27,-2,Buffalo Bills,18
2012-10-11,Tennessee Titans,Pittsburgh Steelers,26,23,2012,6,quinta,Regular Season,2-4,2,4,0,27,28,-1,2-3,2,3,0,14,10,4,Tennessee Titans,18
2012-10-08,New York Jets,Houston Texans,17,23,2012,5,segunda,Regular Season,2-3,2,3,0,25,23,2,5-0,5,0,0,1,1,0,Houston Texans,22
2012-10-07,Washington Redskins,Atlanta Falcons,17,24,2012,5,domingo,Regular Season,2-3,2,3,0,21,18,3,5-0,5,0,0,2,2,0,Atlanta Falcons,16
2012-10-07,San Francisco 49ers,Buffalo Bills,45,3,2012,5,domingo,Regular Season,4-1,4,1,0,3,4,-1,2-3,2,3,0,27,21,6,San Francisco 49ers,17
2012-10-07,Pittsburgh Steelers,Philadelphia Eagles,16,14,2012,5,domingo,Regular Season,2-2,2,2,0,10,16,-6,3-2,3,2,0,11,7,4,Pittsburgh Steelers,9
2012-10-07,New York Giants,Cleveland Browns,41,27,2012,5,domingo,Regular Season,3-2,3,2,0,7,10,-3,0-5,0,5,0,32,32,0,New York Giants,22
2012-10-07,New Orleans Saints,Los Angeles Chargers,31,24,2012,5,domingo,Regular Season,1-4,1,4,0,24,28,-4,3-2,3,2,0,14,11,3,New Orleans Saints,17
2012-10-07,New England Patriots,Denver Broncos,31,21,2012,5,domingo,Regular Season,3-2,3,2,0,5,6,-1,2-3,2,3,0,17,13,4,New England Patriots,7
2012-10-07,Minnesota Vikings,Tennessee Titans,30,7,2012,5,domingo,Regular Season,4-1,4,1,0,8,14,-6,1-4,1,4,0,28,25,3,Minnesota Vikings,11
2012-10-07,Kansas City Chiefs,Baltimore Ravens,6,9,2012,5,domingo,Regular Season,1-4,1,4,0,30,27,3,4-1,4,1,0,4,3,1,Baltimore Ravens,24
2012-10-07,Jacksonville Jaguars,Chicago Bears,3,41,2012,5,domingo,Regular Season,1-4,1,4,0,31,30,1,4-1,4,1,0,6,9,-3,Chicago Bears,21
2012-10-07,Indianapolis Colts,Green Bay Packers,30,27,2012,5,domingo,Regular Season,2-2,2,2,0,22,31,-9,2-3,2,3,0,12,8,4,Indianapolis Colts,23
2012-10-07,Cincinnati Bengals,Miami Dolphins,13,17,2012,5,domingo,Regular Season,3-2,3,2,0,15,12,3,2-3,2,3,0,19,26,-7,Miami Dolphins,14
2012-10-07,Carolina Panthers,Seattle Seahawks,12,16,2012,5,domingo,Regular Season,1-4,1,4,0,26,24,2,3-2,3,2,0,16,17,-1,Seattle Seahawks,7
2012-10-04,Los Angeles Rams,Arizona Cardinals,17,3,2012,5,quinta,Regular Season,3-2,3,2,0,18,19,-1,4-1,4,1,0,9,5,4,Los Angeles Rams,14
2012-10-01,Dallas Cowboys,Chicago Bears,18,34,2012,4,segunda,Regular Season,2-2,2,2,0,15,12,3,3-1,3,1,0,9,11,-2,Chicago Bears,1
2012-09-30,Tampa Bay Buccaneers,Washington Redskins,22,24,2012,4,domingo,Regular Season,1-3,1,3,0,22,20,2,2-2,2,2,0,18,22,-4,Washington Redskins,2
2012-09-30,Los Angeles Rams,Seattle Seahawks,19,13,2012,4,domingo,Regular Season,2-2,2,2,0,19,25,-6,2-2,2,2,0,17,10,7,Los Angeles Rams,15
2012-09-30,Philadelphia Eagles,New York Giants,19,17,2012,4,domingo,Regular Season,3-1,3,1,0,7,9,-2,2-2,2,2,0,10,6,4,Philadelphia Eagles,3
2012-09-30,New York Jets,San Francisco 49ers,0,34,2012,4,domingo,Regular Season,2-2,2,2,0,23,17,6,3-1,3,1,0,4,4,0,San Francisco 49ers,13
2012-09-30,Kansas City Chiefs,Los Angeles Chargers,20,37,2012,4,domingo,Regular Season,1-3,1,3,0,27,26,1,3-1,3,1,0,11,13,-2,Los Angeles Chargers,13
2012-09-30,Jacksonville Jaguars,Cincinnati Bengals,10,27,2012,4,domingo,Regular Season,1-3,1,3,0,30,30,0,3-1,3,1,0,12,15,-3,Cincinnati Bengals,15
2012-09-30,Houston Texans,Tennessee Titans,38,14,2012,4,domingo,Regular Season,4-0,4,0,0,1,1,0,1-3,1,3,0,25,24,1,Houston Texans,23
2012-09-30,Green Bay Packers,New Orleans Saints,28,27,2012,4,domingo,Regular Season,2-2,2,2,0,8,7,1,0-4,0,4,0,28,28,0,Green Bay Packers,21
2012-09-30,Detroit Lions,Minnesota Vikings,13,20,2012,4,domingo,Regular Season,1-3,1,3,0,20,18,2,3-1,3,1,0,14,21,-7,Minnesota Vikings,3
2012-09-30,Denver Broncos,Oakland Raiders,37,6,2012,4,domingo,Regular Season,2-2,2,2,0,13,14,-1,1-3,1,3,0,29,27,2,Denver Broncos,13
2012-09-30,Buffalo Bills,New England Patriots,28,52,2012,4,domingo,Regular Season,2-2,2,2,0,21,19,2,2-2,2,2,0,6,8,-2,New England Patriots,11
2012-09-30,Atlanta Falcons,Carolina Panthers,30,28,2012,4,domingo,Regular Season,4-0,4,0,0,2,2,0,1-3,1,3,0,24,23,1,Atlanta Falcons,21
2012-09-30,Arizona Cardinals,Miami Dolphins,24,21,2012,4,domingo,Regular Season,4-0,4,0,0,5,5,0,1-3,1,3,0,26,29,-3,Arizona Cardinals,24
2012-09-27,Baltimore Ravens,Cleveland Browns,23,16,2012,4,quinta,Regular Season,3-1,3,1,0,3,3,0,0-4,0,4,0,32,32,0,Baltimore Ravens,29
2012-09-24,Seattle Seahawks,Green Bay Packers,14,12,2012,3,segunda,Regular Season,2-1,2,1,0,10,17,-7,1-2,1,2,0,7,4,3,Seattle Seahawks,13
2012-09-23,Washington Redskins,Cincinnati Bengals,31,38,2012,3,domingo,Regular Season,1-2,1,2,0,22,20,2,2-1,2,1,0,15,16,-1,Cincinnati Bengals,4
2012-09-23,Tennessee Titans,Detroit Lions,44,41,2012,3,domingo,Regular Season,1-2,1,2,0,24,26,-2,1-2,1,2,0,18,13,5,Tennessee Titans,13
2012-09-23,Los Angeles Chargers,Atlanta Falcons,3,27,2012,3,domingo,Regular Season,2-1,2,1,0,13,11,2,3-0,3,0,0,2,3,-1,Atlanta Falcons,8
2012-09-23,Oakland Raiders,Pittsburgh Steelers,34,31,2012,3,domingo,Regular Season,1-2,1,2,0,27,30,-3,1-2,1,2,0,16,9,7,Oakland Raiders,21
2012-09-23,New Orleans Saints,Kansas City Chiefs,24,27,2012,3,domingo,Regular Season,0-3,0,3,0,28,24,4,1-2,1,2,0,26,28,-2,Kansas City Chiefs,4
2012-09-23,Minnesota Vikings,San Francisco 49ers,24,13,2012,3,domingo,Regular Season,2-1,2,1,0,21,29,-8,2-1,2,1,0,4,1,3,Minnesota Vikings,28
2012-09-23,Miami Dolphins,New York Jets,20,23,2012,3,domingo,Regular Season,1-2,1,2,0,29,25,4,2-1,2,1,0,17,18,-1,New York Jets,7
2012-09-23,Indianapolis Colts,Jacksonville Jaguars,17,22,2012,3,domingo,Regular Season,1-2,1,2,0,31,27,4,1-2,1,2,0,30,31,-1,Jacksonville Jaguars,4
2012-09-23,Denver Broncos,Houston Texans,25,31,2012,3,domingo,Regular Season,1-2,1,2,0,14,10,4,3-0,3,0,0,1,2,-1,Houston Texans,8
2012-09-23,Dallas Cowboys,Tampa Bay Buccaneers,16,10,2012,3,domingo,Regular Season,2-1,2,1,0,12,15,-3,1-2,1,2,0,20,21,-1,Dallas Cowboys,6
2012-09-23,Cleveland Browns,Buffalo Bills,14,24,2012,3,domingo,Regular Season,0-3,0,3,0,32,32,0,2-1,2,1,0,19,22,-3,Buffalo Bills,10
2012-09-23,Chicago Bears,Los Angeles Rams,23,6,2012,3,domingo,Regular Season,2-1,2,1,0,11,12,-1,1-2,1,2,0,25,23,2,Chicago Bears,11
2012-09-23,Baltimore Ravens,New England Patriots,31,30,2012,3,domingo,Regular Season,2-1,2,1,0,3,6,-3,1-2,1,2,0,8,5,3,Baltimore Ravens,1
2012-09-23,Arizona Cardinals,Philadelphia Eagles,27,6,2012,3,domingo,Regular Season,3-0,3,0,0,5,14,-9,2-1,2,1,0,9,7,2,Arizona Cardinals,7
2012-09-20,Carolina Panthers,New York Giants,7,36,2012,3,quinta,Regular Season,1-2,1,2,0,23,19,4,2-1,2,1,0,6,8,-2,New York Giants,11
2012-09-17,Atlanta Falcons,Denver Broncos,27,21,2012,2,segunda,Regular Season,2-0,2,0,0,3,6,-3,1-1,1,1,0,10,9,1,Atlanta Falcons,3
2012-09-16,Los Angeles Rams,Washington Redskins,31,28,2012,2,domingo,Regular Season,1-1,1,1,0,23,27,-4,1-1,1,1,0,20,15,5,Los Angeles Rams,12
2012-09-16,Seattle Seahawks,Dallas Cowboys,27,7,2012,2,domingo,Regular Season,1-1,1,1,0,17,26,-9,1-1,1,1,0,15,10,5,Seattle Seahawks,16
2012-09-16,San Francisco 49ers,Detroit Lions,27,19,2012,2,domingo,Regular Season,2-0,2,0,0,1,2,-1,1-1,1,1,0,13,13,0,San Francisco 49ers,11
2012-09-16,Los Angeles Chargers,Tennessee Titans,38,10,2012,2,domingo,Regular Season,2-0,2,0,0,11,14,-3,0-2,0,2,0,26,22,4,Los Angeles Chargers,8
2012-09-16,Pittsburgh Steelers,New York Jets,27,10,2012,2,domingo,Regular Season,1-1,1,1,0,9,11,-2,1-1,1,1,0,18,17,1,Pittsburgh Steelers,6
2012-09-16,Philadelphia Eagles,Baltimore Ravens,24,23,2012,2,domingo,Regular Season,2-0,2,0,0,7,12,-5,1-1,1,1,0,6,3,3,Philadelphia Eagles,9
2012-09-16,New York Giants,Tampa Bay Buccaneers,41,34,2012,2,domingo,Regular Season,1-1,1,1,0,8,7,1,1-1,1,1,0,21,21,0,New York Giants,14
2012-09-16,New England Patriots,Arizona Cardinals,18,20,2012,2,domingo,Regular Season,1-1,1,1,0,5,1,4,2-0,2,0,0,14,20,-6,Arizona Cardinals,19
2012-09-16,Miami Dolphins,Oakland Raiders,35,13,2012,2,domingo,Regular Season,1-1,1,1,0,25,30,-5,0-2,0,2,0,30,25,5,Miami Dolphins,5
2012-09-16,Jacksonville Jaguars,Houston Texans,7,27,2012,2,domingo,Regular Season,0-2,0,2,0,31,29,2,2-0,2,0,0,2,4,-2,Houston Texans,25
2012-09-16,Indianapolis Colts,Minnesota Vikings,23,20,2012,2,domingo,Regular Season,1-1,1,1,0,27,32,-5,1-1,1,1,0,29,28,1,Indianapolis Colts,4
2012-09-16,Cincinnati Bengals,Cleveland Browns,34,27,2012,2,domingo,Regular Season,1-1,1,1,0,16,18,-2,0-2,0,2,0,32,31,1,Cincinnati Bengals,13
2012-09-16,Carolina Panthers,New Orleans Saints,35,27,2012,2,domingo,Regular Season,1-1,1,1,0,19,23,-4,0-2,0,2,0,24,16,8,Carolina Panthers,7
2012-09-16,Buffalo Bills,Kansas City Chiefs,35,17,2012,2,domingo,Regular Season,1-1,1,1,0,22,24,-2,0-2,0,2,0,28,19,9,Buffalo Bills,5
2012-09-13,Green Bay Packers,Chicago Bears,23,10,2012,2,quinta,Regular Season,1-1,1,1,0,4,5,-1,1-1,1,1,0,12,8,4,Green Bay Packers,3
2012-09-10,Oakland Raiders,Los Angeles Chargers,14,22,2012,1,segunda,Regular Season,0-1,0,1,0,25,26,-1,1-0,1,0,0,14,15,-1,Los Angeles Chargers,11
2012-09-10,Baltimore Ravens,Cincinnati Bengals,44,13,2012,1,segunda,Regular Season,1-0,1,0,0,3,6,-3,0-1,0,1,0,18,16,2,Baltimore Ravens,10
2012-09-09,Tennessee Titans,New England Patriots,13,34,2012,1,domingo,Regular Season,0-1,0,1,0,22,18,4,1-0,1,0,0,1,2,-1,New England Patriots,16
2012-09-09,Tampa Bay Buccaneers,Carolina Panthers,16,10,2012,1,domingo,Regular Season,1-0,1,0,0,21,25,-4,0-1,0,1,0,23,22,1,Tampa Bay Buccaneers,3
2012-09-09,New York Jets,Buffalo Bills,48,28,2012,1,domingo,Regular Season,1-0,1,0,0,17,21,-4,0-1,0,1,0,24,19,5,New York Jets,2
2012-09-09,New Orleans Saints,Washington Redskins,32,40,2012,1,domingo,Regular Season,0-1,0,1,0,16,11,5,1-0,1,0,0,15,24,-9,Washington Redskins,13
2012-09-09,Minnesota Vikings,Jacksonville Jaguars,26,23,2012,1,domingo,Regular Season,1-0,1,0,0,28,30,-2,0-1,0,1,0,29,29,0,Minnesota Vikings,1
2012-09-09,Kansas City Chiefs,Atlanta Falcons,24,40,2012,1,domingo,Regular Season,0-1,0,1,0,19,17,2,1-0,1,0,0,6,10,-4,Atlanta Falcons,7
2012-09-09,Houston Texans,Miami Dolphins,30,10,2012,1,domingo,Regular Season,1-0,1,0,0,4,5,-1,0-1,0,1,0,30,27,3,Houston Texans,22
2012-09-09,Green Bay Packers,San Francisco 49ers,22,30,2012,1,domingo,Regular Season,0-1,0,1,0,5,1,4,1-0,1,0,0,2,4,-2,San Francisco 49ers,3
2012-09-09,Detroit Lions,Los Angeles Rams,27,23,2012,1,domingo,Regular Season,1-0,1,0,0,13,12,1,0-1,0,1,0,27,28,-1,Detroit Lions,16
2012-09-09,Denver Broncos,Pittsburgh Steelers,31,19,2012,1,domingo,Regular Season,1-0,1,0,0,9,13,-4,0-1,0,1,0,11,8,3,Denver Broncos,5
2012-09-09,Cleveland Browns,Philadelphia Eagles,16,17,2012,1,domingo,Regular Season,0-1,0,1,0,31,31,0,1-0,1,0,0,12,7,5,Philadelphia Eagles,24
2012-09-09,Chicago Bears,Indianapolis Colts,41,21,2012,1,domingo,Regular Season,1-0,1,0,0,8,9,-1,0-1,0,1,0,32,32,0,Chicago Bears,23
2012-09-09,Arizona Cardinals,Seattle Seahawks,20,16,2012,1,domingo,Regular Season,1-0,1,0,0,20,23,-3,0-1,0,1,0,26,20,6,Arizona Cardinals,3
2012-09-05,New York Giants,Dallas Cowboys,17,24,2012,1,quarta,Regular Season,0-1,0,1,0,7,3,4,1-0,1,0,0,10,14,-4,Dallas Cowboys,11
2012-01-01,Los Angeles Rams,San Francisco 49ers,27,34,2011,17,domingo,Regular Season,2-14,2,14,0,31,32,-1,13-3,13,3,0,3,3,0,San Francisco 49ers,29
2012-01-01,Philadelphia Eagles,Washington Redskins,34,10,2011,17,domingo,Regular Season,8-8,8,8,0,15,17,-2,5-11,5,11,0,26,26,0,Philadelphia Eagles,9
2012-01-01,Oakland Raiders,Los Angeles Chargers,26,38,2011,17,domingo,Regular Season,8-8,8,8,0,17,14,3,8-8,8,8,0,16,19,-3,Los Angeles Chargers,5
2012-01-01,New York Giants,Dallas Cowboys,31,14,2011,17,domingo,Regular Season,9-7,9,7,0,9,12,-3,8-8,8,8,0,13,11,2,New York Giants,1
2012-01-01,New Orleans Saints,Carolina Panthers,45,17,2011,17,domingo,Regular Season,13-3,13,3,0,2,2,0,6-10,6,10,0,23,21,2,New Orleans Saints,19
2012-01-01,New England Patriots,Buffalo Bills,49,21,2011,17,domingo,Regular Season,13-3,13,3,0,4,4,0,6-10,6,10,0,25,25,0,New England Patriots,21
2012-01-01,Minnesota Vikings,Chicago Bears,13,17,2011,17,domingo,Regular Season,3-13,3,13,0,30,30,0,8-8,8,8,0,20,22,-2,Chicago Bears,8
2012-01-01,Miami Dolphins,New York Jets,19,17,2011,17,domingo,Regular Season,6-10,6,10,0,24,24,0,8-8,8,8,0,19,16,3,Miami Dolphins,8
2012-01-01,Jacksonville Jaguars,Indianapolis Colts,19,13,2011,17,domingo,Regular Season,5-11,5,11,0,27,27,0,2-14,2,14,0,32,31,1,Jacksonville Jaguars,4
2012-01-01,Houston Texans,Tennessee Titans,22,23,2011,17,domingo,Regular Season,10-6,10,6,0,10,9,1,9-7,9,7,0,12,15,-3,Tennessee Titans,6
2012-01-01,Green Bay Packers,Detroit Lions,45,41,2011,17,domingo,Regular Season,15-1,15,1,0,1,1,0,10-6,10,6,0,8,7,1,Green Bay Packers,6
2012-01-01,Denver Broncos,Kansas City Chiefs,3,7,2011,17,domingo,Regular Season,8-8,8,8,0,14,13,1,7-9,7,9,0,22,23,-1,Kansas City Chiefs,10
2012-01-01,Cleveland Browns,Pittsburgh Steelers,9,13,2011,17,domingo,Regular Season,4-12,4,12,0,28,28,0,12-4,12,4,0,6,6,0,Pittsburgh Steelers,22
2012-01-01,Cincinnati Bengals,Baltimore Ravens,16,24,2011,17,domingo,Regular Season,9-7,9,7,0,11,10,1,12-4,12,4,0,5,5,0,Baltimore Ravens,5
2012-01-01,Atlanta Falcons,Tampa Bay Buccaneers,45,24,2011,17,domingo,Regular Season,10-6,10,6,0,7,8,-1,4-12,4,12,0,29,29,0,Atlanta Falcons,21
2012-01-01,Arizona Cardinals,Seattle Seahawks,23,20,2011,17,domingo,Regular Season,8-8,8,8,0,18,20,-2,7-9,7,9,0,21,18,3,Arizona Cardinals,2
2011-12-26,New Orleans Saints,Atlanta Falcons,45,16,2011,16,segunda,Regular Season,12-3,12,3,0,2,2,0,9-6,9,6,0,8,8,0,New Orleans Saints,6
2011-12-25,Green Bay Packers,Chicago Bears,35,21,2011,16,domingo,Regular Season,14-1,14,1,0,1,1,0,7-8,7,8,0,22,21,1,Green Bay Packers,20
2011-12-24,Washington Redskins,Minnesota Vikings,26,33,2011,16,sábado,Regular Season,5-10,5,10,0,26,25,1,3-12,3,12,0,30,30,0,Minnesota Vikings,5
2011-12-24,Tennessee Titans,Jacksonville Jaguars,23,17,2011,16,sábado,Regular Season,8-7,8,7,0,15,20,-5,4-11,4,11,0,27,27,0,Tennessee Titans,7
2011-12-24,Seattle Seahawks,San Francisco 49ers,17,19,2011,16,sábado,Regular Season,7-8,7,8,0,18,15,3,12-3,12,3,0,3,3,0,San Francisco 49ers,12
2011-12-24,Pittsburgh Steelers,Los Angeles Rams,27,0,2011,16,sábado,Regular Season,11-4,11,4,0,6,6,0,2-13,2,13,0,32,31,1,Pittsburgh Steelers,25
2011-12-24,New York Jets,New York Giants,14,29,2011,16,sábado,Regular Season,8-7,8,7,0,16,12,4,8-7,8,7,0,12,16,-4,New York Giants,4
2011-12-24,New England Patriots,Miami Dolphins,27,24,2011,16,sábado,Regular Season,12-3,12,3,0,4,4,0,5-10,5,10,0,24,23,1,New England Patriots,19
2011-12-24,Kansas City Chiefs,Oakland Raiders,13,16,2011,16,sábado,Regular Season,6-9,6,9,0,23,22,1,8-7,8,7,0,14,19,-5,Oakland Raiders,3
2011-12-24,Detroit Lions,Los Angeles Chargers,38,10,2011,16,sábado,Regular Season,10-5,10,5,0,7,9,-2,7-8,7,8,0,19,14,5,Detroit Lions,5
2011-12-24,Dallas Cowboys,Philadelphia Eagles,7,20,2011,16,sábado,Regular Season,8-7,8,7,0,11,10,1,7-8,7,8,0,17,18,-1,Philadelphia Eagles,8
2011-12-24,Cincinnati Bengals,Arizona Cardinals,23,16,2011,16,sábado,Regular Season,9-6,9,6,0,10,13,-3,7-8,7,8,0,20,17,3,Cincinnati Bengals,4
2011-12-24,Carolina Panthers,Tampa Bay Buccaneers,48,16,2011,16,sábado,Regular Season,6-9,6,9,0,21,24,-3,4-11,4,11,0,29,29,0,Carolina Panthers,5
2011-12-24,Buffalo Bills,Denver Broncos,40,14,2011,16,sábado,Regular Season,6-9,6,9,0,25,26,-1,8-7,8,7,0,13,11,2,Buffalo Bills,15
2011-12-24,Baltimore Ravens,Cleveland Browns,20,14,2011,16,sábado,Regular Season,11-4,11,4,0,5,5,0,4-11,4,11,0,28,28,0,Baltimore Ravens,23
2011-12-22,Indianapolis Colts,Houston Texans,19,16,2011,16,quinta,Regular Season,2-13,2,13,0,31,32,-1,10-5,10,5,0,9,7,2,Indianapolis Colts,25
2011-12-19,San Francisco 49ers,Pittsburgh Steelers,20,3,2011,15,segunda,Regular Season,11-3,11,3,0,3,6,-3,10-4,10,4,0,6,4,2,San Francisco 49ers,2
2011-12-18,Los Angeles Rams,Cincinnati Bengals,13,20,2011,15,domingo,Regular Season,2-12,2,12,0,31,31,0,8-6,8,6,0,13,15,-2,Cincinnati Bengals,16
2011-12-18,Los Angeles Chargers,Baltimore Ravens,34,14,2011,15,domingo,Regular Season,7-7,7,7,0,14,18,-4,10-4,10,4,0,5,2,3,Los Angeles Chargers,16
2011-12-18,Philadelphia Eagles,New York Jets,45,19,2011,15,domingo,Regular Season,6-8,6,8,0,18,21,-3,8-6,8,6,0,12,10,2,Philadelphia Eagles,11
2011-12-18,Oakland Raiders,Detroit Lions,27,28,2011,15,domingo,Regular Season,7-7,7,7,0,19,16,3,9-5,9,5,0,9,11,-2,Detroit Lions,5
2011-12-18,New York Giants,Washington Redskins,10,23,2011,15,domingo,Regular Season,7-7,7,7,0,16,12,4,5-9,5,9,0,25,27,-2,Washington Redskins,15
2011-12-18,Minnesota Vikings,New Orleans Saints,20,42,2011,15,domingo,Regular Season,2-12,2,12,0,30,30,0,11-3,11,3,0,2,3,-1,New Orleans Saints,27
2011-12-18,Kansas City Chiefs,Green Bay Packers,19,14,2011,15,domingo,Regular Season,6-8,6,8,0,22,25,-3,13-1,13,1,0,1,1,0,Kansas City Chiefs,24
2011-12-18,Indianapolis Colts,Tennessee Titans,27,13,2011,15,domingo,Regular Season,1-13,1,13,0,32,32,0,7-7,7,7,0,20,13,7,Indianapolis Colts,19
2011-12-18,Houston Texans,Carolina Panthers,13,28,2011,15,domingo,Regular Season,10-4,10,4,0,7,7,0,5-9,5,9,0,24,24,0,Carolina Panthers,17
2011-12-18,Denver Broncos,New England Patriots,23,41,2011,15,domingo,Regular Season,8-6,8,6,0,11,9,2,11-3,11,3,0,4,5,-1,New England Patriots,4
2011-12-18,Chicago Bears,Seattle Seahawks,14,38,2011,15,domingo,Regular Season,7-7,7,7,0,21,17,4,7-7,7,7,0,15,20,-5,Seattle Seahawks,3
2011-12-18,Buffalo Bills,Miami Dolphins,23,30,2011,15,domingo,Regular Season,5-9,5,9,0,26,22,4,5-9,5,9,0,23,23,0,Miami Dolphins,1
2011-12-18,Arizona Cardinals,Cleveland Browns,20,17,2011,15,domingo,Regular Season,7-7,7,7,0,17,19,-2,4-10,4,10,0,28,29,-1,Arizona Cardinals,10
2011-12-17,Tampa Bay Buccaneers,Dallas Cowboys,15,31,2011,15,sábado,Regular Season,4-10,4,10,0,29,28,1,8-6,8,6,0,10,14,-4,Dallas Cowboys,14
2011-12-15,Atlanta Falcons,Jacksonville Jaguars,41,14,2011,15,quinta,Regular Season,9-5,9,5,0,8,8,0,4-10,4,10,0,27,26,1,Atlanta Falcons,18
2011-12-12,Seattle Seahawks,Los Angeles Rams,30,13,2011,14,segunda,Regular Season,6-7,6,7,0,20,19,1,2-11,2,11,0,31,31,0,Seattle Seahawks,12
2011-12-11,Washington Redskins,New England Patriots,27,34,2011,14,domingo,Regular Season,4-9,4,9,0,27,27,0,10-3,10,3,0,5,6,-1,New England Patriots,21
2011-12-11,Tennessee Titans,New Orleans Saints,17,22,2011,14,domingo,Regular Season,7-6,7,6,0,13,13,0,10-3,10,3,0,3,4,-1,New Orleans Saints,9
2011-12-11,Los Angeles Chargers,Buffalo Bills,37,10,2011,14,domingo,Regular Season,6-7,6,7,0,18,21,-3,5-8,5,8,0,22,20,2,Los Angeles Chargers,1
2011-12-11,New York Jets,Kansas City Chiefs,37,10,2011,14,domingo,Regular Season,8-5,8,5,0,10,11,-1,5-8,5,8,0,25,23,2,New York Jets,12
2011-12-11,Miami Dolphins,Philadelphia Eagles,10,26,2011,14,domingo,Regular Season,4-9,4,9,0,23,22,1,5-8,5,8,0,21,24,-3,Philadelphia Eagles,2
2011-12-11,Jacksonville Jaguars,Tampa Bay Buccaneers,41,14,2011,14,domingo,Regular Season,4-9,4,9,0,26,29,-3,4-9,4,9,0,28,26,2,Jacksonville Jaguars,3
2011-12-11,Green Bay Packers,Oakland Raiders,46,16,2011,14,domingo,Regular Season,13-0,13,0,0,1,1,0,7-6,7,6,0,16,15,1,Green Bay Packers,14
2011-12-11,Detroit Lions,Minnesota Vikings,34,28,2011,14,domingo,Regular Season,8-5,8,5,0,11,12,-1,2-11,2,11,0,30,30,0,Detroit Lions,18
2011-12-11,Denver Broncos,Chicago Bears,13,10,2011,14,domingo,Regular Season,8-5,8,5,0,9,10,-1,7-6,7,6,0,17,17,0,Denver Broncos,7
2011-12-11,Dallas Cowboys,New York Giants,34,37,2011,14,domingo,Regular Season,7-6,7,6,0,14,9,5,7-6,7,6,0,12,16,-4,New York Giants,7
2011-12-11,Cincinnati Bengals,Houston Texans,19,20,2011,14,domingo,Regular Season,7-6,7,6,0,15,14,1,10-3,10,3,0,7,7,0,Houston Texans,7
2011-12-11,Carolina Panthers,Atlanta Falcons,23,31,2011,14,domingo,Regular Season,4-9,4,9,0,24,25,-1,8-5,8,5,0,8,8,0,Atlanta Falcons,17
2011-12-11,Baltimore Ravens,Indianapolis Colts,24,10,2011,14,domingo,Regular Season,10-3,10,3,0,2,2,0,0-13,0,13,0,32,32,0,Baltimore Ravens,30
2011-12-11,Arizona Cardinals,San Francisco 49ers,21,19,2011,14,domingo,Regular Season,6-7,6,7,0,19,18,1,10-3,10,3,0,6,3,3,Arizona Cardinals,15
2011-12-08,Pittsburgh Steelers,Cleveland Browns,14,3,2011,14,quinta,Regular Season,10-3,10,3,0,4,5,-1,4-9,4,9,0,29,28,1,Pittsburgh Steelers,23
2011-12-05,Jacksonville Jaguars,Los Angeles Chargers,14,38,2011,13,segunda,Regular Season,3-9,3,9,0,29,29,0,5-7,5,7,0,21,22,-1,Los Angeles Chargers,7
2011-12-04,Washington Redskins,New York Jets,19,34,2011,13,domingo,Regular Season,4-8,4,8,0,27,23,4,7-5,7,5,0,11,15,-4,New York Jets,8
2011-12-04,Tampa Bay Buccaneers,Carolina Panthers,19,38,2011,13,domingo,Regular Season,4-8,4,8,0,26,20,6,4-8,4,8,0,25,28,-3,Carolina Panthers,8
2011-12-04,San Francisco 49ers,Los Angeles Rams,26,0,2011,13,domingo,Regular Season,10-2,10,2,0,3,3,0,2-10,2,10,0,31,31,0,San Francisco 49ers,28
2011-12-04,Pittsburgh Steelers,Cincinnati Bengals,35,7,2011,13,domingo,Regular Season,9-3,9,3,0,5,5,0,7-5,7,5,0,14,13,1,Pittsburgh Steelers,8
2011-12-04,New York Giants,Green Bay Packers,35,38,2011,13,domingo,Regular Season,6-6,6,6,0,16,14,2,12-0,12,0,0,1,1,0,Green Bay Packers,13
2011-12-04,New Orleans Saints,Detroit Lions,31,17,2011,13,domingo,Regular Season,9-3,9,3,0,4,4,0,7-5,7,5,0,12,11,1,New Orleans Saints,7
2011-12-04,New England Patriots,Indianapolis Colts,31,24,2011,13,domingo,Regular Season,9-3,9,3,0,6,6,0,0-12,0,12,0,32,32,0,New England Patriots,26
2011-12-04,Minnesota Vikings,Denver Broncos,32,35,2011,13,domingo,Regular Season,2-10,2,10,0,30,30,0,7-5,7,5,0,10,16,-6,Denver Broncos,14
2011-12-04,Miami Dolphins,Oakland Raiders,34,14,2011,13,domingo,Regular Season,4-8,4,8,0,22,26,-4,7-5,7,5,0,15,10,5,Miami Dolphins,16
2011-12-04,Houston Texans,Atlanta Falcons,17,10,2011,13,domingo,Regular Season,9-3,9,3,0,7,7,0,7-5,7,5,0,8,9,-1,Houston Texans,2
2011-12-04,Cleveland Browns,Baltimore Ravens,10,24,2011,13,domingo,Regular Season,4-8,4,8,0,28,27,1,9-3,9,3,0,2,2,0,Baltimore Ravens,25
2011-12-04,Chicago Bears,Kansas City Chiefs,3,10,2011,13,domingo,Regular Season,7-5,7,5,0,17,12,5,5-7,5,7,0,23,21,2,Kansas City Chiefs,9
2011-12-04,Buffalo Bills,Tennessee Titans,17,23,2011,13,domingo,Regular Season,5-7,5,7,0,20,19,1,7-5,7,5,0,13,17,-4,Tennessee Titans,2
2011-12-04,Arizona Cardinals,Dallas Cowboys,19,13,2011,13,domingo,Regular Season,5-7,5,7,0,18,25,-7,7-5,7,5,0,9,8,1,Arizona Cardinals,17
2011-12-01,Seattle Seahawks,Philadelphia Eagles,31,14,2011,13,quinta,Regular Season,5-7,5,7,0,19,24,-5,4-8,4,8,0,24,18,6,Seattle Seahawks,6
2011-11-28,New Orleans Saints,New York Giants,49,24,2011,12,segunda,Regular Season,8-3,8,3,0,4,3,1,6-5,6,5,0,14,12,2,New Orleans Saints,9
2011-11-27,Tennessee Titans,Tampa Bay Buccaneers,23,17,2011,12,domingo,Regular Season,6-5,6,5,0,17,16,1,4-7,4,7,0,20,20,0,Tennessee Titans,4
2011-11-27,Los Angeles Rams,Arizona Cardinals,20,23,2011,12,domingo,Regular Season,2-9,2,9,0,31,31,0,4-7,4,7,0,25,27,-2,Arizona Cardinals,4
2011-11-27,Seattle Seahawks,Washington Redskins,17,23,2011,12,domingo,Regular Season,4-7,4,7,0,24,23,1,4-7,4,7,0,23,26,-3,Washington Redskins,3
2011-11-27,Los Angeles Chargers,Denver Broncos,13,16,2011,12,domingo,Regular Season,4-7,4,7,0,22,21,1,6-5,6,5,0,16,17,-1,Denver Broncos,4
2011-11-27,Philadelphia Eagles,New England Patriots,20,38,2011,12,domingo,Regular Season,4-7,4,7,0,18,18,0,8-3,8,3,0,6,6,0,New England Patriots,12
2011-11-27,Oakland Raiders,Chicago Bears,25,20,2011,12,domingo,Regular Season,7-4,7,4,0,10,14,-4,7-4,7,4,0,12,7,5,Oakland Raiders,7
2011-11-27,New York Jets,Buffalo Bills,28,24,2011,12,domingo,Regular Season,6-5,6,5,0,15,15,0,5-6,5,6,0,19,19,0,New York Jets,4
2011-11-27,Kansas City Chiefs,Pittsburgh Steelers,9,13,2011,12,domingo,Regular Season,4-7,4,7,0,21,22,-1,8-3,8,3,0,5,4,1,Pittsburgh Steelers,18
2011-11-27,Jacksonville Jaguars,Houston Texans,13,20,2011,12,domingo,Regular Season,3-8,3,8,0,29,28,1,8-3,8,3,0,7,8,-1,Houston Texans,20
2011-11-27,Indianapolis Colts,Carolina Panthers,19,27,2011,12,domingo,Regular Season,0-11,0,11,0,32,32,0,3-8,3,8,0,28,30,-2,Carolina Panthers,2
2011-11-27,Cincinnati Bengals,Cleveland Browns,23,20,2011,12,domingo,Regular Season,7-4,7,4,0,13,13,0,4-7,4,7,0,27,24,3,Cincinnati Bengals,11
2011-11-27,Atlanta Falcons,Minnesota Vikings,24,14,2011,12,domingo,Regular Season,7-4,7,4,0,9,11,-2,2-9,2,9,0,30,29,1,Atlanta Falcons,18
2011-11-24,Detroit Lions,Green Bay Packers,15,27,2011,12,quinta,Regular Season,7-4,7,4,0,11,10,1,11-0,11,0,0,1,1,0,Green Bay Packers,9
2011-11-24,Dallas Cowboys,Miami Dolphins,20,19,2011,12,quinta,Regular Season,7-4,7,4,0,8,9,-1,3-8,3,8,0,26,25,1,Dallas Cowboys,16
2011-11-24,Baltimore Ravens,San Francisco 49ers,16,6,2011,12,quinta,Regular Season,8-3,8,3,0,2,5,-3,9-2,9,2,0,3,2,1,Baltimore Ravens,3
2011-11-21,New England Patriots,Kansas City Chiefs,34,3,2011,11,segunda,Regular Season,7-3,7,3,0,6,8,-2,4-6,4,6,0,22,21,1,New England Patriots,13
2011-11-20,Washington Redskins,Dallas Cowboys,24,27,2011,11,domingo,Regular Season,3-7,3,7,0,26,26,0,6-4,6,4,0,9,12,-3,Dallas Cowboys,14
2011-11-20,Los Angeles Rams,Seattle Seahawks,7,24,2011,11,domingo,Regular Season,2-8,2,8,0,31,30,1,4-6,4,6,0,23,24,-1,Seattle Seahawks,6
2011-11-20,San Francisco 49ers,Arizona Cardinals,23,7,2011,11,domingo,Regular Season,9-1,9,1,0,2,2,0,3-7,3,7,0,27,23,4,San Francisco 49ers,21
2011-11-20,New York Giants,Philadelphia Eagles,10,17,2011,11,domingo,Regular Season,6-4,6,4,0,12,7,5,4-6,4,6,0,18,22,-4,Philadelphia Eagles,15
2011-11-20,Minnesota Vikings,Oakland Raiders,21,27,2011,11,domingo,Regular Season,2-8,2,8,0,29,27,2,6-4,6,4,0,14,16,-2,Oakland Raiders,11
2011-11-20,Miami Dolphins,Buffalo Bills,35,8,2011,11,domingo,Regular Season,3-7,3,7,0,25,29,-4,5-5,5,5,0,19,17,2,Miami Dolphins,12
2011-11-20,Green Bay Packers,Tampa Bay Buccaneers,35,26,2011,11,domingo,Regular Season,10-0,10,0,0,1,1,0,4-6,4,6,0,20,20,0,Green Bay Packers,19
2011-11-20,Detroit Lions,Carolina Panthers,49,35,2011,11,domingo,Regular Season,7-3,7,3,0,10,10,0,2-8,2,8,0,30,31,-1,Detroit Lions,21
2011-11-20,Cleveland Browns,Jacksonville Jaguars,14,10,2011,11,domingo,Regular Season,4-6,4,6,0,24,28,-4,3-7,3,7,0,28,25,3,Cleveland Browns,3
2011-11-20,Chicago Bears,Los Angeles Chargers,31,20,2011,11,domingo,Regular Season,7-3,7,3,0,7,5,2,4-6,4,6,0,21,18,3,Chicago Bears,13
2011-11-20,Baltimore Ravens,Cincinnati Bengals,31,24,2011,11,domingo,Regular Season,7-3,7,3,0,5,6,-1,6-4,6,4,0,13,11,2,Baltimore Ravens,5
2011-11-20,Atlanta Falcons,Tennessee Titans,23,17,2011,11,domingo,Regular Season,6-4,6,4,0,11,13,-2,5-5,5,5,0,16,15,1,Atlanta Falcons,2
2011-11-17,Denver Broncos,New York Jets,17,13,2011,11,quinta,Regular Season,5-5,5,5,0,17,19,-2,5-5,5,5,0,15,14,1,Denver Broncos,5
2011-11-14,Green Bay Packers,Minnesota Vikings,45,7,2011,10,segunda,Regular Season,9-0,9,0,0,1,1,0,2-7,2,7,0,27,24,3,Green Bay Packers,23
2011-11-13,Tampa Bay Buccaneers,Houston Texans,9,37,2011,10,domingo,Regular Season,4-5,4,5,0,20,18,2,7-3,7,3,0,9,8,1,Houston Texans,10
2011-11-13,Seattle Seahawks,Baltimore Ravens,22,17,2011,10,domingo,Regular Season,3-6,3,6,0,24,28,-4,6-3,6,3,0,6,3,3,Seattle Seahawks,25
2011-11-13,San Francisco 49ers,New York Giants,27,20,2011,10,domingo,Regular Season,8-1,8,1,0,2,2,0,6-3,6,3,0,7,6,1,San Francisco 49ers,4
2011-11-13,Philadelphia Eagles,Arizona Cardinals,17,21,2011,10,domingo,Regular Season,3-6,3,6,0,22,16,6,3-6,3,6,0,23,29,-6,Arizona Cardinals,13
2011-11-13,New York Jets,New England Patriots,16,37,2011,10,domingo,Regular Season,5-4,5,4,0,14,11,3,6-3,6,3,0,8,12,-4,New England Patriots,1
2011-11-13,Miami Dolphins,Washington Redskins,20,9,2011,10,domingo,Regular Season,2-7,2,7,0,29,31,-2,3-6,3,6,0,26,22,4,Miami Dolphins,9
2011-11-13,Kansas City Chiefs,Denver Broncos,10,17,2011,10,domingo,Regular Season,4-5,4,5,0,21,19,2,4-5,4,5,0,19,23,-4,Denver Broncos,4
2011-11-13,Indianapolis Colts,Jacksonville Jaguars,3,17,2011,10,domingo,Regular Season,0-10,0,10,0,32,32,0,3-6,3,6,0,25,27,-2,Jacksonville Jaguars,5
2011-11-13,Dallas Cowboys,Buffalo Bills,44,7,2011,10,domingo,Regular Season,5-4,5,4,0,12,15,-3,5-4,5,4,0,17,14,3,Dallas Cowboys,1
2011-11-13,Cleveland Browns,Los Angeles Rams,12,13,2011,10,domingo,Regular Season,3-6,3,6,0,28,25,3,2-7,2,7,0,30,30,0,Los Angeles Rams,5
2011-11-13,Cincinnati Bengals,Pittsburgh Steelers,17,24,2011,10,domingo,Regular Season,6-3,6,3,0,11,10,1,7-3,7,3,0,4,5,-1,Pittsburgh Steelers,5
2011-11-13,Chicago Bears,Detroit Lions,37,13,2011,10,domingo,Regular Season,6-3,6,3,0,5,9,-4,6-3,6,3,0,10,7,3,Chicago Bears,2
2011-11-13,Carolina Panthers,Tennessee Titans,3,30,2011,10,domingo,Regular Season,2-7,2,7,0,31,26,5,5-4,5,4,0,15,20,-5,Tennessee Titans,6
2011-11-13,Atlanta Falcons,New Orleans Saints,23,26,2011,10,domingo,Regular Season,5-4,5,4,0,13,13,0,7-3,7,3,0,3,4,-1,New Orleans Saints,9
2011-11-10,Los Angeles Chargers,Oakland Raiders,17,24,2011,10,quinta,Regular Season,4-5,4,5,0,18,17,1,5-4,5,4,0,16,21,-5,Oakland Raiders,4
2011-11-07,Philadelphia Eagles,Chicago Bears,24,30,2011,9,segunda,Regular Season,3-5,3,5,0,16,16,0,5-3,5,3,0,9,10,-1,Chicago Bears,6
2011-11-06,Washington Redskins,San Francisco 49ers,11,19,2011,9,domingo,Regular Season,3-5,3,5,0,22,22,0,7-1,7,1,0,2,2,0,San Francisco 49ers,20
2011-11-06,Tennessee Titans,Cincinnati Bengals,17,24,2011,9,domingo,Regular Season,4-4,4,4,0,20,20,0,6-2,6,2,0,10,14,-4,Cincinnati Bengals,6
2011-11-06,Los Angeles Chargers,Green Bay Packers,38,45,2011,9,domingo,Regular Season,4-4,4,4,0,17,15,2,8-0,8,0,0,1,1,0,Green Bay Packers,14
2011-11-06,Pittsburgh Steelers,Baltimore Ravens,20,23,2011,9,domingo,Regular Season,6-3,6,3,0,5,3,2,6-2,6,2,0,3,4,-1,Baltimore Ravens,1
2011-11-06,Oakland Raiders,Denver Broncos,24,38,2011,9,domingo,Regular Season,4-4,4,4,0,21,17,4,3-5,3,5,0,23,28,-5,Denver Broncos,11
2011-11-06,New Orleans Saints,Tampa Bay Buccaneers,27,16,2011,9,domingo,Regular Season,6-3,6,3,0,4,6,-2,4-4,4,4,0,18,19,-1,New Orleans Saints,13
2011-11-06,New England Patriots,New York Giants,20,24,2011,9,domingo,Regular Season,5-3,5,3,0,12,5,7,6-2,6,2,0,6,9,-3,New York Giants,4
2011-11-06,Kansas City Chiefs,Miami Dolphins,3,31,2011,9,domingo,Regular Season,4-4,4,4,0,19,18,1,1-7,1,7,0,31,31,0,Miami Dolphins,13
2011-11-06,Indianapolis Colts,Atlanta Falcons,7,31,2011,9,domingo,Regular Season,0-9,0,9,0,32,32,0,5-3,5,3,0,13,12,1,Atlanta Falcons,20
2011-11-06,Houston Texans,Cleveland Browns,30,12,2011,9,domingo,Regular Season,6-3,6,3,0,8,11,-3,3-5,3,5,0,25,24,1,Houston Texans,13
2011-11-06,Dallas Cowboys,Seattle Seahawks,23,13,2011,9,domingo,Regular Season,4-4,4,4,0,15,21,-6,2-6,2,6,0,28,27,1,Dallas Cowboys,6
2011-11-06,Buffalo Bills,New York Jets,11,27,2011,9,domingo,Regular Season,5-3,5,3,0,14,7,7,5-3,5,3,0,11,13,-2,New York Jets,6
2011-11-06,Arizona Cardinals,Los Angeles Rams,19,13,2011,9,domingo,Regular Season,2-6,2,6,0,29,30,-1,1-7,1,7,0,30,29,1,Arizona Cardinals,1
2011-10-31,Kansas City Chiefs,Los Angeles Chargers,23,20,2011,8,segunda,Regular Season,4-3,4,3,0,18,21,-3,4-3,4,3,0,15,9,6,Kansas City Chiefs,12
2011-10-30,Tennessee Titans,Indianapolis Colts,27,10,2011,8,domingo,Regular Season,4-3,4,3,0,20,19,1,0-8,0,8,0,32,32,0,Tennessee Titans,13
2011-10-30,Los Angeles Rams,New Orleans Saints,31,21,2011,8,domingo,Regular Season,1-6,1,6,0,29,30,-1,5-3,5,3,0,6,3,3,Los Angeles Rams,27
2011-10-30,Seattle Seahawks,Cincinnati Bengals,12,34,2011,8,domingo,Regular Season,2-5,2,5,0,27,26,1,5-2,5,2,0,14,16,-2,Cincinnati Bengals,10
2011-10-30,San Francisco 49ers,Cleveland Browns,20,10,2011,8,domingo,Regular Season,6-1,6,1,0,2,4,-2,3-4,3,4,0,24,24,0,San Francisco 49ers,20
2011-10-30,Pittsburgh Steelers,New England Patriots,25,17,2011,8,domingo,Regular Season,6-2,6,2,0,3,5,-2,5-2,5,2,0,5,2,3,Pittsburgh Steelers,3
2011-10-30,Philadelphia Eagles,Dallas Cowboys,34,7,2011,8,domingo,Regular Season,3-4,3,4,0,16,22,-6,3-4,3,4,0,21,18,3,Philadelphia Eagles,4
2011-10-30,New York Giants,Miami Dolphins,20,17,2011,8,domingo,Regular Season,5-2,5,2,0,9,11,-2,0-7,0,7,0,31,31,0,New York Giants,20
2011-10-30,Houston Texans,Jacksonville Jaguars,24,14,2011,8,domingo,Regular Season,5-3,5,3,0,11,12,-1,2-6,2,6,0,26,25,1,Houston Texans,13
2011-10-30,Denver Broncos,Detroit Lions,10,45,2011,8,domingo,Regular Season,2-5,2,5,0,28,27,1,6-2,6,2,0,8,8,0,Detroit Lions,19
2011-10-30,Carolina Panthers,Minnesota Vikings,21,24,2011,8,domingo,Regular Season,2-6,2,6,0,25,23,2,2-6,2,6,0,23,28,-5,Minnesota Vikings,5
2011-10-30,Buffalo Bills,Washington Redskins,23,0,2011,8,domingo,Regular Season,5-2,5,2,0,7,7,0,3-4,3,4,0,22,20,2,Buffalo Bills,13
2011-10-30,Baltimore Ravens,Arizona Cardinals,30,27,2011,8,domingo,Regular Season,5-2,5,2,0,4,6,-2,1-6,1,6,0,30,29,1,Baltimore Ravens,23
2011-10-24,Jacksonville Jaguars,Baltimore Ravens,12,7,2011,7,segunda,Regular Season,2-5,2,5,0,25,29,-4,4-2,4,2,0,6,3,3,Jacksonville Jaguars,26
2011-10-23,Tennessee Titans,Houston Texans,7,41,2011,7,domingo,Regular Season,3-3,3,3,0,19,13,6,4-3,4,3,0,12,17,-5,Houston Texans,4
2011-10-23,Tampa Bay Buccaneers,Chicago Bears,18,24,2011,7,domingo,Regular Season,4-3,4,3,0,17,12,5,4-3,4,3,0,10,14,-4,Chicago Bears,2
2011-10-23,Oakland Raiders,Kansas City Chiefs,0,28,2011,7,domingo,Regular Season,4-3,4,3,0,15,9,6,3-3,3,3,0,21,24,-3,Kansas City Chiefs,15
2011-10-23,New York Jets,Los Angeles Chargers,27,21,2011,7,domingo,Regular Season,4-3,4,3,0,13,16,-3,4-2,4,2,0,9,7,2,New York Jets,9
2011-10-23,New Orleans Saints,Indianapolis Colts,62,7,2011,7,domingo,Regular Season,5-2,5,2,0,3,5,-2,0-7,0,7,0,32,32,0,New Orleans Saints,27
2011-10-23,Minnesota Vikings,Green Bay Packers,27,33,2011,7,domingo,Regular Season,1-6,1,6,0,28,28,0,7-0,7,0,0,1,1,0,Green Bay Packers,27
2011-10-23,Miami Dolphins,Denver Broncos,15,18,2011,7,domingo,Regular Season,0-6,0,6,0,31,30,1,2-4,2,4,0,27,27,0,Denver Broncos,3
2011-10-23,Detroit Lions,Atlanta Falcons,16,23,2011,7,domingo,Regular Season,5-2,5,2,0,8,6,2,4-3,4,3,0,14,19,-5,Atlanta Falcons,13
2011-10-23,Dallas Cowboys,Los Angeles Rams,34,7,2011,7,domingo,Regular Season,3-3,3,3,0,18,21,-3,0-6,0,6,0,30,31,-1,Dallas Cowboys,10
2011-10-23,Cleveland Browns,Seattle Seahawks,6,3,2011,7,domingo,Regular Season,3-3,3,3,0,24,23,1,2-4,2,4,0,26,22,4,Cleveland Browns,1
2011-10-23,Carolina Panthers,Washington Redskins,33,20,2011,7,domingo,Regular Season,2-5,2,5,0,23,25,-2,3-3,3,3,0,20,15,5,Carolina Panthers,10
2011-10-23,Arizona Cardinals,Pittsburgh Steelers,20,32,2011,7,domingo,Regular Season,1-5,1,5,0,29,26,3,5-2,5,2,0,5,8,-3,Pittsburgh Steelers,18
2011-10-17,New York Jets,Miami Dolphins,24,6,2011,6,segunda,Regular Season,3-3,3,3,0,16,17,-1,0-5,0,5,0,30,30,0,New York Jets,13
2011-10-16,Washington Redskins,Philadelphia Eagles,13,20,2011,6,domingo,Regular Season,3-2,3,2,0,15,10,5,2-4,2,4,0,20,21,-1,Philadelphia Eagles,11
2011-10-16,Tampa Bay Buccaneers,New Orleans Saints,26,20,2011,6,domingo,Regular Season,4-2,4,2,0,12,16,-4,4-2,4,2,0,5,3,2,Tampa Bay Buccaneers,13
2011-10-16,Pittsburgh Steelers,Jacksonville Jaguars,17,13,2011,6,domingo,Regular Season,4-2,4,2,0,8,8,0,1-5,1,5,0,29,29,0,Pittsburgh Steelers,21
2011-10-16,Oakland Raiders,Cleveland Browns,24,17,2011,6,domingo,Regular Season,4-2,4,2,0,9,11,-2,2-3,2,3,0,23,23,0,Oakland Raiders,12
2011-10-16,New York Giants,Buffalo Bills,27,24,2011,6,domingo,Regular Season,4-2,4,2,0,11,14,-3,4-2,4,2,0,10,6,4,New York Giants,8
2011-10-16,New England Patriots,Dallas Cowboys,20,16,2011,6,domingo,Regular Season,5-1,5,1,0,2,2,0,2-3,2,3,0,21,15,6,New England Patriots,13
2011-10-16,Green Bay Packers,Los Angeles Rams,24,3,2011,6,domingo,Regular Season,6-0,6,0,0,1,1,0,0-5,0,5,0,31,31,0,Green Bay Packers,30
2011-10-16,Detroit Lions,San Francisco 49ers,19,25,2011,6,domingo,Regular Season,5-1,5,1,0,6,4,2,5-1,5,1,0,4,9,-5,San Francisco 49ers,5
2011-10-16,Cincinnati Bengals,Indianapolis Colts,27,17,2011,6,domingo,Regular Season,4-2,4,2,0,18,20,-2,0-6,0,6,0,32,32,0,Cincinnati Bengals,12
2011-10-16,Chicago Bears,Minnesota Vikings,39,10,2011,6,domingo,Regular Season,3-3,3,3,0,14,18,-4,1-5,1,5,0,28,26,2,Chicago Bears,8
2011-10-16,Baltimore Ravens,Houston Texans,29,14,2011,6,domingo,Regular Season,4-1,4,1,0,3,5,-2,3-3,3,3,0,17,12,5,Baltimore Ravens,7
2011-10-16,Atlanta Falcons,Carolina Panthers,31,17,2011,6,domingo,Regular Season,3-3,3,3,0,19,19,0,1-5,1,5,0,25,24,1,Atlanta Falcons,5
2011-10-10,Detroit Lions,Chicago Bears,24,13,2011,5,segunda,Regular Season,5-0,5,0,0,4,4,0,2-3,2,3,0,18,18,0,Detroit Lions,14
2011-10-09,San Francisco 49ers,Tampa Bay Buccaneers,48,3,2011,5,domingo,Regular Season,4-1,4,1,0,9,16,-7,3-2,3,2,0,16,11,5,San Francisco 49ers,5
2011-10-09,Pittsburgh Steelers,Tennessee Titans,38,17,2011,5,domingo,Regular Season,3-2,3,2,0,8,13,-5,3-2,3,2,0,13,8,5,Pittsburgh Steelers,5
2011-10-09,New York Giants,Seattle Seahawks,25,36,2011,5,domingo,Regular Season,3-2,3,2,0,14,10,4,2-3,2,3,0,22,25,-3,Seattle Seahawks,15
2011-10-09,New England Patriots,New York Jets,30,21,2011,5,domingo,Regular Season,4-1,4,1,0,2,3,-1,2-3,2,3,0,17,14,3,New England Patriots,11
2011-10-09,Minnesota Vikings,Arizona Cardinals,34,10,2011,5,domingo,Regular Season,1-4,1,4,0,26,30,-4,1-4,1,4,0,28,23,5,Minnesota Vikings,7
2011-10-09,Jacksonville Jaguars,Cincinnati Bengals,20,30,2011,5,domingo,Regular Season,1-4,1,4,0,29,26,3,3-2,3,2,0,20,21,-1,Cincinnati Bengals,5
2011-10-09,Indianapolis Colts,Kansas City Chiefs,24,28,2011,5,domingo,Regular Season,0-5,0,5,0,32,29,3,2-3,2,3,0,25,28,-3,Kansas City Chiefs,1
2011-10-09,Houston Texans,Oakland Raiders,20,25,2011,5,domingo,Regular Season,3-2,3,2,0,12,6,6,3-2,3,2,0,11,15,-4,Oakland Raiders,9
2011-10-09,Denver Broncos,Los Angeles Chargers,24,29,2011,5,domingo,Regular Season,1-4,1,4,0,27,27,0,4-1,4,1,0,7,7,0,Los Angeles Chargers,20
2011-10-09,Carolina Panthers,New Orleans Saints,27,30,2011,5,domingo,Regular Season,1-4,1,4,0,24,24,0,4-1,4,1,0,3,2,1,New Orleans Saints,22
2011-10-09,Buffalo Bills,Philadelphia Eagles,31,24,2011,5,domingo,Regular Season,4-1,4,1,0,6,9,-3,1-4,1,4,0,21,20,1,Buffalo Bills,11
2011-10-09,Atlanta Falcons,Green Bay Packers,14,25,2011,5,domingo,Regular Season,2-3,2,3,0,19,19,0,5-0,5,0,0,1,1,0,Green Bay Packers,18
2011-10-03,Tampa Bay Buccaneers,Indianapolis Colts,24,17,2011,4,segunda,Regular Season,3-1,3,1,0,11,14,-3,0-4,0,4,0,29,30,-1,Tampa Bay Buccaneers,16
2011-10-02,Los Angeles Rams,Washington Redskins,10,17,2011,4,domingo,Regular Season,0-4,0,4,0,32,31,1,3-1,3,1,0,12,16,-4,Washington Redskins,15
2011-10-02,Seattle Seahawks,Atlanta Falcons,28,30,2011,4,domingo,Regular Season,1-3,1,3,0,25,24,1,2-2,2,2,0,19,19,0,Atlanta Falcons,5
2011-10-02,Los Angeles Chargers,Miami Dolphins,26,16,2011,4,domingo,Regular Season,3-1,3,1,0,7,9,-2,0-4,0,4,0,31,29,2,Los Angeles Chargers,20
2011-10-02,Philadelphia Eagles,San Francisco 49ers,23,24,2011,4,domingo,Regular Season,1-3,1,3,0,20,17,3,3-1,3,1,0,16,20,-4,San Francisco 49ers,3
2011-10-02,Oakland Raiders,New England Patriots,19,31,2011,4,domingo,Regular Season,2-2,2,2,0,15,13,2,3-1,3,1,0,3,3,0,New England Patriots,10
2011-10-02,Kansas City Chiefs,Minnesota Vikings,22,17,2011,4,domingo,Regular Season,1-3,1,3,0,28,32,-4,0-4,0,4,0,30,28,2,Kansas City Chiefs,4
2011-10-02,Jacksonville Jaguars,New Orleans Saints,10,23,2011,4,domingo,Regular Season,1-3,1,3,0,26,25,1,3-1,3,1,0,2,2,0,New Orleans Saints,23
2011-10-02,Houston Texans,Pittsburgh Steelers,17,10,2011,4,domingo,Regular Season,3-1,3,1,0,6,8,-2,2-2,2,2,0,13,10,3,Houston Texans,2
2011-10-02,Green Bay Packers,Denver Broncos,49,23,2011,4,domingo,Regular Season,4-0,4,0,0,1,1,0,1-3,1,3,0,27,26,1,Green Bay Packers,25
2011-10-02,Dallas Cowboys,Detroit Lions,30,34,2011,4,domingo,Regular Season,2-2,2,2,0,17,11,6,4-0,4,0,0,4,4,0,Detroit Lions,7
2011-10-02,Cleveland Browns,Tennessee Titans,13,31,2011,4,domingo,Regular Season,2-2,2,2,0,22,21,1,3-1,3,1,0,8,15,-7,Tennessee Titans,6
2011-10-02,Cincinnati Bengals,Buffalo Bills,23,20,2011,4,domingo,Regular Season,2-2,2,2,0,21,27,-6,3-1,3,1,0,9,6,3,Cincinnati Bengals,21
2011-10-02,Chicago Bears,Carolina Panthers,34,29,2011,4,domingo,Regular Season,2-2,2,2,0,18,18,0,1-3,1,3,0,24,22,2,Chicago Bears,4
2011-10-02,Baltimore Ravens,New York Jets,34,17,2011,4,domingo,Regular Season,3-1,3,1,0,5,5,0,2-2,2,2,0,14,7,7,Baltimore Ravens,2
2011-10-02,Arizona Cardinals,New York Giants,27,31,2011,4,domingo,Regular Season,1-3,1,3,0,23,23,0,3-1,3,1,0,10,12,-2,New York Giants,11
2011-09-26,Dallas Cowboys,Washington Redskins,18,16,2011,3,segunda,Regular Season,2-1,2,1,0,11,13,-2,2-1,2,1,0,16,15,1,Dallas Cowboys,2
2011-09-25,Tennessee Titans,Denver Broncos,17,14,2011,3,domingo,Regular Season,2-1,2,1,0,15,17,-2,1-2,1,2,0,26,24,2,Tennessee Titans,7
2011-09-25,Tampa Bay Buccaneers,Atlanta Falcons,16,13,2011,3,domingo,Regular Season,2-1,2,1,0,14,14,0,1-2,1,2,0,19,8,11,Tampa Bay Buccaneers,6
2011-09-25,Los Angeles Rams,Baltimore Ravens,7,37,2011,3,domingo,Regular Season,0-3,0,3,0,31,22,9,2-1,2,1,0,5,7,-2,Baltimore Ravens,15
2011-09-25,Seattle Seahawks,Arizona Cardinals,13,10,2011,3,domingo,Regular Season,1-2,1,2,0,24,32,-8,1-2,1,2,0,23,19,4,Seattle Seahawks,13
2011-09-25,Los Angeles Chargers,Kansas City Chiefs,20,17,2011,3,domingo,Regular Season,2-1,2,1,0,9,12,-3,0-3,0,3,0,32,31,1,Los Angeles Chargers,19
2011-09-25,Philadelphia Eagles,New York Giants,16,29,2011,3,domingo,Regular Season,1-2,1,2,0,17,6,11,2-1,2,1,0,12,18,-6,New York Giants,12
2011-09-25,Oakland Raiders,New York Jets,34,24,2011,3,domingo,Regular Season,2-1,2,1,0,13,20,-7,2-1,2,1,0,7,3,4,Oakland Raiders,17
2011-09-25,New Orleans Saints,Houston Texans,40,33,2011,3,domingo,Regular Season,2-1,2,1,0,2,4,-2,2-1,2,1,0,8,5,3,New Orleans Saints,1
2011-09-25,Minnesota Vikings,Detroit Lions,23,26,2011,3,domingo,Regular Season,0-3,0,3,0,28,26,2,3-0,3,0,0,4,11,-7,Detroit Lions,15
2011-09-25,Indianapolis Colts,Pittsburgh Steelers,20,23,2011,3,domingo,Regular Season,0-3,0,3,0,30,30,0,2-1,2,1,0,10,9,1,Pittsburgh Steelers,21
2011-09-25,Cleveland Browns,Miami Dolphins,17,16,2011,3,domingo,Regular Season,2-1,2,1,0,21,29,-8,0-3,0,3,0,29,25,4,Cleveland Browns,4
2011-09-25,Cincinnati Bengals,San Francisco 49ers,8,13,2011,3,domingo,Regular Season,1-2,1,2,0,27,28,-1,2-1,2,1,0,20,23,-3,San Francisco 49ers,5
2011-09-25,Chicago Bears,Green Bay Packers,17,27,2011,3,domingo,Regular Season,1-2,1,2,0,18,10,8,3-0,3,0,0,1,1,0,Green Bay Packers,9
2011-09-25,Carolina Panthers,Jacksonville Jaguars,16,10,2011,3,domingo,Regular Season,1-2,1,2,0,22,27,-5,1-2,1,2,0,25,21,4,Carolina Panthers,6
2011-09-25,Buffalo Bills,New England Patriots,34,31,2011,3,domingo,Regular Season,3-0,3,0,0,6,16,-10,2-1,2,1,0,3,2,1,Buffalo Bills,14
2011-09-19,New York Giants,Los Angeles Rams,28,16,2011,2,segunda,Regular Season,1-1,1,1,0,18,17,1,0-2,0,2,0,22,20,2,New York Giants,3
2011-09-18,Washington Redskins,Arizona Cardinals,22,21,2011,2,domingo,Regular Season,2-0,2,0,0,15,19,-4,1-1,1,1,0,19,16,3,Washington Redskins,3
2011-09-18,Tennessee Titans,Baltimore Ravens,26,13,2011,2,domingo,Regular Season,1-1,1,1,0,17,25,-8,1-1,1,1,0,7,4,3,Tennessee Titans,21
2011-09-18,San Francisco 49ers,Dallas Cowboys,24,27,2011,2,domingo,Regular Season,1-1,1,1,0,23,22,1,1-1,1,1,0,13,13,0,Dallas Cowboys,9
2011-09-18,Pittsburgh Steelers,Seattle Seahawks,24,0,2011,2,domingo,Regular Season,1-1,1,1,0,9,8,1,0-2,0,2,0,32,31,1,Pittsburgh Steelers,23
2011-09-18,New York Jets,Jacksonville Jaguars,32,3,2011,2,domingo,Regular Season,2-0,2,0,0,3,5,-2,1-1,1,1,0,21,15,6,New York Jets,10
2011-09-18,New Orleans Saints,Chicago Bears,30,13,2011,2,domingo,Regular Season,1-1,1,1,0,4,6,-2,1-1,1,1,0,10,7,3,New Orleans Saints,1
2011-09-18,New England Patriots,Los Angeles Chargers,35,21,2011,2,domingo,Regular Season,2-0,2,0,0,2,2,0,1-1,1,1,0,12,9,3,New England Patriots,7
2011-09-18,Minnesota Vikings,Tampa Bay Buccaneers,20,24,2011,2,domingo,Regular Season,0-2,0,2,0,26,24,2,1-1,1,1,0,14,14,0,Tampa Bay Buccaneers,10
2011-09-18,Miami Dolphins,Houston Texans,13,23,2011,2,domingo,Regular Season,0-2,0,2,0,25,26,-1,2-0,2,0,0,5,10,-5,Houston Texans,16
2011-09-18,Indianapolis Colts,Cleveland Browns,19,27,2011,2,domingo,Regular Season,0-2,0,2,0,30,23,7,1-1,1,1,0,29,32,-3,Cleveland Browns,9
2011-09-18,Detroit Lions,Kansas City Chiefs,48,3,2011,2,domingo,Regular Season,2-0,2,0,0,11,12,-1,0-2,0,2,0,31,21,10,Detroit Lions,9
2011-09-18,Denver Broncos,Cincinnati Bengals,24,22,2011,2,domingo,Regular Season,1-1,1,1,0,24,28,-4,1-1,1,1,0,28,30,-2,Denver Broncos,2
2011-09-18,Carolina Panthers,Green Bay Packers,23,30,2011,2,domingo,Regular Season,0-2,0,2,0,27,29,-2,2-0,2,0,0,1,1,0,Green Bay Packers,28
2011-09-18,Buffalo Bills,Oakland Raiders,38,35,2011,2,domingo,Regular Season,2-0,2,0,0,16,27,-11,1-1,1,1,0,20,18,2,Buffalo Bills,9
2011-09-18,Atlanta Falcons,Philadelphia Eagles,35,31,2011,2,domingo,Regular Season,1-1,1,1,0,8,11,-3,1-1,1,1,0,6,3,3,Atlanta Falcons,8
2011-09-12,Miami Dolphins,New England Patriots,24,38,2011,1,segunda,Regular Season,0-1,0,1,0,26,24,2,1-0,1,0,0,2,2,0,New England Patriots,22
2011-09-12,Denver Broncos,Oakland Raiders,20,23,2011,1,segunda,Regular Season,0-1,0,1,0,28,27,1,1-0,1,0,0,18,22,-4,Oakland Raiders,5
2011-09-11,Washington Redskins,New York Giants,28,14,2011,1,domingo,Regular Season,1-0,1,0,0,19,28,-9,0-1,0,1,0,17,15,2,Washington Redskins,13
2011-09-11,Tampa Bay Buccaneers,Detroit Lions,20,27,2011,1,domingo,Regular Season,0-1,0,1,0,14,12,2,1-0,1,0,0,12,16,-4,Detroit Lions,4
2011-09-11,Los Angeles Rams,Philadelphia Eagles,13,31,2011,1,domingo,Regular Season,0-1,0,1,0,20,17,3,1-0,1,0,0,3,4,-1,Philadelphia Eagles,13
2011-09-11,San Francisco 49ers,Seattle Seahawks,33,17,2011,1,domingo,Regular Season,1-0,1,0,0,22,26,-4,0-1,0,1,0,31,25,6,San Francisco 49ers,1
2011-09-11,Los Angeles Chargers,Minnesota Vikings,24,17,2011,1,domingo,Regular Season,1-0,1,0,0,9,10,-1,0-1,0,1,0,24,20,4,Los Angeles Chargers,10
2011-09-11,New York Jets,Dallas Cowboys,27,24,2011,1,domingo,Regular Season,1-0,1,0,0,5,7,-2,0-1,0,1,0,13,14,-1,New York Jets,7
2011-09-11,Kansas City Chiefs,Buffalo Bills,7,41,2011,1,domingo,Regular Season,0-1,0,1,0,21,18,3,1-0,1,0,0,27,30,-3,Buffalo Bills,12
2011-09-11,Jacksonville Jaguars,Tennessee Titans,16,14,2011,1,domingo,Regular Season,1-0,1,0,0,15,19,-4,0-1,0,1,0,25,23,2,Jacksonville Jaguars,4
2011-09-11,Houston Texans,Indianapolis Colts,34,7,2011,1,domingo,Regular Season,1-0,1,0,0,10,11,-1,0-1,0,1,0,23,9,14,Houston Texans,2
2011-09-11,Cleveland Browns,Cincinnati Bengals,17,27,2011,1,domingo,Regular Season,0-1,0,1,0,32,29,3,1-0,1,0,0,30,32,-2,Cincinnati Bengals,3
2011-09-11,Chicago Bears,Atlanta Falcons,30,12,2011,1,domingo,Regular Season,1-0,1,0,0,7,13,-6,0-1,0,1,0,11,6,5,Chicago Bears,7
2011-09-11,Baltimore Ravens,Pittsburgh Steelers,35,7,2011,1,domingo,Regular Season,1-0,1,0,0,4,8,-4,0-1,0,1,0,8,3,5,Baltimore Ravens,5
2011-09-11,Arizona Cardinals,Carolina Panthers,28,21,2011,1,domingo,Regular Season,1-0,1,0,0,16,21,-5,0-1,0,1,0,29,31,-2,Arizona Cardinals,10
2011-09-08,Green Bay Packers,New Orleans Saints,42,34,2011,1,quinta,Regular Season,1-0,1,0,0,1,1,0,0-1,0,1,0,6,5,1,Green Bay Packers,4
2011-01-02,Washington Redskins,New York Giants,14,17,2010,17,domingo,Regular Season,6-10,6,10,0,26,21,5,10-6,10,6,0,12,12,0,New York Giants,9
2011-01-02,Seattle Seahawks,Los Angeles Rams,16,6,2010,17,domingo,Regular Season,7-9,7,9,0,19,26,-7,7-9,7,9,0,17,16,1,Seattle Seahawks,10
2011-01-02,San Francisco 49ers,Arizona Cardinals,38,7,2010,17,domingo,Regular Season,6-10,6,10,0,25,27,-2,5-11,5,11,0,28,29,-1,San Francisco 49ers,2
2011-01-02,Philadelphia Eagles,Dallas Cowboys,13,14,2010,17,domingo,Regular Season,10-6,10,6,0,7,7,0,6-10,6,10,0,18,22,-4,Dallas Cowboys,15
2011-01-02,New York Jets,Buffalo Bills,38,7,2010,17,domingo,Regular Season,11-5,11,5,0,8,8,0,4-12,4,12,0,30,28,2,New York Jets,20
2011-01-02,New Orleans Saints,Tampa Bay Buccaneers,13,23,2010,17,domingo,Regular Season,11-5,11,5,0,5,4,1,10-6,10,6,0,13,13,0,Tampa Bay Buccaneers,9
2011-01-02,New England Patriots,Miami Dolphins,38,7,2010,17,domingo,Regular Season,14-2,14,2,0,1,1,0,7-9,7,9,0,22,18,4,New England Patriots,17
2011-01-02,Kansas City Chiefs,Oakland Raiders,10,31,2010,17,domingo,Regular Season,10-6,10,6,0,11,11,0,8-8,8,8,0,15,17,-2,Oakland Raiders,6
2011-01-02,Indianapolis Colts,Tennessee Titans,23,20,2010,17,domingo,Regular Season,10-6,10,6,0,10,10,0,6-10,6,10,0,20,20,0,Indianapolis Colts,10
2011-01-02,Houston Texans,Jacksonville Jaguars,34,17,2010,17,domingo,Regular Season,6-10,6,10,0,21,23,-2,8-8,8,8,0,16,15,1,Houston Texans,8
2011-01-02,Green Bay Packers,Chicago Bears,10,3,2010,17,domingo,Regular Season,10-6,10,6,0,9,9,0,11-5,11,5,0,6,6,0,Green Bay Packers,3
2011-01-02,Detroit Lions,Minnesota Vikings,20,13,2010,17,domingo,Regular Season,6-10,6,10,0,24,24,0,6-10,6,10,0,23,19,4,Detroit Lions,5
2011-01-02,Denver Broncos,Los Angeles Chargers,28,33,2010,17,domingo,Regular Season,4-12,4,12,0,29,31,-2,9-7,9,7,0,14,14,0,Los Angeles Chargers,17
2011-01-02,Cleveland Browns,Pittsburgh Steelers,9,41,2010,17,domingo,Regular Season,5-11,5,11,0,27,25,2,12-4,12,4,0,3,5,-2,Pittsburgh Steelers,20
2011-01-02,Baltimore Ravens,Cincinnati Bengals,13,7,2010,17,domingo,Regular Season,12-4,12,4,0,4,3,1,4-12,4,12,0,31,30,1,Baltimore Ravens,27
2011-01-02,Atlanta Falcons,Carolina Panthers,31,10,2010,17,domingo,Regular Season,13-3,13,3,0,2,2,0,2-14,2,14,0,32,32,0,Atlanta Falcons,30
2010-12-28,Philadelphia Eagles,Minnesota Vikings,14,24,2010,16,terça,Regular Season,10-5,10,5,0,7,3,4,6-9,6,9,0,19,24,-5,Minnesota Vikings,21
2010-12-27,Atlanta Falcons,New Orleans Saints,14,17,2010,16,segunda,Regular Season,12-3,12,3,0,2,2,0,11-4,11,4,0,4,7,-3,New Orleans Saints,5
2010-12-26,Tampa Bay Buccaneers,Seattle Seahawks,38,15,2010,16,domingo,Regular Season,9-6,9,6,0,13,15,-2,6-9,6,9,0,26,23,3,Tampa Bay Buccaneers,8
2010-12-26,Los Angeles Rams,San Francisco 49ers,25,17,2010,16,domingo,Regular Season,7-8,7,8,0,16,20,-4,5-10,5,10,0,27,25,2,Los Angeles Rams,5
2010-12-26,Oakland Raiders,Indianapolis Colts,26,31,2010,16,domingo,Regular Season,7-8,7,8,0,17,16,1,9-6,9,6,0,10,13,-3,Indianapolis Colts,3
2010-12-26,Miami Dolphins,Detroit Lions,27,34,2010,16,domingo,Regular Season,7-8,7,8,0,18,17,1,5-10,5,10,0,24,28,-4,Detroit Lions,11
2010-12-26,Kansas City Chiefs,Tennessee Titans,34,14,2010,16,domingo,Regular Season,10-5,10,5,0,11,11,0,6-9,6,9,0,20,19,1,Kansas City Chiefs,8
2010-12-26,Jacksonville Jaguars,Washington Redskins,17,20,2010,16,domingo,Regular Season,8-7,8,7,0,15,14,1,6-9,6,9,0,21,26,-5,Washington Redskins,12
2010-12-26,Green Bay Packers,New York Giants,45,17,2010,16,domingo,Regular Season,9-6,9,6,0,9,12,-3,9-6,9,6,0,12,9,3,Green Bay Packers,3
2010-12-26,Denver Broncos,Houston Texans,24,23,2010,16,domingo,Regular Season,4-11,4,11,0,31,31,0,5-10,5,10,0,23,21,2,Denver Broncos,10
2010-12-26,Cleveland Browns,Baltimore Ravens,10,20,2010,16,domingo,Regular Season,5-10,5,10,0,25,22,3,11-4,11,4,0,3,4,-1,Baltimore Ravens,18
2010-12-26,Cincinnati Bengals,Los Angeles Chargers,34,20,2010,16,domingo,Regular Season,4-11,4,11,0,30,30,0,8-7,8,7,0,14,10,4,Cincinnati Bengals,20
2010-12-26,Chicago Bears,New York Jets,38,34,2010,16,domingo,Regular Season,11-4,11,4,0,6,8,-2,10-5,10,5,0,8,5,3,Chicago Bears,3
2010-12-26,Buffalo Bills,New England Patriots,3,34,2010,16,domingo,Regular Season,4-11,4,11,0,28,27,1,13-2,13,2,0,1,1,0,New England Patriots,26
2010-12-25,Arizona Cardinals,Dallas Cowboys,27,26,2010,16,sábado,Regular Season,5-10,5,10,0,29,29,0,5-10,5,10,0,22,18,4,Arizona Cardinals,11
2010-12-23,Pittsburgh Steelers,Carolina Panthers,27,3,2010,16,quinta,Regular Season,11-4,11,4,0,5,6,-1,2-13,2,13,0,32,32,0,Pittsburgh Steelers,26
2010-12-20,Minnesota Vikings,Chicago Bears,14,40,2010,15,segunda,Regular Season,5-9,5,9,0,24,26,-2,10-4,10,4,0,8,8,0,Chicago Bears,18
2010-12-19,Tennessee Titans,Houston Texans,31,17,2010,15,domingo,Regular Season,6-8,6,8,0,19,22,-3,5-9,5,9,0,21,19,2,Tennessee Titans,3
2010-12-19,Tampa Bay Buccaneers,Detroit Lions,20,23,2010,15,domingo,Regular Season,8-6,8,6,0,15,13,2,4-10,4,10,0,28,29,-1,Detroit Lions,16
2010-12-19,Los Angeles Rams,Kansas City Chiefs,13,27,2010,15,domingo,Regular Season,6-8,6,8,0,20,18,2,9-5,9,5,0,11,14,-3,Kansas City Chiefs,4
2010-12-19,Seattle Seahawks,Atlanta Falcons,18,34,2010,15,domingo,Regular Season,6-8,6,8,0,23,24,-1,12-2,12,2,0,2,2,0,Atlanta Falcons,22
2010-12-19,Pittsburgh Steelers,New York Jets,17,22,2010,15,domingo,Regular Season,10-4,10,4,0,6,3,3,10-4,10,4,0,5,9,-4,New York Jets,6
2010-12-19,Oakland Raiders,Denver Broncos,39,23,2010,15,domingo,Regular Season,7-7,7,7,0,16,17,-1,3-11,3,11,0,31,30,1,Oakland Raiders,13
2010-12-19,New York Giants,Philadelphia Eagles,31,38,2010,15,domingo,Regular Season,9-5,9,5,0,9,7,2,10-4,10,4,0,3,6,-3,Philadelphia Eagles,1
2010-12-19,New England Patriots,Green Bay Packers,31,27,2010,15,domingo,Regular Season,12-2,12,2,0,1,1,0,8-6,8,6,0,12,10,2,New England Patriots,9
2010-12-19,Miami Dolphins,Buffalo Bills,14,17,2010,15,domingo,Regular Season,7-7,7,7,0,17,16,1,4-10,4,10,0,27,28,-1,Buffalo Bills,12
2010-12-19,Indianapolis Colts,Jacksonville Jaguars,34,24,2010,15,domingo,Regular Season,8-6,8,6,0,13,15,-2,8-6,8,6,0,14,11,3,Indianapolis Colts,4
2010-12-19,Dallas Cowboys,Washington Redskins,33,30,2010,15,domingo,Regular Season,5-9,5,9,0,18,20,-2,5-9,5,9,0,26,25,1,Dallas Cowboys,5
2010-12-19,Cincinnati Bengals,Cleveland Browns,19,17,2010,15,domingo,Regular Season,3-11,3,11,0,30,31,-1,5-9,5,9,0,22,21,1,Cincinnati Bengals,10
2010-12-19,Carolina Panthers,Arizona Cardinals,19,12,2010,15,domingo,Regular Season,2-12,2,12,0,32,32,0,4-10,4,10,0,29,27,2,Carolina Panthers,5
2010-12-19,Baltimore Ravens,New Orleans Saints,30,24,2010,15,domingo,Regular Season,10-4,10,4,0,4,5,-1,10-4,10,4,0,7,4,3,Baltimore Ravens,1
2010-12-16,Los Angeles Chargers,San Francisco 49ers,34,7,2010,15,quinta,Regular Season,8-6,8,6,0,10,12,-2,5-9,5,9,0,25,23,2,Los Angeles Chargers,11
2010-12-13,Minnesota Vikings,New York Giants,3,21,2010,14,segunda,Regular Season,5-8,5,8,0,26,23,3,9-4,9,4,0,7,10,-3,New York Giants,13
2010-12-13,Houston Texans,Baltimore Ravens,28,34,2010,14,segunda,Regular Season,5-8,5,8,0,19,19,0,9-4,9,4,0,5,4,1,Baltimore Ravens,15
2010-12-12,Washington Redskins,Tampa Bay Buccaneers,16,17,2010,14,domingo,Regular Season,5-8,5,8,0,25,25,0,8-5,8,5,0,13,13,0,Tampa Bay Buccaneers,12
2010-12-12,San Francisco 49ers,Seattle Seahawks,40,21,2010,14,domingo,Regular Season,5-8,5,8,0,23,26,-3,6-7,6,7,0,24,20,4,San Francisco 49ers,6
2010-12-12,Los Angeles Chargers,Kansas City Chiefs,31,0,2010,14,domingo,Regular Season,7-6,7,6,0,12,14,-2,8-5,8,5,0,14,11,3,Los Angeles Chargers,3
2010-12-12,Pittsburgh Steelers,Cincinnati Bengals,23,7,2010,14,domingo,Regular Season,10-3,10,3,0,3,3,0,2-11,2,11,0,31,30,1,Pittsburgh Steelers,27
2010-12-12,New York Jets,Miami Dolphins,6,10,2010,14,domingo,Regular Season,9-4,9,4,0,9,6,3,7-6,7,6,0,16,18,-2,Miami Dolphins,12
2010-12-12,New Orleans Saints,Los Angeles Rams,31,13,2010,14,domingo,Regular Season,10-3,10,3,0,4,5,-1,6-7,6,7,0,18,17,1,New Orleans Saints,12
2010-12-12,Jacksonville Jaguars,Oakland Raiders,38,31,2010,14,domingo,Regular Season,8-5,8,5,0,11,12,-1,6-7,6,7,0,17,16,1,Jacksonville Jaguars,4
2010-12-12,Detroit Lions,Green Bay Packers,7,3,2010,14,domingo,Regular Season,3-10,3,10,0,29,31,-2,8-5,8,5,0,10,7,3,Detroit Lions,24
2010-12-12,Dallas Cowboys,Philadelphia Eagles,27,30,2010,14,domingo,Regular Season,4-9,4,9,0,20,24,-4,9-4,9,4,0,6,9,-3,Philadelphia Eagles,15
2010-12-12,Chicago Bears,New England Patriots,7,36,2010,14,domingo,Regular Season,9-4,9,4,0,8,8,0,11-2,11,2,0,1,2,-1,New England Patriots,6
2010-12-12,Carolina Panthers,Atlanta Falcons,10,31,2010,14,domingo,Regular Season,1-12,1,12,0,32,32,0,11-2,11,2,0,2,1,1,Atlanta Falcons,31
2010-12-12,Buffalo Bills,Cleveland Browns,13,6,2010,14,domingo,Regular Season,3-10,3,10,0,28,27,1,5-8,5,8,0,21,21,0,Buffalo Bills,6
2010-12-12,Arizona Cardinals,Denver Broncos,43,13,2010,14,domingo,Regular Season,4-9,4,9,0,27,29,-2,3-10,3,10,0,30,28,2,Arizona Cardinals,1
2010-12-09,Tennessee Titans,Indianapolis Colts,28,30,2010,14,quinta,Regular Season,5-8,5,8,0,22,22,0,7-6,7,6,0,15,15,0,Indianapolis Colts,7
2010-12-06,New England Patriots,New York Jets,45,3,2010,13,segunda,Regular Season,10-2,10,2,0,2,2,0,9-3,9,3,0,6,3,3,New England Patriots,1
2010-12-05,Tennessee Titans,Jacksonville Jaguars,6,17,2010,13,domingo,Regular Season,5-7,5,7,0,22,19,3,7-5,7,5,0,12,16,-4,Jacksonville Jaguars,3
2010-12-05,Tampa Bay Buccaneers,Atlanta Falcons,24,28,2010,13,domingo,Regular Season,7-5,7,5,0,13,13,0,10-2,10,2,0,1,1,0,Atlanta Falcons,12
2010-12-05,Seattle Seahawks,Carolina Panthers,31,14,2010,13,domingo,Regular Season,6-6,6,6,0,20,22,-2,1-11,1,11,0,32,32,0,Seattle Seahawks,10
2010-12-05,Los Angeles Chargers,Oakland Raiders,13,28,2010,13,domingo,Regular Season,6-6,6,6,0,14,11,3,6-6,6,6,0,16,20,-4,Oakland Raiders,9
2010-12-05,New York Giants,Washington Redskins,31,7,2010,13,domingo,Regular Season,8-4,8,4,0,10,10,0,5-7,5,7,0,25,21,4,New York Giants,11
2010-12-05,Minnesota Vikings,Buffalo Bills,38,14,2010,13,domingo,Regular Season,5-7,5,7,0,23,23,0,2-10,2,10,0,27,27,0,Minnesota Vikings,4
2010-12-05,Miami Dolphins,Cleveland Browns,10,13,2010,13,domingo,Regular Season,6-6,6,6,0,18,15,3,5-7,5,7,0,21,24,-3,Cleveland Browns,9
2010-12-05,Kansas City Chiefs,Denver Broncos,10,6,2010,13,domingo,Regular Season,8-4,8,4,0,11,12,-1,3-9,3,9,0,28,28,0,Kansas City Chiefs,16
2010-12-05,Indianapolis Colts,Dallas Cowboys,35,38,2010,13,domingo,Regular Season,6-6,6,6,0,15,14,1,4-8,4,8,0,24,26,-2,Dallas Cowboys,12
2010-12-05,Green Bay Packers,San Francisco 49ers,34,16,2010,13,domingo,Regular Season,8-4,8,4,0,7,8,-1,4-8,4,8,0,26,25,1,Green Bay Packers,17
2010-12-05,Detroit Lions,Chicago Bears,20,24,2010,13,domingo,Regular Season,2-10,2,10,0,31,31,0,9-3,9,3,0,8,7,1,Chicago Bears,24
2010-12-05,Cincinnati Bengals,New Orleans Saints,30,34,2010,13,domingo,Regular Season,2-10,2,10,0,30,30,0,9-3,9,3,0,5,6,-1,New Orleans Saints,24
2010-12-05,Baltimore Ravens,Pittsburgh Steelers,10,13,2010,13,domingo,Regular Season,8-4,8,4,0,4,4,0,9-3,9,3,0,3,5,-2,Pittsburgh Steelers,1
2010-12-05,Arizona Cardinals,Los Angeles Rams,6,19,2010,13,domingo,Regular Season,3-9,3,9,0,29,29,0,6-6,6,6,0,17,18,-1,Los Angeles Rams,11
2010-12-02,Philadelphia Eagles,Houston Texans,34,24,2010,13,quinta,Regular Season,8-4,8,4,0,9,9,0,5-7,5,7,0,19,17,2,Philadelphia Eagles,8
2010-11-29,Arizona Cardinals,San Francisco 49ers,6,27,2010,12,segunda,Regular Season,3-8,3,8,0,29,29,0,4-7,4,7,0,25,26,-1,San Francisco 49ers,3
2010-11-28,Washington Redskins,Minnesota Vikings,13,17,2010,12,domingo,Regular Season,5-6,5,6,0,21,18,3,4-7,4,7,0,23,25,-2,Minnesota Vikings,7
2010-11-28,Seattle Seahawks,Kansas City Chiefs,24,42,2010,12,domingo,Regular Season,5-6,5,6,0,22,21,1,7-4,7,4,0,12,13,-1,Kansas City Chiefs,8
2010-11-28,Oakland Raiders,Miami Dolphins,17,33,2010,12,domingo,Regular Season,5-6,5,6,0,20,16,4,6-5,6,5,0,15,19,-4,Miami Dolphins,3
2010-11-28,New York Giants,Jacksonville Jaguars,24,20,2010,12,domingo,Regular Season,7-4,7,4,0,10,10,0,6-5,6,5,0,16,15,1,New York Giants,5
2010-11-28,Indianapolis Colts,Los Angeles Chargers,14,36,2010,12,domingo,Regular Season,6-5,6,5,0,14,9,5,6-5,6,5,0,11,14,-3,Los Angeles Chargers,5
2010-11-28,Houston Texans,Tennessee Titans,20,0,2010,12,domingo,Regular Season,5-6,5,6,0,17,20,-3,5-6,5,6,0,19,17,2,Houston Texans,3
2010-11-28,Denver Broncos,Los Angeles Rams,33,36,2010,12,domingo,Regular Season,3-8,3,8,0,28,27,1,5-6,5,6,0,18,22,-4,Los Angeles Rams,5
2010-11-28,Cleveland Browns,Carolina Panthers,24,23,2010,12,domingo,Regular Season,4-7,4,7,0,24,23,1,1-10,1,10,0,32,32,0,Cleveland Browns,9
2010-11-28,Chicago Bears,Philadelphia Eagles,31,26,2010,12,domingo,Regular Season,8-3,8,3,0,7,12,-5,7-4,7,4,0,9,6,3,Chicago Bears,6
2010-11-28,Buffalo Bills,Pittsburgh Steelers,16,19,2010,12,domingo,Regular Season,2-9,2,9,0,27,28,-1,8-3,8,3,0,5,5,0,Pittsburgh Steelers,23
2010-11-28,Baltimore Ravens,Tampa Bay Buccaneers,17,10,2010,12,domingo,Regular Season,8-3,8,3,0,4,3,1,7-4,7,4,0,13,11,2,Baltimore Ravens,8
2010-11-28,Atlanta Falcons,Green Bay Packers,20,17,2010,12,domingo,Regular Season,9-2,9,2,0,1,1,0,7-4,7,4,0,8,7,1,Atlanta Falcons,6
2010-11-25,New York Jets,Cincinnati Bengals,26,10,2010,12,quinta,Regular Season,9-2,9,2,0,3,4,-1,2-9,2,9,0,30,30,0,New York Jets,26
2010-11-25,Detroit Lions,New England Patriots,24,45,2010,12,quinta,Regular Season,2-9,2,9,0,31,31,0,9-2,9,2,0,2,2,0,New England Patriots,29
2010-11-25,Dallas Cowboys,New Orleans Saints,27,30,2010,12,quinta,Regular Season,3-8,3,8,0,26,24,2,8-3,8,3,0,6,8,-2,New Orleans Saints,16
2010-11-22,Los Angeles Chargers,Denver Broncos,35,14,2010,11,segunda,Regular Season,5-5,5,5,0,14,16,-2,3-7,3,7,0,27,26,1,Los Angeles Chargers,10
2010-11-21,Tennessee Titans,Washington Redskins,16,19,2010,11,domingo,Regular Season,5-5,5,5,0,17,13,4,5-5,5,5,0,18,21,-3,Washington Redskins,8
2010-11-21,Los Angeles Rams,Atlanta Falcons,17,34,2010,11,domingo,Regular Season,4-6,4,6,0,22,23,-1,8-2,8,2,0,1,1,0,Atlanta Falcons,22
2010-11-21,San Francisco 49ers,Tampa Bay Buccaneers,0,21,2010,11,domingo,Regular Season,3-7,3,7,0,26,25,1,7-3,7,3,0,11,11,0,Tampa Bay Buccaneers,14
2010-11-21,Pittsburgh Steelers,Oakland Raiders,35,3,2010,11,domingo,Regular Season,7-3,7,3,0,5,5,0,5-5,5,5,0,16,12,4,Pittsburgh Steelers,7
2010-11-21,Philadelphia Eagles,New York Giants,27,17,2010,11,domingo,Regular Season,7-3,7,3,0,6,6,0,6-4,6,4,0,10,8,2,Philadelphia Eagles,2
2010-11-21,New York Jets,Houston Texans,30,27,2010,11,domingo,Regular Season,8-2,8,2,0,4,3,1,4-6,4,6,0,20,19,1,New York Jets,16
2010-11-21,New Orleans Saints,Seattle Seahawks,34,19,2010,11,domingo,Regular Season,7-3,7,3,0,8,9,-1,5-5,5,5,0,21,20,1,New Orleans Saints,11
2010-11-21,New England Patriots,Indianapolis Colts,31,28,2010,11,domingo,Regular Season,8-2,8,2,0,2,2,0,6-4,6,4,0,9,10,-1,New England Patriots,8
2010-11-21,Minnesota Vikings,Green Bay Packers,3,31,2010,11,domingo,Regular Season,3-7,3,7,0,25,24,1,7-3,7,3,0,7,7,0,Green Bay Packers,17
2010-11-21,Kansas City Chiefs,Arizona Cardinals,31,13,2010,11,domingo,Regular Season,6-4,6,4,0,13,15,-2,3-7,3,7,0,29,27,2,Kansas City Chiefs,12
2010-11-21,Jacksonville Jaguars,Cleveland Browns,24,20,2010,11,domingo,Regular Season,6-4,6,4,0,15,18,-3,3-7,3,7,0,23,22,1,Jacksonville Jaguars,4
2010-11-21,Dallas Cowboys,Detroit Lions,35,19,2010,11,domingo,Regular Season,3-7,3,7,0,24,29,-5,2-8,2,8,0,31,31,0,Dallas Cowboys,2
2010-11-21,Cincinnati Bengals,Buffalo Bills,31,49,2010,11,domingo,Regular Season,2-8,2,8,0,30,28,2,2-8,2,8,0,28,30,-2,Buffalo Bills,2
2010-11-21,Carolina Panthers,Baltimore Ravens,13,37,2010,11,domingo,Regular Season,1-9,1,9,0,32,32,0,7-3,7,3,0,3,4,-1,Baltimore Ravens,28
2010-11-18,Miami Dolphins,Chicago Bears,0,16,2010,11,quinta,Regular Season,5-5,5,5,0,19,14,5,7-3,7,3,0,12,17,-5,Chicago Bears,3
2010-11-15,Washington Redskins,Philadelphia Eagles,28,59,2010,10,segunda,Regular Season,4-5,4,5,0,21,18,3,6-3,6,3,0,6,8,-2,Philadelphia Eagles,10
2010-11-14,Tampa Bay Buccaneers,Carolina Panthers,31,16,2010,10,domingo,Regular Season,6-3,6,3,0,11,13,-2,1-8,1,8,0,32,31,1,Tampa Bay Buccaneers,18
2010-11-14,San Francisco 49ers,Los Angeles Rams,23,20,2010,10,domingo,Regular Season,3-6,3,6,0,25,28,-3,4-5,4,5,0,23,21,2,San Francisco 49ers,7
2010-11-14,Pittsburgh Steelers,New England Patriots,26,39,2010,10,domingo,Regular Season,6-3,6,3,0,5,2,3,7-2,7,2,0,2,6,-4,New England Patriots,4
2010-11-14,New York Giants,Dallas Cowboys,20,33,2010,10,domingo,Regular Season,6-3,6,3,0,8,4,4,2-7,2,7,0,29,30,-1,Dallas Cowboys,26
2010-11-14,Miami Dolphins,Tennessee Titans,29,17,2010,10,domingo,Regular Season,5-4,5,4,0,14,17,-3,5-4,5,4,0,13,11,2,Miami Dolphins,6
2010-11-14,Jacksonville Jaguars,Houston Texans,31,24,2010,10,domingo,Regular Season,5-4,5,4,0,18,20,-2,4-5,4,5,0,19,15,4,Jacksonville Jaguars,5
2010-11-14,Indianapolis Colts,Cincinnati Bengals,23,17,2010,10,domingo,Regular Season,6-3,6,3,0,10,10,0,2-7,2,7,0,28,26,2,Indianapolis Colts,16
2010-11-14,Denver Broncos,Kansas City Chiefs,49,29,2010,10,domingo,Regular Season,3-6,3,6,0,26,29,-3,5-4,5,4,0,15,14,1,Denver Broncos,15
2010-11-14,Cleveland Browns,New York Jets,20,26,2010,10,domingo,Regular Season,3-6,3,6,0,22,23,-1,7-2,7,2,0,3,5,-2,New York Jets,18
2010-11-14,Chicago Bears,Minnesota Vikings,27,13,2010,10,domingo,Regular Season,6-3,6,3,0,17,19,-2,3-6,3,6,0,24,22,2,Chicago Bears,3
2010-11-14,Buffalo Bills,Detroit Lions,14,12,2010,10,domingo,Regular Season,1-8,1,8,0,30,32,-2,2-7,2,7,0,31,27,4,Buffalo Bills,5
2010-11-14,Arizona Cardinals,Seattle Seahawks,18,36,2010,10,domingo,Regular Season,3-6,3,6,0,27,25,2,5-4,5,4,0,20,24,-4,Seattle Seahawks,1
2010-11-11,Atlanta Falcons,Baltimore Ravens,26,21,2010,10,quinta,Regular Season,7-2,7,2,0,1,3,-2,6-3,6,3,0,4,1,3,Atlanta Falcons,2
2010-11-08,Cincinnati Bengals,Pittsburgh Steelers,21,27,2010,9,segunda,Regular Season,2-6,2,6,0,26,25,1,6-2,6,2,0,2,3,-1,Pittsburgh Steelers,22
2010-11-07,Seattle Seahawks,New York Giants,7,41,2010,9,domingo,Regular Season,4-4,4,4,0,24,20,4,6-2,6,2,0,4,7,-3,New York Giants,13
2010-11-07,Philadelphia Eagles,Indianapolis Colts,26,24,2010,9,domingo,Regular Season,5-3,5,3,0,8,12,-4,5-3,5,3,0,10,5,5,Philadelphia Eagles,7
2010-11-07,Oakland Raiders,Kansas City Chiefs,23,20,2010,9,domingo,Regular Season,5-4,5,4,0,12,16,-4,5-3,5,3,0,14,11,3,Oakland Raiders,5
2010-11-07,Minnesota Vikings,Arizona Cardinals,27,24,2010,9,domingo,Regular Season,3-5,3,5,0,22,23,-1,3-5,3,5,0,25,24,1,Minnesota Vikings,1
2010-11-07,Houston Texans,Los Angeles Chargers,23,29,2010,9,domingo,Regular Season,4-4,4,4,0,15,13,2,4-5,4,5,0,16,22,-6,Los Angeles Chargers,9
2010-11-07,Green Bay Packers,Dallas Cowboys,45,7,2010,9,domingo,Regular Season,6-3,6,3,0,7,8,-1,1-7,1,7,0,30,29,1,Green Bay Packers,21
2010-11-07,Detroit Lions,New York Jets,20,23,2010,9,domingo,Regular Season,2-6,2,6,0,27,27,0,6-2,6,2,0,5,4,1,New York Jets,23
2010-11-07,Cleveland Browns,New England Patriots,34,14,2010,9,domingo,Regular Season,3-5,3,5,0,23,26,-3,6-2,6,2,0,6,1,5,Cleveland Browns,25
2010-11-07,Carolina Panthers,New Orleans Saints,3,34,2010,9,domingo,Regular Season,1-7,1,7,0,31,31,0,6-3,6,3,0,9,10,-1,New Orleans Saints,21
2010-11-07,Buffalo Bills,Chicago Bears,19,22,2010,9,domingo,Regular Season,0-8,0,8,0,32,32,0,5-3,5,3,0,19,17,2,Chicago Bears,15
2010-11-07,Baltimore Ravens,Miami Dolphins,26,10,2010,9,domingo,Regular Season,6-2,6,2,0,1,2,-1,4-4,4,4,0,17,15,2,Baltimore Ravens,13
2010-11-07,Atlanta Falcons,Tampa Bay Buccaneers,27,21,2010,9,domingo,Regular Season,6-2,6,2,0,3,6,-3,5-3,5,3,0,13,14,-1,Atlanta Falcons,8
2010-11-01,Indianapolis Colts,Houston Texans,30,17,2010,8,segunda,Regular Season,5-2,5,2,0,5,6,-1,4-3,4,3,0,13,8,5,Indianapolis Colts,2
2010-10-31,Los Angeles Rams,Carolina Panthers,20,10,2010,8,domingo,Regular Season,4-4,4,4,0,21,20,1,1-6,1,6,0,31,29,2,Los Angeles Rams,9
2010-10-31,San Francisco 49ers,Denver Broncos,24,16,2010,8,domingo,Regular Season,2-6,2,6,0,30,31,-1,2-6,2,6,0,28,27,1,San Francisco 49ers,4
2010-10-31,Los Angeles Chargers,Tennessee Titans,33,25,2010,8,domingo,Regular Season,3-5,3,5,0,22,24,-2,5-3,5,3,0,9,7,2,Los Angeles Chargers,17
2010-10-31,Oakland Raiders,Seattle Seahawks,33,3,2010,8,domingo,Regular Season,4-4,4,4,0,16,23,-7,4-3,4,3,0,20,17,3,Oakland Raiders,6
2010-10-31,New York Jets,Green Bay Packers,0,9,2010,8,domingo,Regular Season,5-2,5,2,0,4,2,2,5-3,5,3,0,8,10,-2,Green Bay Packers,8
2010-10-31,New Orleans Saints,Pittsburgh Steelers,20,10,2010,8,domingo,Regular Season,5-3,5,3,0,10,14,-4,5-2,5,2,0,3,1,2,New Orleans Saints,13
2010-10-31,New England Patriots,Minnesota Vikings,28,18,2010,8,domingo,Regular Season,6-1,6,1,0,1,3,-2,2-5,2,5,0,23,19,4,New England Patriots,16
2010-10-31,Kansas City Chiefs,Buffalo Bills,13,10,2010,8,domingo,Regular Season,5-2,5,2,0,11,12,-1,0-7,0,7,0,32,32,0,Kansas City Chiefs,20
2010-10-31,Detroit Lions,Washington Redskins,37,25,2010,8,domingo,Regular Season,2-5,2,5,0,27,30,-3,4-4,4,4,0,18,13,5,Detroit Lions,17
2010-10-31,Dallas Cowboys,Jacksonville Jaguars,17,35,2010,8,domingo,Regular Season,1-6,1,6,0,29,26,3,4-4,4,4,0,19,25,-6,Jacksonville Jaguars,1
2010-10-31,Cincinnati Bengals,Miami Dolphins,14,22,2010,8,domingo,Regular Season,2-5,2,5,0,25,22,3,4-3,4,3,0,15,16,-1,Miami Dolphins,6
2010-10-31,Arizona Cardinals,Tampa Bay Buccaneers,35,38,2010,8,domingo,Regular Season,3-4,3,4,0,24,21,3,5-2,5,2,0,14,18,-4,Tampa Bay Buccaneers,3
2010-10-25,Dallas Cowboys,New York Giants,35,41,2010,7,segunda,Regular Season,1-5,1,5,0,26,26,0,5-2,5,2,0,9,11,-2,New York Giants,15
2010-10-24,Tennessee Titans,Philadelphia Eagles,37,19,2010,7,domingo,Regular Season,5-2,5,2,0,7,8,-1,4-3,4,3,0,11,10,1,Tennessee Titans,2
2010-10-24,Tampa Bay Buccaneers,Los Angeles Rams,18,17,2010,7,domingo,Regular Season,4-2,4,2,0,18,19,-1,3-4,3,4,0,20,21,-1,Tampa Bay Buccaneers,2
2010-10-24,Seattle Seahawks,Arizona Cardinals,22,10,2010,7,domingo,Regular Season,4-2,4,2,0,17,23,-6,3-3,3,3,0,21,18,3,Seattle Seahawks,5
2010-10-24,Los Angeles Chargers,New England Patriots,20,23,2010,7,domingo,Regular Season,2-5,2,5,0,24,24,0,5-1,5,1,0,3,3,0,New England Patriots,21
2010-10-24,New Orleans Saints,Cleveland Browns,17,30,2010,7,domingo,Regular Season,4-3,4,3,0,14,6,8,2-5,2,5,0,28,30,-2,Cleveland Browns,24
2010-10-24,Miami Dolphins,Pittsburgh Steelers,22,23,2010,7,domingo,Regular Season,3-3,3,3,0,16,16,0,5-1,5,1,0,1,1,0,Pittsburgh Steelers,15
2010-10-24,Kansas City Chiefs,Jacksonville Jaguars,42,20,2010,7,domingo,Regular Season,4-2,4,2,0,12,13,-1,3-4,3,4,0,25,25,0,Kansas City Chiefs,12
2010-10-24,Green Bay Packers,Minnesota Vikings,28,24,2010,7,domingo,Regular Season,4-3,4,3,0,10,15,-5,2-4,2,4,0,19,17,2,Green Bay Packers,2
2010-10-24,Denver Broncos,Oakland Raiders,14,59,2010,7,domingo,Regular Season,2-5,2,5,0,27,22,5,3-4,3,4,0,23,28,-5,Oakland Raiders,6
2010-10-24,Chicago Bears,Washington Redskins,14,17,2010,7,domingo,Regular Season,4-3,4,3,0,15,12,3,4-3,4,3,0,13,14,-1,Washington Redskins,2
2010-10-24,Carolina Panthers,San Francisco 49ers,23,20,2010,7,domingo,Regular Season,1-5,1,5,0,29,31,-2,1-6,1,6,0,31,27,4,Carolina Panthers,4
2010-10-24,Baltimore Ravens,Buffalo Bills,37,34,2010,7,domingo,Regular Season,5-2,5,2,0,4,4,0,0-6,0,6,0,32,32,0,Baltimore Ravens,28
2010-10-24,Atlanta Falcons,Cincinnati Bengals,39,32,2010,7,domingo,Regular Season,5-2,5,2,0,5,7,-2,2-4,2,4,0,22,20,2,Atlanta Falcons,13
2010-10-18,Jacksonville Jaguars,Tennessee Titans,3,30,2010,6,segunda,Regular Season,3-3,3,3,0,25,18,7,4-2,4,2,0,8,12,-4,Tennessee Titans,6
2010-10-17,Washington Redskins,Indianapolis Colts,24,27,2010,6,domingo,Regular Season,3-3,3,3,0,14,11,3,4-2,4,2,0,5,5,0,Indianapolis Colts,6
2010-10-17,Tampa Bay Buccaneers,New Orleans Saints,6,31,2010,6,domingo,Regular Season,3-2,3,2,0,19,16,3,4-2,4,2,0,6,9,-3,New Orleans Saints,7
2010-10-17,Los Angeles Rams,Los Angeles Chargers,20,17,2010,6,domingo,Regular Season,3-3,3,3,0,21,26,-5,2-4,2,4,0,24,21,3,Los Angeles Rams,5
2010-10-17,San Francisco 49ers,Oakland Raiders,17,9,2010,6,domingo,Regular Season,1-5,1,5,0,27,30,-3,2-4,2,4,0,28,25,3,San Francisco 49ers,5
2010-10-17,Pittsburgh Steelers,Cleveland Browns,28,10,2010,6,domingo,Regular Season,4-1,4,1,0,1,1,0,1-5,1,5,0,30,29,1,Pittsburgh Steelers,28
2010-10-17,Philadelphia Eagles,Atlanta Falcons,31,17,2010,6,domingo,Regular Season,4-2,4,2,0,10,14,-4,4-2,4,2,0,7,4,3,Philadelphia Eagles,10
2010-10-17,New York Giants,Detroit Lions,28,20,2010,6,domingo,Regular Season,4-2,4,2,0,11,15,-4,1-5,1,5,0,29,28,1,New York Giants,13
2010-10-17,New England Patriots,Baltimore Ravens,23,20,2010,6,domingo,Regular Season,4-1,4,1,0,3,6,-3,4-2,4,2,0,4,2,2,New England Patriots,4
2010-10-17,Minnesota Vikings,Dallas Cowboys,24,21,2010,6,domingo,Regular Season,2-3,2,3,0,17,20,-3,1-4,1,4,0,26,19,7,Minnesota Vikings,1
2010-10-17,Houston Texans,Kansas City Chiefs,35,31,2010,6,domingo,Regular Season,4-2,4,2,0,9,13,-4,3-2,3,2,0,13,10,3,Houston Texans,3
2010-10-17,Green Bay Packers,Miami Dolphins,20,23,2010,6,domingo,Regular Season,3-3,3,3,0,15,8,7,3-2,3,2,0,16,17,-1,Miami Dolphins,9
2010-10-17,Denver Broncos,New York Jets,20,24,2010,6,domingo,Regular Season,2-4,2,4,0,22,23,-1,5-1,5,1,0,2,3,-1,New York Jets,20
2010-10-17,Chicago Bears,Seattle Seahawks,20,23,2010,6,domingo,Regular Season,4-2,4,2,0,12,7,5,3-2,3,2,0,23,27,-4,Seattle Seahawks,20
2010-10-11,New York Jets,Minnesota Vikings,29,20,2010,5,segunda,Regular Season,4-1,4,1,0,3,4,-1,1-3,1,3,0,20,15,5,New York Jets,11
2010-10-10,Washington Redskins,Green Bay Packers,16,13,2010,5,domingo,Regular Season,3-2,3,2,0,11,16,-5,3-2,3,2,0,8,3,5,Washington Redskins,13
2010-10-10,San Francisco 49ers,Philadelphia Eagles,24,27,2010,5,domingo,Regular Season,0-5,0,5,0,30,28,2,3-2,3,2,0,14,17,-3,Philadelphia Eagles,11
2010-10-10,Oakland Raiders,Los Angeles Chargers,35,27,2010,5,domingo,Regular Season,2-3,2,3,0,25,29,-4,2-3,2,3,0,21,12,9,Oakland Raiders,17
2010-10-10,Indianapolis Colts,Kansas City Chiefs,19,9,2010,5,domingo,Regular Season,3-2,3,2,0,5,9,-4,3-1,3,1,0,10,10,0,Indianapolis Colts,1
2010-10-10,Houston Texans,New York Giants,10,34,2010,5,domingo,Regular Season,3-2,3,2,0,13,7,6,3-2,3,2,0,15,20,-5,New York Giants,13
2010-10-10,Detroit Lions,Los Angeles Rams,44,6,2010,5,domingo,Regular Season,1-4,1,4,0,28,31,-3,2-3,2,3,0,26,24,2,Detroit Lions,7
2010-10-10,Dallas Cowboys,Tennessee Titans,27,34,2010,5,domingo,Regular Season,1-3,1,3,0,19,14,5,3-2,3,2,0,12,19,-7,Tennessee Titans,5
2010-10-10,Cleveland Browns,Atlanta Falcons,10,20,2010,5,domingo,Regular Season,1-4,1,4,0,29,27,2,4-1,4,1,0,4,5,-1,Atlanta Falcons,22
2010-10-10,Cincinnati Bengals,Tampa Bay Buccaneers,21,24,2010,5,domingo,Regular Season,2-3,2,3,0,22,18,4,3-1,3,1,0,16,23,-7,Tampa Bay Buccaneers,5
2010-10-10,Carolina Panthers,Chicago Bears,6,23,2010,5,domingo,Regular Season,0-5,0,5,0,31,30,1,4-1,4,1,0,7,11,-4,Chicago Bears,19
2010-10-10,Buffalo Bills,Jacksonville Jaguars,26,36,2010,5,domingo,Regular Season,0-5,0,5,0,32,32,0,3-2,3,2,0,18,22,-4,Jacksonville Jaguars,10
2010-10-10,Baltimore Ravens,Denver Broncos,31,17,2010,5,domingo,Regular Season,4-1,4,1,0,2,6,-4,2-3,2,3,0,23,21,2,Baltimore Ravens,15
2010-10-10,Arizona Cardinals,New Orleans Saints,30,20,2010,5,domingo,Regular Season,3-2,3,2,0,24,25,-1,3-2,3,2,0,9,2,7,Arizona Cardinals,23
2010-10-04,Miami Dolphins,New England Patriots,14,41,2010,4,segunda,Regular Season,2-2,2,2,0,13,11,2,3-1,3,1,0,8,10,-2,New England Patriots,1
2010-10-03,Tennessee Titans,Denver Broncos,20,26,2010,4,domingo,Regular Season,2-2,2,2,0,19,13,6,2-2,2,2,0,21,23,-2,Denver Broncos,10
2010-10-03,Los Angeles Rams,Seattle Seahawks,20,3,2010,4,domingo,Regular Season,2-2,2,2,0,24,27,-3,2-2,2,2,0,26,19,7,Los Angeles Rams,8
2010-10-03,Los Angeles Chargers,Arizona Cardinals,41,10,2010,4,domingo,Regular Season,2-2,2,2,0,12,18,-6,2-2,2,2,0,25,22,3,Los Angeles Chargers,4
2010-10-03,Pittsburgh Steelers,Baltimore Ravens,14,17,2010,4,domingo,Regular Season,3-1,3,1,0,1,1,0,3-1,3,1,0,6,8,-2,Baltimore Ravens,7
2010-10-03,Philadelphia Eagles,Washington Redskins,12,17,2010,4,domingo,Regular Season,2-2,2,2,0,17,14,3,2-2,2,2,0,16,21,-5,Washington Redskins,7
2010-10-03,Oakland Raiders,Houston Texans,24,31,2010,4,domingo,Regular Season,1-3,1,3,0,29,28,1,3-1,3,1,0,7,9,-2,Houston Texans,19
2010-10-03,New York Giants,Chicago Bears,17,3,2010,4,domingo,Regular Season,2-2,2,2,0,20,24,-4,3-1,3,1,0,11,6,5,New York Giants,18
2010-10-03,New Orleans Saints,Carolina Panthers,16,14,2010,4,domingo,Regular Season,3-1,3,1,0,2,2,0,0-4,0,4,0,30,29,1,New Orleans Saints,27
2010-10-03,Jacksonville Jaguars,Indianapolis Colts,31,28,2010,4,domingo,Regular Season,2-2,2,2,0,22,26,-4,2-2,2,2,0,9,3,6,Jacksonville Jaguars,23
2010-10-03,Green Bay Packers,Detroit Lions,28,26,2010,4,domingo,Regular Season,3-1,3,1,0,3,4,-1,0-4,0,4,0,31,31,0,Green Bay Packers,27
2010-10-03,Cleveland Browns,Cincinnati Bengals,23,20,2010,4,domingo,Regular Season,1-3,1,3,0,27,30,-3,2-2,2,2,0,18,12,6,Cleveland Browns,18
2010-10-03,Buffalo Bills,New York Jets,14,38,2010,4,domingo,Regular Season,0-4,0,4,0,32,32,0,3-1,3,1,0,4,7,-3,New York Jets,25
2010-10-03,Atlanta Falcons,San Francisco 49ers,16,14,2010,4,domingo,Regular Season,3-1,3,1,0,5,5,0,0-4,0,4,0,28,25,3,Atlanta Falcons,20
2010-09-27,Chicago Bears,Green Bay Packers,20,17,2010,3,segunda,Regular Season,3-0,3,0,0,6,12,-6,2-1,2,1,0,4,2,2,Chicago Bears,10
2010-09-26,Tampa Bay Buccaneers,Pittsburgh Steelers,13,38,2010,3,domingo,Regular Season,2-1,2,1,0,20,21,-1,3-0,3,0,0,1,5,-4,Pittsburgh Steelers,16
2010-09-26,Los Angeles Rams,Washington Redskins,30,16,2010,3,domingo,Regular Season,1-2,1,2,0,27,31,-4,1-2,1,2,0,21,14,7,Los Angeles Rams,17
2010-09-26,Seattle Seahawks,Los Angeles Chargers,27,20,2010,3,domingo,Regular Season,2-1,2,1,0,19,26,-7,1-2,1,2,0,18,13,5,Seattle Seahawks,13
2010-09-26,New York Giants,Tennessee Titans,10,29,2010,3,domingo,Regular Season,1-2,1,2,0,24,19,5,2-1,2,1,0,13,15,-2,Tennessee Titans,4
2010-09-26,New Orleans Saints,Atlanta Falcons,24,27,2010,3,domingo,Regular Season,2-1,2,1,0,2,1,1,2-1,2,1,0,5,10,-5,Atlanta Falcons,9
2010-09-26,New England Patriots,Buffalo Bills,38,30,2010,3,domingo,Regular Season,2-1,2,1,0,10,9,1,0-3,0,3,0,32,32,0,New England Patriots,23
2010-09-26,Minnesota Vikings,Detroit Lions,24,10,2010,3,domingo,Regular Season,1-2,1,2,0,17,18,-1,0-3,0,3,0,31,29,2,Minnesota Vikings,11
2010-09-26,Miami Dolphins,New York Jets,23,31,2010,3,domingo,Regular Season,2-1,2,1,0,11,7,4,2-1,2,1,0,7,6,1,New York Jets,1
2010-09-26,Kansas City Chiefs,San Francisco 49ers,31,10,2010,3,domingo,Regular Season,3-0,3,0,0,15,20,-5,0-3,0,3,0,25,23,2,Kansas City Chiefs,3
2010-09-26,Jacksonville Jaguars,Philadelphia Eagles,3,28,2010,3,domingo,Regular Season,1-2,1,2,0,26,25,1,2-1,2,1,0,14,16,-2,Philadelphia Eagles,9
2010-09-26,Houston Texans,Dallas Cowboys,13,27,2010,3,domingo,Regular Season,2-1,2,1,0,9,3,6,1-2,1,2,0,16,17,-1,Dallas Cowboys,14
2010-09-26,Denver Broncos,Indianapolis Colts,13,27,2010,3,domingo,Regular Season,1-2,1,2,0,23,22,1,2-1,2,1,0,3,4,-1,Indianapolis Colts,18
2010-09-26,Carolina Panthers,Cincinnati Bengals,7,20,2010,3,domingo,Regular Season,0-3,0,3,0,29,28,1,2-1,2,1,0,12,11,1,Cincinnati Bengals,17
2010-09-26,Baltimore Ravens,Cleveland Browns,24,17,2010,3,domingo,Regular Season,2-1,2,1,0,8,8,0,0-3,0,3,0,30,30,0,Baltimore Ravens,22
2010-09-26,Arizona Cardinals,Oakland Raiders,24,23,2010,3,domingo,Regular Season,2-1,2,1,0,22,24,-2,1-2,1,2,0,28,27,1,Arizona Cardinals,3
2010-09-19,Washington Redskins,Houston Texans,27,30,2010,2,domingo,Regular Season,1-1,1,1,0,14,14,0,2-0,2,0,0,3,7,-4,Houston Texans,7
2010-09-19,Tennessee Titans,Pittsburgh Steelers,11,19,2010,2,domingo,Regular Season,1-1,1,1,0,15,9,6,2-0,2,0,0,5,10,-5,Pittsburgh Steelers,1
2010-09-20,San Francisco 49ers,New Orleans Saints,22,25,2010,2,segunda,Regular Season,0-2,0,2,0,23,20,3,2-0,2,0,0,1,1,0,New Orleans Saints,19
2010-09-19,Los Angeles Chargers,Jacksonville Jaguars,38,13,2010,2,domingo,Regular Season,1-1,1,1,0,13,12,1,1-1,1,1,0,25,24,1,Los Angeles Chargers,12
2010-09-19,Oakland Raiders,Los Angeles Rams,16,14,2010,2,domingo,Regular Season,1-1,1,1,0,27,27,0,0-2,0,2,0,31,31,0,Oakland Raiders,4
2010-09-19,New York Jets,New England Patriots,28,14,2010,2,domingo,Regular Season,1-1,1,1,0,6,11,-5,1-1,1,1,0,9,4,5,New York Jets,7
2010-09-19,Minnesota Vikings,Miami Dolphins,10,14,2010,2,domingo,Regular Season,0-2,0,2,0,18,6,12,2-0,2,0,0,7,15,-8,Miami Dolphins,9
2010-09-19,Indianapolis Colts,New York Giants,38,14,2010,2,domingo,Regular Season,1-1,1,1,0,4,5,-1,1-1,1,1,0,19,16,3,Indianapolis Colts,11
2010-09-19,Green Bay Packers,Buffalo Bills,34,7,2010,2,domingo,Regular Season,2-0,2,0,0,2,2,0,0-2,0,2,0,32,30,2,Green Bay Packers,28
2010-09-19,Detroit Lions,Philadelphia Eagles,32,35,2010,2,domingo,Regular Season,0-2,0,2,0,29,29,0,1-1,1,1,0,16,18,-2,Philadelphia Eagles,11
2010-09-19,Denver Broncos,Seattle Seahawks,31,14,2010,2,domingo,Regular Season,1-1,1,1,0,22,25,-3,1-1,1,1,0,26,21,5,Denver Broncos,4
2010-09-19,Dallas Cowboys,Chicago Bears,20,27,2010,2,domingo,Regular Season,0-2,0,2,0,17,8,9,2-0,2,0,0,12,22,-10,Chicago Bears,14
2010-09-19,Cleveland Browns,Kansas City Chiefs,14,16,2010,2,domingo,Regular Season,0-2,0,2,0,30,32,-2,2-0,2,0,0,20,23,-3,Kansas City Chiefs,9
2010-09-19,Cincinnati Bengals,Baltimore Ravens,15,10,2010,2,domingo,Regular Season,1-1,1,1,0,11,17,-6,1-1,1,1,0,8,3,5,Cincinnati Bengals,14
2010-09-19,Carolina Panthers,Tampa Bay Buccaneers,7,20,2010,2,domingo,Regular Season,0-2,0,2,0,28,26,2,2-0,2,0,0,21,28,-7,Tampa Bay Buccaneers,2
2010-09-19,Atlanta Falcons,Arizona Cardinals,41,7,2010,2,domingo,Regular Season,1-1,1,1,0,10,13,-3,1-1,1,1,0,24,19,5,Atlanta Falcons,6
2010-09-13,New York Jets,Baltimore Ravens,9,10,2010,1,segunda,Regular Season,0-1,0,1,0,11,9,2,1-0,1,0,0,3,6,-3,Baltimore Ravens,3
2010-09-13,Kansas City Chiefs,Los Angeles Chargers,21,14,2010,1,segunda,Regular Season,1-0,1,0,0,23,27,-4,0-1,0,1,0,12,8,4,Kansas City Chiefs,19
2010-09-12,Washington Redskins,Dallas Cowboys,13,7,2010,1,domingo,Regular Season,1-0,1,0,0,14,17,-3,0-1,0,1,0,8,4,4,Washington Redskins,13
2010-09-12,Tennessee Titans,Oakland Raiders,38,13,2010,1,domingo,Regular Season,1-0,1,0,0,9,16,-7,0-1,0,1,0,27,24,3,Tennessee Titans,8
2010-09-12,Tampa Bay Buccaneers,Cleveland Browns,17,14,2010,1,domingo,Regular Season,1-0,1,0,0,28,30,-2,0-1,0,1,0,32,29,3,Tampa Bay Buccaneers,1
2010-09-12,Los Angeles Rams,Arizona Cardinals,13,17,2010,1,domingo,Regular Season,0-1,0,1,0,31,32,-1,1-0,1,0,0,19,20,-1,Arizona Cardinals,12
2010-09-12,Seattle Seahawks,San Francisco 49ers,31,6,2010,1,domingo,Regular Season,1-0,1,0,0,21,26,-5,0-1,0,1,0,20,13,7,Seattle Seahawks,13
2010-09-12,Pittsburgh Steelers,Atlanta Falcons,15,9,2010,1,domingo,Regular Season,1-0,1,0,0,10,18,-8,0-1,0,1,0,13,7,6,Pittsburgh Steelers,11
2010-09-12,Philadelphia Eagles,Green Bay Packers,20,27,2010,1,domingo,Regular Season,0-1,0,1,0,18,15,3,1-0,1,0,0,2,3,-1,Green Bay Packers,12
2010-09-12,New York Giants,Carolina Panthers,31,18,2010,1,domingo,Regular Season,1-0,1,0,0,16,19,-3,0-1,0,1,0,26,23,3,New York Giants,4
2010-09-12,New England Patriots,Cincinnati Bengals,38,24,2010,1,domingo,Regular Season,1-0,1,0,0,4,10,-6,0-1,0,1,0,17,12,5,New England Patriots,2
2010-09-12,Jacksonville Jaguars,Denver Broncos,24,17,2010,1,domingo,Regular Season,1-0,1,0,0,24,25,-1,0-1,0,1,0,25,22,3,Jacksonville Jaguars,3
2010-09-12,Houston Texans,Indianapolis Colts,34,24,2010,1,domingo,Regular Season,1-0,1,0,0,7,14,-7,0-1,0,1,0,5,1,4,Houston Texans,13
2010-09-12,Chicago Bears,Detroit Lions,19,14,2010,1,domingo,Regular Season,1-0,1,0,0,22,21,1,0-1,0,1,0,29,28,1,Chicago Bears,7
2010-09-12,Buffalo Bills,Miami Dolphins,10,15,2010,1,domingo,Regular Season,0-1,0,1,0,30,31,-1,1-0,1,0,0,15,11,4,Miami Dolphins,20
2010-09-09,New Orleans Saints,Minnesota Vikings,14,9,2010,1,quinta,Regular Season,1-0,1,0,0,1,2,-1,0-1,0,1,0,6,5,1,New Orleans Saints,3
2010-01-03,Tampa Bay Buccaneers,Atlanta Falcons,10,20,2009,17,domingo,Regular Season,3-13,3,13,0,30,29,1,9-7,9,7,0,15,16,-1,Atlanta Falcons,13
2010-01-03,Los Angeles Rams,San Francisco 49ers,6,28,2009,17,domingo,Regular Season,1-15,1,15,0,32,32,0,8-8,8,8,0,19,21,-2,San Francisco 49ers,11
2010-01-03,Seattle Seahawks,Tennessee Titans,13,17,2009,17,domingo,Regular Season,5-11,5,11,0,27,26,1,8-8,8,8,0,16,17,-1,Tennessee Titans,9
2010-01-03,Los Angeles Chargers,Washington Redskins,23,20,2009,17,domingo,Regular Season,13-3,13,3,0,2,2,0,4-12,4,12,0,29,28,1,Los Angeles Chargers,26
2010-01-03,Oakland Raiders,Baltimore Ravens,13,21,2009,17,domingo,Regular Season,5-11,5,11,0,26,24,2,9-7,9,7,0,11,11,0,Baltimore Ravens,13
2010-01-03,New York Jets,Cincinnati Bengals,37,0,2009,17,domingo,Regular Season,9-7,9,7,0,12,14,-2,10-6,10,6,0,9,7,2,New York Jets,7
2010-01-03,Minnesota Vikings,New York Giants,44,7,2009,17,domingo,Regular Season,12-4,12,4,0,3,5,-2,8-8,8,8,0,20,18,2,Minnesota Vikings,13
2010-01-03,Miami Dolphins,Pittsburgh Steelers,24,30,2009,17,domingo,Regular Season,7-9,7,9,0,21,20,1,9-7,9,7,0,13,12,1,Pittsburgh Steelers,8
2010-01-03,Houston Texans,New England Patriots,34,27,2009,17,domingo,Regular Season,9-7,9,7,0,14,15,-1,10-6,10,6,0,10,10,0,Houston Texans,5
2010-01-03,Detroit Lions,Chicago Bears,23,37,2009,17,domingo,Regular Season,2-14,2,14,0,31,31,0,7-9,7,9,0,22,23,-1,Chicago Bears,8
2010-01-03,Denver Broncos,Kansas City Chiefs,24,44,2009,17,domingo,Regular Season,8-8,8,8,0,17,13,4,4-12,4,12,0,28,30,-2,Kansas City Chiefs,17
2010-01-03,Dallas Cowboys,Philadelphia Eagles,24,0,2009,17,domingo,Regular Season,11-5,11,5,0,4,9,-5,11-5,11,5,0,7,4,3,Dallas Cowboys,5
2010-01-03,Cleveland Browns,Jacksonville Jaguars,23,17,2009,17,domingo,Regular Season,5-11,5,11,0,25,27,-2,7-9,7,9,0,23,22,1,Cleveland Browns,5
2010-01-03,Carolina Panthers,New Orleans Saints,23,10,2009,17,domingo,Regular Season,8-8,8,8,0,18,19,-1,13-3,13,3,0,5,3,2,Carolina Panthers,16
2010-01-03,Buffalo Bills,Indianapolis Colts,30,7,2009,17,domingo,Regular Season,6-10,6,10,0,24,25,-1,14-2,14,2,0,1,1,0,Buffalo Bills,24
2010-01-03,Arizona Cardinals,Green Bay Packers,7,33,2009,17,domingo,Regular Season,10-6,10,6,0,8,6,2,11-5,11,5,0,6,8,-2,Green Bay Packers,2
2009-12-28,Chicago Bears,Minnesota Vikings,36,30,2009,16,segunda,Regular Season,6-9,6,9,0,23,25,-2,11-4,11,4,0,5,4,1,Chicago Bears,21
2009-12-27,Washington Redskins,Dallas Cowboys,0,17,2009,16,domingo,Regular Season,4-11,4,11,0,28,27,1,10-5,10,5,0,9,10,-1,Dallas Cowboys,17
2009-12-27,San Francisco 49ers,Detroit Lions,20,6,2009,16,domingo,Regular Season,7-8,7,8,0,21,22,-1,2-13,2,13,0,31,31,0,San Francisco 49ers,9
2009-12-27,Pittsburgh Steelers,Baltimore Ravens,23,20,2009,16,domingo,Regular Season,8-7,8,7,0,12,15,-3,8-7,8,7,0,11,11,0,Pittsburgh Steelers,4
2009-12-27,Philadelphia Eagles,Denver Broncos,30,27,2009,16,domingo,Regular Season,11-4,11,4,0,4,5,-1,8-7,8,7,0,13,13,0,Philadelphia Eagles,8
2009-12-27,New York Giants,Carolina Panthers,9,41,2009,16,domingo,Regular Season,8-7,8,7,0,18,12,6,7-8,7,8,0,19,21,-2,Carolina Panthers,9
2009-12-27,New Orleans Saints,Tampa Bay Buccaneers,17,20,2009,16,domingo,Regular Season,13-2,13,2,0,3,2,1,3-12,3,12,0,29,30,-1,Tampa Bay Buccaneers,28
2009-12-27,New England Patriots,Jacksonville Jaguars,35,7,2009,16,domingo,Regular Season,10-5,10,5,0,10,9,1,7-8,7,8,0,22,18,4,New England Patriots,9
2009-12-27,Miami Dolphins,Houston Texans,20,27,2009,16,domingo,Regular Season,7-8,7,8,0,20,16,4,8-7,8,7,0,15,20,-5,Houston Texans,4
2009-12-27,Indianapolis Colts,New York Jets,15,29,2009,16,domingo,Regular Season,14-1,14,1,0,1,1,0,8-7,8,7,0,14,19,-5,New York Jets,18
2009-12-27,Green Bay Packers,Seattle Seahawks,48,10,2009,16,domingo,Regular Season,10-5,10,5,0,8,8,0,5-10,5,10,0,26,24,2,Green Bay Packers,16
2009-12-27,Cleveland Browns,Oakland Raiders,23,9,2009,16,domingo,Regular Season,4-11,4,11,0,27,28,-1,5-10,5,10,0,24,23,1,Cleveland Browns,5
2009-12-27,Cincinnati Bengals,Kansas City Chiefs,17,10,2009,16,domingo,Regular Season,10-5,10,5,0,7,7,0,3-12,3,12,0,30,29,1,Cincinnati Bengals,22
2009-12-27,Atlanta Falcons,Buffalo Bills,31,3,2009,16,domingo,Regular Season,8-7,8,7,0,16,17,-1,5-10,5,10,0,25,26,-1,Atlanta Falcons,9
2009-12-27,Arizona Cardinals,Los Angeles Rams,31,10,2009,16,domingo,Regular Season,10-5,10,5,0,6,6,0,1-14,1,14,0,32,32,0,Arizona Cardinals,26
2009-12-25,Tennessee Titans,Los Angeles Chargers,17,42,2009,16,sexta,Regular Season,7-8,7,8,0,17,14,3,12-3,12,3,0,2,3,-1,Los Angeles Chargers,11
2009-12-21,Washington Redskins,New York Giants,12,45,2009,15,segunda,Regular Season,4-10,4,10,0,27,26,1,8-6,8,6,0,12,14,-2,New York Giants,12
2009-12-20,Tennessee Titans,Miami Dolphins,27,24,2009,15,domingo,Regular Season,7-7,7,7,0,14,17,-3,7-7,7,7,0,16,13,3,Tennessee Titans,4
2009-12-20,Los Angeles Rams,Houston Texans,13,16,2009,15,domingo,Regular Season,1-13,1,13,0,32,32,0,7-7,7,7,0,20,20,0,Houston Texans,12
2009-12-20,Seattle Seahawks,Tampa Bay Buccaneers,7,24,2009,15,domingo,Regular Season,5-9,5,9,0,24,24,0,2-12,2,12,0,30,31,-1,Tampa Bay Buccaneers,7
2009-12-20,Los Angeles Chargers,Cincinnati Bengals,27,24,2009,15,domingo,Regular Season,11-3,11,3,0,3,4,-1,9-5,9,5,0,7,7,0,Los Angeles Chargers,3
2009-12-20,Pittsburgh Steelers,Green Bay Packers,37,36,2009,15,domingo,Regular Season,7-7,7,7,0,15,19,-4,9-5,9,5,0,8,6,2,Pittsburgh Steelers,13
2009-12-20,Philadelphia Eagles,San Francisco 49ers,27,13,2009,15,domingo,Regular Season,10-4,10,4,0,5,5,0,6-8,6,8,0,22,21,1,Philadelphia Eagles,16
2009-12-20,New York Jets,Atlanta Falcons,7,10,2009,15,domingo,Regular Season,7-7,7,7,0,19,16,3,7-7,7,7,0,17,18,-1,Atlanta Falcons,2
2009-12-20,Kansas City Chiefs,Cleveland Browns,34,41,2009,15,domingo,Regular Season,3-11,3,11,0,29,28,1,3-11,3,11,0,28,29,-1,Cleveland Browns,1
2009-12-20,Detroit Lions,Arizona Cardinals,24,31,2009,15,domingo,Regular Season,2-12,2,12,0,31,30,1,9-5,9,5,0,6,8,-2,Arizona Cardinals,22
2009-12-20,Denver Broncos,Oakland Raiders,19,20,2009,15,domingo,Regular Season,8-6,8,6,0,13,10,3,5-9,5,9,0,23,27,-4,Oakland Raiders,17
2009-12-20,Carolina Panthers,Minnesota Vikings,26,7,2009,15,domingo,Regular Season,6-8,6,8,0,21,22,-1,11-3,11,3,0,4,3,1,Carolina Panthers,19
2009-12-20,Buffalo Bills,New England Patriots,10,17,2009,15,domingo,Regular Season,5-9,5,9,0,26,25,1,9-5,9,5,0,9,9,0,New England Patriots,16
2009-12-20,Baltimore Ravens,Chicago Bears,31,7,2009,15,domingo,Regular Season,8-6,8,6,0,11,12,-1,5-9,5,9,0,25,23,2,Baltimore Ravens,11
2009-12-19,New Orleans Saints,Dallas Cowboys,17,24,2009,15,sábado,Regular Season,13-1,13,1,0,2,1,1,9-5,9,5,0,10,11,-1,Dallas Cowboys,10
2009-12-17,Jacksonville Jaguars,Indianapolis Colts,31,35,2009,15,quinta,Regular Season,7-7,7,7,0,18,15,3,14-0,14,0,0,1,2,-1,Indianapolis Colts,13
2009-12-14,San Francisco 49ers,Arizona Cardinals,24,9,2009,14,segunda,Regular Season,6-7,6,7,0,21,23,-2,8-5,8,5,0,8,6,2,San Francisco 49ers,17
2009-12-13,Tennessee Titans,Los Angeles Rams,47,7,2009,14,domingo,Regular Season,6-7,6,7,0,17,17,0,1-12,1,12,0,32,31,1,Tennessee Titans,14
2009-12-13,Tampa Bay Buccaneers,New York Jets,3,26,2009,14,domingo,Regular Season,1-12,1,12,0,31,30,1,7-6,7,6,0,16,19,-3,New York Jets,11
2009-12-13,Oakland Raiders,Washington Redskins,13,34,2009,14,domingo,Regular Season,4-9,4,9,0,27,25,2,4-9,4,9,0,26,27,-1,Washington Redskins,2
2009-12-13,New York Giants,Philadelphia Eagles,38,45,2009,14,domingo,Regular Season,7-6,7,6,0,14,12,2,9-4,9,4,0,5,8,-3,Philadelphia Eagles,4
2009-12-13,New England Patriots,Carolina Panthers,20,10,2009,14,domingo,Regular Season,8-5,8,5,0,9,11,-2,5-8,5,8,0,22,20,2,New England Patriots,9
2009-12-13,Minnesota Vikings,Cincinnati Bengals,30,10,2009,14,domingo,Regular Season,11-2,11,2,0,3,3,0,9-4,9,4,0,7,5,2,Minnesota Vikings,2
2009-12-13,Kansas City Chiefs,Buffalo Bills,10,16,2009,14,domingo,Regular Season,3-10,3,10,0,28,28,0,5-8,5,8,0,25,26,-1,Buffalo Bills,2
2009-12-13,Jacksonville Jaguars,Miami Dolphins,10,14,2009,14,domingo,Regular Season,7-6,7,6,0,15,13,2,7-6,7,6,0,13,14,-1,Miami Dolphins,1
2009-12-13,Indianapolis Colts,Denver Broncos,28,16,2009,14,domingo,Regular Season,13-0,13,0,0,2,2,0,8-5,8,5,0,10,9,1,Indianapolis Colts,7
2009-12-13,Houston Texans,Seattle Seahawks,34,7,2009,14,domingo,Regular Season,6-7,6,7,0,20,22,-2,5-8,5,8,0,24,21,3,Houston Texans,1
2009-12-13,Dallas Cowboys,Los Angeles Chargers,17,20,2009,14,domingo,Regular Season,8-5,8,5,0,11,10,1,10-3,10,3,0,4,4,0,Los Angeles Chargers,6
2009-12-13,Chicago Bears,Green Bay Packers,14,21,2009,14,domingo,Regular Season,5-8,5,8,0,23,24,-1,9-4,9,4,0,6,7,-1,Green Bay Packers,17
2009-12-13,Baltimore Ravens,Detroit Lions,48,3,2009,14,domingo,Regular Season,7-6,7,6,0,12,16,-4,2-11,2,11,0,30,29,1,Baltimore Ravens,13
2009-12-13,Atlanta Falcons,New Orleans Saints,23,26,2009,14,domingo,Regular Season,6-7,6,7,0,18,18,0,13-0,13,0,0,1,1,0,New Orleans Saints,17
2009-12-10,Cleveland Browns,Pittsburgh Steelers,13,6,2009,14,quinta,Regular Season,2-11,2,11,0,29,32,-3,6-7,6,7,0,19,15,4,Cleveland Browns,17
2009-12-07,Green Bay Packers,Baltimore Ravens,27,14,2009,13,segunda,Regular Season,8-4,8,4,0,7,11,-4,6-6,6,6,0,16,13,3,Green Bay Packers,2
2009-12-06,Washington Redskins,New Orleans Saints,30,33,2009,13,domingo,Regular Season,3-9,3,9,0,27,26,1,12-0,12,0,0,1,1,0,New Orleans Saints,25
2009-12-06,Seattle Seahawks,San Francisco 49ers,20,17,2009,13,domingo,Regular Season,5-7,5,7,0,21,25,-4,5-7,5,7,0,23,20,3,Seattle Seahawks,5
2009-12-06,Pittsburgh Steelers,Oakland Raiders,24,27,2009,13,domingo,Regular Season,6-6,6,6,0,15,12,3,4-8,4,8,0,25,28,-3,Oakland Raiders,16
2009-12-06,New York Giants,Dallas Cowboys,31,24,2009,13,domingo,Regular Season,7-5,7,5,0,12,15,-3,8-4,8,4,0,10,7,3,New York Giants,8
2009-12-06,Miami Dolphins,New England Patriots,22,21,2009,13,domingo,Regular Season,6-6,6,6,0,14,19,-5,7-5,7,5,0,11,6,5,Miami Dolphins,13
2009-12-06,Kansas City Chiefs,Denver Broncos,13,44,2009,13,domingo,Regular Season,3-9,3,9,0,28,27,1,8-4,8,4,0,9,10,-1,Denver Broncos,17
2009-12-06,Jacksonville Jaguars,Houston Texans,23,18,2009,13,domingo,Regular Season,7-5,7,5,0,13,17,-4,5-7,5,7,0,22,18,4,Jacksonville Jaguars,1
2009-12-06,Indianapolis Colts,Tennessee Titans,27,17,2009,13,domingo,Regular Season,12-0,12,0,0,2,2,0,5-7,5,7,0,17,16,1,Indianapolis Colts,14
2009-12-06,Cleveland Browns,Los Angeles Chargers,23,30,2009,13,domingo,Regular Season,1-11,1,11,0,32,32,0,9-3,9,3,0,4,4,0,Los Angeles Chargers,28
2009-12-06,Cincinnati Bengals,Detroit Lions,23,13,2009,13,domingo,Regular Season,9-3,9,3,0,5,5,0,2-10,2,10,0,29,29,0,Cincinnati Bengals,24
2009-12-06,Chicago Bears,Los Angeles Rams,17,9,2009,13,domingo,Regular Season,5-7,5,7,0,24,23,1,1-11,1,11,0,31,31,0,Chicago Bears,8
2009-12-06,Carolina Panthers,Tampa Bay Buccaneers,16,6,2009,13,domingo,Regular Season,5-7,5,7,0,20,22,-2,1-11,1,11,0,30,30,0,Carolina Panthers,8
2009-12-06,Atlanta Falcons,Philadelphia Eagles,7,34,2009,13,domingo,Regular Season,6-6,6,6,0,18,14,4,8-4,8,4,0,8,9,-1,Philadelphia Eagles,5
2009-12-06,Arizona Cardinals,Minnesota Vikings,30,17,2009,13,domingo,Regular Season,8-4,8,4,0,6,8,-2,10-2,10,2,0,3,3,0,Arizona Cardinals,5
2009-12-03,Buffalo Bills,New York Jets,13,19,2009,13,quinta,Regular Season,4-8,4,8,0,26,24,2,6-6,6,6,0,19,21,-2,New York Jets,3
2009-11-30,New Orleans Saints,New England Patriots,38,17,2009,12,segunda,Regular Season,11-0,11,0,0,1,1,0,7-4,7,4,0,6,4,2,New Orleans Saints,3
2009-11-29,Tennessee Titans,Arizona Cardinals,20,17,2009,12,domingo,Regular Season,5-6,5,6,0,16,19,-3,7-4,7,4,0,8,5,3,Tennessee Titans,14
2009-11-29,Los Angeles Rams,Seattle Seahawks,17,27,2009,12,domingo,Regular Season,1-10,1,10,0,31,31,0,4-7,4,7,0,25,25,0,Seattle Seahawks,6
2009-11-29,San Francisco 49ers,Jacksonville Jaguars,20,3,2009,12,domingo,Regular Season,5-6,5,6,0,20,20,0,6-5,6,5,0,17,14,3,San Francisco 49ers,6
2009-11-29,Los Angeles Chargers,Kansas City Chiefs,43,14,2009,12,domingo,Regular Season,8-3,8,3,0,4,6,-2,3-8,3,8,0,27,26,1,Los Angeles Chargers,20
2009-11-29,Philadelphia Eagles,Washington Redskins,27,24,2009,12,domingo,Regular Season,7-4,7,4,0,9,10,-1,3-8,3,8,0,26,24,2,Philadelphia Eagles,14
2009-11-29,New York Jets,Carolina Panthers,17,6,2009,12,domingo,Regular Season,5-6,5,6,0,21,22,-1,4-7,4,7,0,22,21,1,New York Jets,1
2009-11-29,Minnesota Vikings,Chicago Bears,36,10,2009,12,domingo,Regular Season,10-1,10,1,0,3,3,0,4-7,4,7,0,23,23,0,Minnesota Vikings,20
2009-11-29,Houston Texans,Indianapolis Colts,27,35,2009,12,domingo,Regular Season,5-6,5,6,0,18,18,0,11-0,11,0,0,2,2,0,Indianapolis Colts,16
2009-11-29,Cincinnati Bengals,Cleveland Browns,16,7,2009,12,domingo,Regular Season,8-3,8,3,0,5,7,-2,1-10,1,10,0,32,32,0,Cincinnati Bengals,25
2009-11-29,Buffalo Bills,Miami Dolphins,31,14,2009,12,domingo,Regular Season,4-7,4,7,0,24,27,-3,5-6,5,6,0,19,17,2,Buffalo Bills,10
2009-11-29,Baltimore Ravens,Pittsburgh Steelers,20,17,2009,12,domingo,Regular Season,6-5,6,5,0,13,15,-2,6-5,6,5,0,12,9,3,Baltimore Ravens,6
2009-11-29,Atlanta Falcons,Tampa Bay Buccaneers,20,17,2009,12,domingo,Regular Season,6-5,6,5,0,14,16,-2,1-10,1,10,0,30,30,0,Atlanta Falcons,14
2009-11-26,Detroit Lions,Green Bay Packers,12,34,2009,12,quinta,Regular Season,2-9,2,9,0,29,29,0,7-4,7,4,0,11,12,-1,Green Bay Packers,17
2009-11-26,Denver Broncos,New York Giants,26,6,2009,12,quinta,Regular Season,7-4,7,4,0,10,13,-3,6-5,6,5,0,15,11,4,Denver Broncos,2
2009-11-26,Dallas Cowboys,Oakland Raiders,24,7,2009,12,quinta,Regular Season,8-3,8,3,0,7,8,-1,3-8,3,8,0,28,28,0,Dallas Cowboys,20
2009-11-23,Houston Texans,Tennessee Titans,17,20,2009,11,segunda,Regular Season,5-5,5,5,0,18,13,5,4-6,4,6,0,19,22,-3,Tennessee Titans,9
2009-11-22,Tampa Bay Buccaneers,New Orleans Saints,7,38,2009,11,domingo,Regular Season,1-9,1,9,0,30,29,1,10-0,10,0,0,1,1,0,New Orleans Saints,28
2009-11-22,Los Angeles Rams,Arizona Cardinals,13,21,2009,11,domingo,Regular Season,1-9,1,9,0,31,30,1,7-3,7,3,0,5,7,-2,Arizona Cardinals,23
2009-11-22,Oakland Raiders,Cincinnati Bengals,20,17,2009,11,domingo,Regular Season,3-7,3,7,0,28,28,0,7-3,7,3,0,7,4,3,Oakland Raiders,24
2009-11-22,New York Giants,Atlanta Falcons,34,31,2009,11,domingo,Regular Season,6-4,6,4,0,11,16,-5,5-5,5,5,0,16,14,2,New York Giants,2
2009-11-22,New England Patriots,New York Jets,31,14,2009,11,domingo,Regular Season,7-3,7,3,0,4,5,-1,4-6,4,6,0,22,21,1,New England Patriots,16
2009-11-22,Minnesota Vikings,Seattle Seahawks,35,9,2009,11,domingo,Regular Season,9-1,9,1,0,3,3,0,3-7,3,7,0,25,25,0,Minnesota Vikings,22
2009-11-22,Kansas City Chiefs,Pittsburgh Steelers,27,24,2009,11,domingo,Regular Season,3-7,3,7,0,26,27,-1,6-4,6,4,0,9,6,3,Kansas City Chiefs,21
2009-11-22,Jacksonville Jaguars,Buffalo Bills,18,15,2009,11,domingo,Regular Season,6-4,6,4,0,14,17,-3,3-7,3,7,0,27,26,1,Jacksonville Jaguars,9
2009-11-22,Green Bay Packers,San Francisco 49ers,30,24,2009,11,domingo,Regular Season,6-4,6,4,0,12,15,-3,4-6,4,6,0,20,19,1,Green Bay Packers,4
2009-11-22,Detroit Lions,Cleveland Browns,38,37,2009,11,domingo,Regular Season,2-8,2,8,0,29,31,-2,1-9,1,9,0,32,32,0,Detroit Lions,1
2009-11-22,Denver Broncos,Los Angeles Chargers,3,32,2009,11,domingo,Regular Season,6-4,6,4,0,13,9,4,7-3,7,3,0,6,8,-2,Los Angeles Chargers,1
2009-11-22,Dallas Cowboys,Washington Redskins,7,6,2009,11,domingo,Regular Season,7-3,7,3,0,8,10,-2,3-7,3,7,0,24,24,0,Dallas Cowboys,14
2009-11-22,Chicago Bears,Philadelphia Eagles,20,24,2009,11,domingo,Regular Season,4-6,4,6,0,23,23,0,6-4,6,4,0,10,12,-2,Philadelphia Eagles,11
2009-11-22,Baltimore Ravens,Indianapolis Colts,15,17,2009,11,domingo,Regular Season,5-5,5,5,0,15,11,4,10-0,10,0,0,2,2,0,Indianapolis Colts,9
2009-11-19,Carolina Panthers,Miami Dolphins,17,24,2009,11,quinta,Regular Season,4-6,4,6,0,21,20,1,5-5,5,5,0,17,18,-1,Miami Dolphins,2
2009-11-16,Cleveland Browns,Baltimore Ravens,0,16,2009,10,segunda,Regular Season,1-8,1,8,0,32,32,0,5-4,5,4,0,11,14,-3,Baltimore Ravens,18
2009-11-15,Washington Redskins,Denver Broncos,27,17,2009,10,domingo,Regular Season,3-6,3,6,0,24,26,-2,6-3,6,3,0,9,7,2,Washington Redskins,19
2009-11-15,Tennessee Titans,Buffalo Bills,41,17,2009,10,domingo,Regular Season,3-6,3,6,0,22,23,-1,3-6,3,6,0,26,24,2,Tennessee Titans,1
2009-11-15,Los Angeles Rams,New Orleans Saints,23,28,2009,10,domingo,Regular Season,1-8,1,8,0,30,30,0,9-0,9,0,0,1,1,0,New Orleans Saints,29
2009-11-15,Los Angeles Chargers,Philadelphia Eagles,31,23,2009,10,domingo,Regular Season,6-3,6,3,0,8,12,-4,5-4,5,4,0,12,11,1,Los Angeles Chargers,1
2009-11-15,Pittsburgh Steelers,Cincinnati Bengals,12,18,2009,10,domingo,Regular Season,6-3,6,3,0,6,5,1,7-2,7,2,0,4,4,0,Cincinnati Bengals,1
2009-11-15,Oakland Raiders,Kansas City Chiefs,10,16,2009,10,domingo,Regular Season,2-7,2,7,0,28,27,1,2-7,2,7,0,27,28,-1,Kansas City Chiefs,1
2009-11-15,New York Jets,Jacksonville Jaguars,22,24,2009,10,domingo,Regular Season,4-5,4,5,0,21,18,3,5-4,5,4,0,17,22,-5,Jacksonville Jaguars,4
2009-11-15,Minnesota Vikings,Detroit Lions,27,10,2009,10,domingo,Regular Season,8-1,8,1,0,3,3,0,1-8,1,8,0,31,29,2,Minnesota Vikings,26
2009-11-15,Miami Dolphins,Tampa Bay Buccaneers,25,23,2009,10,domingo,Regular Season,4-5,4,5,0,18,17,1,1-8,1,8,0,29,31,-2,Miami Dolphins,14
2009-11-15,Indianapolis Colts,New England Patriots,35,34,2009,10,domingo,Regular Season,9-0,9,0,0,2,2,0,6-3,6,3,0,5,6,-1,Indianapolis Colts,4
2009-11-15,Green Bay Packers,Dallas Cowboys,17,7,2009,10,domingo,Regular Season,5-4,5,4,0,15,16,-1,6-3,6,3,0,10,8,2,Green Bay Packers,8
2009-11-15,Carolina Panthers,Atlanta Falcons,28,19,2009,10,domingo,Regular Season,4-5,4,5,0,20,21,-1,5-4,5,4,0,14,9,5,Carolina Panthers,12
2009-11-15,Arizona Cardinals,Seattle Seahawks,31,20,2009,10,domingo,Regular Season,6-3,6,3,0,7,10,-3,3-6,3,6,0,25,25,0,Arizona Cardinals,15
2009-11-12,San Francisco 49ers,Chicago Bears,10,6,2009,10,quinta,Regular Season,4-5,4,5,0,19,20,-1,4-5,4,5,0,23,19,4,San Francisco 49ers,1
2009-11-09,Denver Broncos,Pittsburgh Steelers,10,28,2009,9,segunda,Regular Season,6-2,6,2,0,7,4,3,6-2,6,2,0,5,7,-2,Pittsburgh Steelers,3
2009-11-08,Tampa Bay Buccaneers,Green Bay Packers,38,28,2009,9,domingo,Regular Season,1-7,1,7,0,31,32,-1,4-4,4,4,0,16,12,4,Tampa Bay Buccaneers,20
2009-11-08,Seattle Seahawks,Detroit Lions,32,20,2009,9,domingo,Regular Season,3-5,3,5,0,25,24,1,1-7,1,7,0,29,29,0,Seattle Seahawks,5
2009-11-08,San Francisco 49ers,Tennessee Titans,27,34,2009,9,domingo,Regular Season,3-5,3,5,0,20,19,1,2-6,2,6,0,23,26,-3,Tennessee Titans,7
2009-11-08,Philadelphia Eagles,Dallas Cowboys,16,20,2009,9,domingo,Regular Season,5-3,5,3,0,11,9,2,6-2,6,2,0,8,8,0,Dallas Cowboys,1
2009-11-08,New York Giants,Los Angeles Chargers,20,21,2009,9,domingo,Regular Season,5-4,5,4,0,15,15,0,5-3,5,3,0,12,16,-4,Los Angeles Chargers,1
2009-11-08,New Orleans Saints,Carolina Panthers,30,20,2009,9,domingo,Regular Season,8-0,8,0,0,1,1,0,3-5,3,5,0,21,23,-2,New Orleans Saints,22
2009-11-08,New England Patriots,Miami Dolphins,27,17,2009,9,domingo,Regular Season,6-2,6,2,0,6,5,1,3-5,3,5,0,17,20,-3,New England Patriots,15
2009-11-08,Jacksonville Jaguars,Kansas City Chiefs,24,21,2009,9,domingo,Regular Season,4-4,4,4,0,22,21,1,1-7,1,7,0,28,28,0,Jacksonville Jaguars,7
2009-11-08,Indianapolis Colts,Houston Texans,20,17,2009,9,domingo,Regular Season,8-0,8,0,0,2,2,0,5-4,5,4,0,13,14,-1,Indianapolis Colts,12
2009-11-08,Cincinnati Bengals,Baltimore Ravens,17,7,2009,9,domingo,Regular Season,6-2,6,2,0,4,6,-2,4-4,4,4,0,14,10,4,Cincinnati Bengals,4
2009-11-08,Chicago Bears,Arizona Cardinals,21,41,2009,9,domingo,Regular Season,4-4,4,4,0,19,17,2,5-3,5,3,0,10,13,-3,Arizona Cardinals,4
2009-11-08,Atlanta Falcons,Washington Redskins,31,17,2009,9,domingo,Regular Season,5-3,5,3,0,9,11,-2,2-6,2,6,0,26,25,1,Atlanta Falcons,14
2009-11-02,New Orleans Saints,Atlanta Falcons,35,27,2009,8,segunda,Regular Season,7-0,7,0,0,1,2,-1,4-3,4,3,0,11,11,0,New Orleans Saints,9
2009-11-01,Tennessee Titans,Jacksonville Jaguars,30,13,2009,8,domingo,Regular Season,1-6,1,6,0,26,29,-3,3-4,3,4,0,21,21,0,Tennessee Titans,8
2009-11-01,Los Angeles Chargers,Oakland Raiders,24,16,2009,8,domingo,Regular Season,4-3,4,3,0,16,16,0,2-6,2,6,0,27,27,0,Los Angeles Chargers,11
2009-11-01,Philadelphia Eagles,New York Giants,40,17,2009,8,domingo,Regular Season,5-2,5,2,0,9,12,-3,5-3,5,3,0,15,8,7,Philadelphia Eagles,4
2009-11-01,New York Jets,Miami Dolphins,25,30,2009,8,domingo,Regular Season,4-4,4,4,0,18,15,3,3-4,3,4,0,20,19,1,Miami Dolphins,4
2009-11-01,Indianapolis Colts,San Francisco 49ers,18,14,2009,8,domingo,Regular Season,7-0,7,0,0,2,1,1,3-4,3,4,0,19,20,-1,Indianapolis Colts,19
2009-11-01,Green Bay Packers,Minnesota Vikings,26,38,2009,8,domingo,Regular Season,4-3,4,3,0,12,13,-1,7-1,7,1,0,3,4,-1,Minnesota Vikings,9
2009-11-01,Detroit Lions,Los Angeles Rams,10,17,2009,8,domingo,Regular Season,1-6,1,6,0,29,26,3,1-7,1,7,0,30,32,-2,Los Angeles Rams,6
2009-11-01,Dallas Cowboys,Seattle Seahawks,38,17,2009,8,domingo,Regular Season,5-2,5,2,0,8,9,-1,2-5,2,5,0,24,23,1,Dallas Cowboys,14
2009-11-01,Chicago Bears,Cleveland Browns,30,6,2009,8,domingo,Regular Season,4-3,4,3,0,17,18,-1,1-7,1,7,0,31,30,1,Chicago Bears,12
2009-11-01,Buffalo Bills,Houston Texans,10,31,2009,8,domingo,Regular Season,3-5,3,5,0,22,22,0,5-3,5,3,0,14,17,-3,Houston Texans,5
2009-11-01,Baltimore Ravens,Denver Broncos,30,7,2009,8,domingo,Regular Season,4-3,4,3,0,10,14,-4,6-1,6,1,0,4,3,1,Baltimore Ravens,11
2009-11-01,Arizona Cardinals,Carolina Panthers,21,34,2009,8,domingo,Regular Season,4-3,4,3,0,13,10,3,3-4,3,4,0,23,24,-1,Carolina Panthers,14
2009-10-26,Washington Redskins,Philadelphia Eagles,17,27,2009,7,segunda,Regular Season,2-5,2,5,0,25,27,-2,4-2,4,2,0,12,12,0,Philadelphia Eagles,15
2009-10-25,Tampa Bay Buccaneers,New England Patriots,7,35,2009,7,domingo,Regular Season,0-7,0,7,0,31,31,0,5-2,5,2,0,5,6,-1,New England Patriots,25
2009-10-25,Los Angeles Rams,Indianapolis Colts,6,42,2009,7,domingo,Regular Season,0-7,0,7,0,32,32,0,6-0,6,0,0,1,1,0,Indianapolis Colts,31
2009-10-25,Pittsburgh Steelers,Minnesota Vikings,27,17,2009,7,domingo,Regular Season,5-2,5,2,0,7,8,-1,6-1,6,1,0,4,3,1,Pittsburgh Steelers,5
2009-10-25,Oakland Raiders,New York Jets,0,38,2009,7,domingo,Regular Season,2-5,2,5,0,27,25,2,4-3,4,3,0,15,18,-3,New York Jets,7
2009-10-25,New York Giants,Arizona Cardinals,17,24,2009,7,domingo,Regular Season,5-2,5,2,0,8,5,3,4-2,4,2,0,10,16,-6,Arizona Cardinals,11
2009-10-25,Miami Dolphins,New Orleans Saints,34,46,2009,7,domingo,Regular Season,2-4,2,4,0,19,20,-1,6-0,6,0,0,2,2,0,New Orleans Saints,18
2009-10-25,Kansas City Chiefs,Los Angeles Chargers,7,37,2009,7,domingo,Regular Season,1-6,1,6,0,28,28,0,3-3,3,3,0,16,14,2,Los Angeles Chargers,14
2009-10-25,Houston Texans,San Francisco 49ers,24,21,2009,7,domingo,Regular Season,4-3,4,3,0,17,17,0,3-3,3,3,0,20,15,5,Houston Texans,2
2009-10-25,Dallas Cowboys,Atlanta Falcons,37,21,2009,7,domingo,Regular Season,4-2,4,2,0,9,19,-10,4-2,4,2,0,11,7,4,Dallas Cowboys,12
2009-10-25,Cleveland Browns,Green Bay Packers,3,31,2009,7,domingo,Regular Season,1-6,1,6,0,30,29,1,4-2,4,2,0,13,13,0,Green Bay Packers,16
2009-10-25,Cincinnati Bengals,Chicago Bears,45,10,2009,7,domingo,Regular Season,5-2,5,2,0,6,9,-3,3-3,3,3,0,18,10,8,Cincinnati Bengals,1
2009-10-25,Carolina Panthers,Buffalo Bills,9,20,2009,7,domingo,Regular Season,2-4,2,4,0,24,22,2,3-4,3,4,0,22,24,-2,Buffalo Bills,2
2009-10-19,Los Angeles Chargers,Denver Broncos,23,34,2009,6,segunda,Regular Season,2-3,2,3,0,14,16,-2,6-0,6,0,0,4,5,-1,Denver Broncos,11
2009-10-18,Washington Redskins,Kansas City Chiefs,6,14,2009,6,domingo,Regular Season,2-4,2,4,0,27,24,3,1-5,1,5,0,28,30,-2,Kansas City Chiefs,6
2009-10-18,Tampa Bay Buccaneers,Carolina Panthers,21,28,2009,6,domingo,Regular Season,0-6,0,6,0,31,31,0,2-3,2,3,0,22,23,-1,Carolina Panthers,8
2009-10-18,Seattle Seahawks,Arizona Cardinals,3,27,2009,6,domingo,Regular Season,2-4,2,4,0,23,20,3,3-2,3,2,0,16,19,-3,Arizona Cardinals,1
2009-10-18,Pittsburgh Steelers,Cleveland Browns,27,14,2009,6,domingo,Regular Season,4-2,4,2,0,8,13,-5,1-5,1,5,0,29,28,1,Pittsburgh Steelers,15
2009-10-18,Oakland Raiders,Philadelphia Eagles,13,9,2009,6,domingo,Regular Season,2-4,2,4,0,25,29,-4,3-2,3,2,0,12,7,5,Oakland Raiders,22
2009-10-18,New York Jets,Buffalo Bills,13,16,2009,6,domingo,Regular Season,3-3,3,3,0,18,9,9,2-4,2,4,0,24,25,-1,Buffalo Bills,16
2009-10-18,New Orleans Saints,New York Giants,48,27,2009,6,domingo,Regular Season,5-0,5,0,0,2,4,-2,5-1,5,1,0,5,2,3,New Orleans Saints,2
2009-10-18,New England Patriots,Tennessee Titans,59,0,2009,6,domingo,Regular Season,4-2,4,2,0,6,10,-4,0-6,0,6,0,30,27,3,New England Patriots,17
2009-10-18,Minnesota Vikings,Baltimore Ravens,33,31,2009,6,domingo,Regular Season,6-0,6,0,0,3,3,0,3-3,3,3,0,11,11,0,Minnesota Vikings,8
2009-10-18,Jacksonville Jaguars,Los Angeles Rams,23,20,2009,6,domingo,Regular Season,3-3,3,3,0,21,21,0,0-6,0,6,0,32,32,0,Jacksonville Jaguars,11
2009-10-18,Green Bay Packers,Detroit Lions,26,0,2009,6,domingo,Regular Season,3-2,3,2,0,13,14,-1,1-5,1,5,0,26,26,0,Green Bay Packers,12
2009-10-18,Cincinnati Bengals,Houston Texans,17,28,2009,6,domingo,Regular Season,4-2,4,2,0,9,6,3,3-3,3,3,0,17,22,-5,Houston Texans,16
2009-10-18,Atlanta Falcons,Chicago Bears,21,14,2009,6,domingo,Regular Season,4-1,4,1,0,7,8,-1,3-2,3,2,0,10,12,-2,Atlanta Falcons,4
2009-10-12,Miami Dolphins,New York Jets,31,27,2009,5,segunda,Regular Season,2-3,2,3,0,18,21,-3,3-2,3,2,0,9,5,4,Miami Dolphins,16
2009-10-11,Tennessee Titans,Indianapolis Colts,9,31,2009,5,domingo,Regular Season,0-5,0,5,0,27,25,2,5-0,5,0,0,1,1,0,Indianapolis Colts,24
2009-10-11,Los Angeles Rams,Minnesota Vikings,10,38,2009,5,domingo,Regular Season,0-5,0,5,0,32,32,0,5-0,5,0,0,3,3,0,Minnesota Vikings,29
2009-10-11,Seattle Seahawks,Jacksonville Jaguars,41,0,2009,5,domingo,Regular Season,2-3,2,3,0,20,24,-4,2-3,2,3,0,21,18,3,Seattle Seahawks,6
2009-10-11,San Francisco 49ers,Atlanta Falcons,10,45,2009,5,domingo,Regular Season,3-2,3,2,0,15,12,3,3-1,3,1,0,8,9,-1,Atlanta Falcons,3
2009-10-11,Philadelphia Eagles,Tampa Bay Buccaneers,33,14,2009,5,domingo,Regular Season,3-1,3,1,0,7,10,-3,0-5,0,5,0,31,31,0,Philadelphia Eagles,21
2009-10-11,New York Giants,Oakland Raiders,44,7,2009,5,domingo,Regular Season,5-0,5,0,0,2,2,0,1-4,1,4,0,29,28,1,New York Giants,26
2009-10-11,Kansas City Chiefs,Dallas Cowboys,20,26,2009,5,domingo,Regular Season,0-5,0,5,0,30,30,0,3-2,3,2,0,17,17,0,Dallas Cowboys,13
2009-10-11,Detroit Lions,Pittsburgh Steelers,20,28,2009,5,domingo,Regular Season,1-4,1,4,0,26,27,-1,3-2,3,2,0,13,15,-2,Pittsburgh Steelers,12
2009-10-11,Denver Broncos,New England Patriots,20,17,2009,5,domingo,Regular Season,5-0,5,0,0,5,8,-3,3-2,3,2,0,10,6,4,Denver Broncos,2
2009-10-11,Carolina Panthers,Washington Redskins,20,17,2009,5,domingo,Regular Season,1-3,1,3,0,23,26,-3,2-3,2,3,0,24,22,2,Carolina Panthers,4
2009-10-11,Buffalo Bills,Cleveland Browns,3,6,2009,5,domingo,Regular Season,1-4,1,4,0,25,23,2,1-4,1,4,0,28,29,-1,Cleveland Browns,6
2009-10-11,Baltimore Ravens,Cincinnati Bengals,14,17,2009,5,domingo,Regular Season,3-2,3,2,0,11,7,4,4-1,4,1,0,6,11,-5,Cincinnati Bengals,4
2009-10-11,Arizona Cardinals,Houston Texans,28,21,2009,5,domingo,Regular Season,2-2,2,2,0,19,19,0,2-3,2,3,0,22,20,2,Arizona Cardinals,1
2009-10-05,Minnesota Vikings,Green Bay Packers,30,23,2009,4,segunda,Regular Season,4-0,4,0,0,3,5,-2,2-2,2,2,0,13,10,3,Minnesota Vikings,5
2009-10-04,Washington Redskins,Tampa Bay Buccaneers,16,13,2009,4,domingo,Regular Season,2-2,2,2,0,22,26,-4,0-4,0,4,0,31,31,0,Washington Redskins,5
2009-10-04,San Francisco 49ers,Los Angeles Rams,35,0,2009,4,domingo,Regular Season,3-1,3,1,0,12,15,-3,0-4,0,4,0,32,32,0,San Francisco 49ers,17
2009-10-04,Pittsburgh Steelers,Los Angeles Chargers,38,28,2009,4,domingo,Regular Season,2-2,2,2,0,15,16,-1,2-2,2,2,0,16,12,4,Pittsburgh Steelers,4
2009-10-04,New Orleans Saints,New York Jets,24,10,2009,4,domingo,Regular Season,4-0,4,0,0,4,4,0,3-1,3,1,0,5,6,-1,New Orleans Saints,2
2009-10-04,New England Patriots,Baltimore Ravens,27,21,2009,4,domingo,Regular Season,3-1,3,1,0,6,7,-1,3-1,3,1,0,7,1,6,New England Patriots,6
2009-10-04,Miami Dolphins,Buffalo Bills,38,10,2009,4,domingo,Regular Season,1-3,1,3,0,21,24,-3,1-3,1,3,0,23,21,2,Miami Dolphins,3
2009-10-04,Kansas City Chiefs,New York Giants,16,27,2009,4,domingo,Regular Season,0-4,0,4,0,30,30,0,4-0,4,0,0,2,3,-1,New York Giants,27
2009-10-04,Jacksonville Jaguars,Tennessee Titans,37,17,2009,4,domingo,Regular Season,2-2,2,2,0,18,22,-4,0-4,0,4,0,25,18,7,Jacksonville Jaguars,4
2009-10-04,Indianapolis Colts,Seattle Seahawks,34,17,2009,4,domingo,Regular Season,4-0,4,0,0,1,2,-1,1-3,1,3,0,24,23,1,Indianapolis Colts,21
2009-10-04,Houston Texans,Oakland Raiders,29,6,2009,4,domingo,Regular Season,2-2,2,2,0,20,20,0,1-3,1,3,0,28,27,1,Houston Texans,7
2009-10-04,Denver Broncos,Dallas Cowboys,17,10,2009,4,domingo,Regular Season,4-0,4,0,0,8,13,-5,2-2,2,2,0,17,17,0,Denver Broncos,4
2009-10-04,Cleveland Browns,Cincinnati Bengals,20,23,2009,4,domingo,Regular Season,0-4,0,4,0,29,29,0,3-1,3,1,0,11,11,0,Cincinnati Bengals,18
2009-10-04,Chicago Bears,Detroit Lions,48,24,2009,4,domingo,Regular Season,3-1,3,1,0,14,14,0,1-3,1,3,0,27,28,-1,Chicago Bears,14
2009-09-28,Dallas Cowboys,Carolina Panthers,21,7,2009,3,segunda,Regular Season,2-1,2,1,0,17,15,2,0-3,0,3,0,25,25,0,Dallas Cowboys,10
2009-09-27,Tampa Bay Buccaneers,New York Giants,0,24,2009,3,domingo,Regular Season,0-3,0,3,0,31,28,3,3-0,3,0,0,3,2,1,New York Giants,26
2009-09-27,Los Angeles Rams,Green Bay Packers,17,36,2009,3,domingo,Regular Season,0-3,0,3,0,32,32,0,2-1,2,1,0,10,12,-2,Green Bay Packers,20
2009-09-27,Seattle Seahawks,Chicago Bears,19,25,2009,3,domingo,Regular Season,1-2,1,2,0,23,22,1,2-1,2,1,0,14,14,0,Chicago Bears,8
2009-09-27,Los Angeles Chargers,Miami Dolphins,23,13,2009,3,domingo,Regular Season,2-1,2,1,0,12,11,1,0-3,0,3,0,24,19,5,Los Angeles Chargers,8
2009-09-27,Philadelphia Eagles,Kansas City Chiefs,34,14,2009,3,domingo,Regular Season,2-1,2,1,0,9,9,0,0-3,0,3,0,30,30,0,Philadelphia Eagles,21
2009-09-27,Oakland Raiders,Denver Broncos,3,23,2009,3,domingo,Regular Season,1-2,1,2,0,27,26,1,3-0,3,0,0,13,20,-7,Denver Broncos,6
2009-09-27,New York Jets,Tennessee Titans,24,17,2009,3,domingo,Regular Season,3-0,3,0,0,6,8,-2,0-3,0,3,0,18,16,2,New York Jets,8
2009-09-27,New England Patriots,Atlanta Falcons,26,10,2009,3,domingo,Regular Season,2-1,2,1,0,7,10,-3,2-1,2,1,0,8,4,4,New England Patriots,6
2009-09-27,Minnesota Vikings,San Francisco 49ers,27,24,2009,3,domingo,Regular Season,3-0,3,0,0,5,5,0,2-1,2,1,0,15,13,2,Minnesota Vikings,8
2009-09-27,Houston Texans,Jacksonville Jaguars,24,31,2009,3,domingo,Regular Season,1-2,1,2,0,20,17,3,1-2,1,2,0,22,27,-5,Jacksonville Jaguars,10
2009-09-27,Detroit Lions,Washington Redskins,19,14,2009,3,domingo,Regular Season,1-2,1,2,0,28,31,-3,1-2,1,2,0,26,23,3,Detroit Lions,8
2009-09-27,Cincinnati Bengals,Pittsburgh Steelers,23,20,2009,3,domingo,Regular Season,2-1,2,1,0,11,24,-13,1-2,1,2,0,16,6,10,Cincinnati Bengals,18
2009-09-27,Buffalo Bills,New Orleans Saints,7,27,2009,3,domingo,Regular Season,1-2,1,2,0,21,21,0,3-0,3,0,0,4,7,-3,New Orleans Saints,14
2009-09-27,Baltimore Ravens,Cleveland Browns,34,3,2009,3,domingo,Regular Season,3-0,3,0,0,1,1,0,0-3,0,3,0,29,29,0,Baltimore Ravens,28
2009-09-27,Arizona Cardinals,Indianapolis Colts,10,31,2009,3,domingo,Regular Season,1-2,1,2,0,19,18,1,3-0,3,0,0,2,3,-1,Indianapolis Colts,15
2009-09-21,Miami Dolphins,Indianapolis Colts,23,27,2009,2,segunda,Regular Season,0-2,0,2,0,19,19,0,2-0,2,0,0,3,5,-2,Indianapolis Colts,14
2009-09-20,Washington Redskins,Los Angeles Rams,9,7,2009,2,domingo,Regular Season,1-1,1,1,0,23,20,3,0-2,0,2,0,32,32,0,Washington Redskins,12
2009-09-20,Tennessee Titans,Houston Texans,31,34,2009,2,domingo,Regular Season,0-2,0,2,0,16,9,7,1-1,1,1,0,17,23,-6,Houston Texans,14
2009-09-20,San Francisco 49ers,Seattle Seahawks,23,10,2009,2,domingo,Regular Season,2-0,2,0,0,13,18,-5,1-1,1,1,0,22,14,8,San Francisco 49ers,4
2009-09-20,Los Angeles Chargers,Baltimore Ravens,26,31,2009,2,domingo,Regular Season,1-1,1,1,0,11,6,5,2-0,2,0,0,1,10,-9,Baltimore Ravens,4
2009-09-20,Philadelphia Eagles,New Orleans Saints,22,48,2009,2,domingo,Regular Season,1-1,1,1,0,9,4,5,2-0,2,0,0,7,12,-5,New Orleans Saints,8
2009-09-20,New York Jets,New England Patriots,16,9,2009,2,domingo,Regular Season,2-0,2,0,0,8,16,-8,1-1,1,1,0,10,2,8,New York Jets,14
2009-09-20,Kansas City Chiefs,Oakland Raiders,10,13,2009,2,domingo,Regular Season,0-2,0,2,0,30,30,0,1-1,1,1,0,26,27,-1,Oakland Raiders,3
2009-09-20,Jacksonville Jaguars,Arizona Cardinals,17,31,2009,2,domingo,Regular Season,0-2,0,2,0,27,25,2,1-1,1,1,0,18,17,1,Arizona Cardinals,8
2009-09-20,Green Bay Packers,Cincinnati Bengals,24,31,2009,2,domingo,Regular Season,1-1,1,1,0,12,11,1,1-1,1,1,0,24,26,-2,Cincinnati Bengals,15
2009-09-20,Detroit Lions,Minnesota Vikings,13,27,2009,2,domingo,Regular Season,0-2,0,2,0,31,31,0,2-0,2,0,0,5,8,-3,Minnesota Vikings,23
2009-09-20,Denver Broncos,Cleveland Browns,27,6,2009,2,domingo,Regular Season,2-0,2,0,0,20,24,-4,0-2,0,2,0,29,28,1,Denver Broncos,4
2009-09-20,Dallas Cowboys,New York Giants,31,33,2009,2,domingo,Regular Season,1-1,1,1,0,15,13,2,2-0,2,0,0,2,3,-1,New York Giants,10
2009-09-20,Chicago Bears,Pittsburgh Steelers,17,14,2009,2,domingo,Regular Season,1-1,1,1,0,14,15,-1,1-1,1,1,0,6,1,5,Chicago Bears,14
2009-09-20,Buffalo Bills,Tampa Bay Buccaneers,33,20,2009,2,domingo,Regular Season,1-1,1,1,0,21,21,0,0-2,0,2,0,28,29,-1,Buffalo Bills,8
2009-09-20,Atlanta Falcons,Carolina Panthers,28,20,2009,2,domingo,Regular Season,2-0,2,0,0,4,7,-3,0-2,0,2,0,25,22,3,Atlanta Falcons,15
2009-09-14,Oakland Raiders,Los Angeles Chargers,20,24,2009,1,segunda,Regular Season,0-1,0,1,0,27,30,-3,1-0,1,0,0,6,5,1,Los Angeles Chargers,25
2009-09-14,New England Patriots,Buffalo Bills,25,24,2009,1,segunda,Regular Season,1-0,1,0,0,2,2,0,0-1,0,1,0,21,21,0,New England Patriots,19
2009-09-13,Tampa Bay Buccaneers,Dallas Cowboys,21,34,2009,1,domingo,Regular Season,0-1,0,1,0,29,26,3,1-0,1,0,0,13,17,-4,Dallas Cowboys,9
2009-09-13,Seattle Seahawks,Los Angeles Rams,28,0,2009,1,domingo,Regular Season,1-0,1,0,0,14,15,-1,0-1,0,1,0,32,31,1,Seattle Seahawks,16
2009-09-13,New York Giants,Washington Redskins,23,17,2009,1,domingo,Regular Season,1-0,1,0,0,3,3,0,0-1,0,1,0,20,20,0,New York Giants,17
2009-09-13,New Orleans Saints,Detroit Lions,45,27,2009,1,domingo,Regular Season,1-0,1,0,0,12,18,-6,0-1,0,1,0,31,32,-1,New Orleans Saints,14
2009-09-13,Indianapolis Colts,Jacksonville Jaguars,14,12,2009,1,domingo,Regular Season,1-0,1,0,0,5,6,-1,0-1,0,1,0,25,25,0,Indianapolis Colts,19
2009-09-13,Houston Texans,New York Jets,7,24,2009,1,domingo,Regular Season,0-1,0,1,0,23,19,4,1-0,1,0,0,16,23,-7,New York Jets,4
2009-09-13,Green Bay Packers,Chicago Bears,21,15,2009,1,domingo,Regular Season,1-0,1,0,0,11,12,-1,0-1,0,1,0,15,11,4,Green Bay Packers,1
2009-09-13,Cleveland Browns,Minnesota Vikings,20,34,2009,1,domingo,Regular Season,0-1,0,1,0,28,28,0,1-0,1,0,0,8,9,-1,Minnesota Vikings,19
2009-09-13,Cincinnati Bengals,Denver Broncos,7,12,2009,1,domingo,Regular Season,0-1,0,1,0,26,24,2,1-0,1,0,0,24,27,-3,Denver Broncos,3
2009-09-13,Carolina Panthers,Philadelphia Eagles,10,38,2009,1,domingo,Regular Season,0-1,0,1,0,22,14,8,1-0,1,0,0,4,4,0,Philadelphia Eagles,10
2009-09-13,Baltimore Ravens,Kansas City Chiefs,38,24,2009,1,domingo,Regular Season,1-0,1,0,0,10,10,0,0-1,0,1,0,30,29,1,Baltimore Ravens,19
2009-09-13,Atlanta Falcons,Miami Dolphins,19,7,2009,1,domingo,Regular Season,1-0,1,0,0,7,8,-1,0-1,0,1,0,19,16,3,Atlanta Falcons,8
2009-09-13,Arizona Cardinals,San Francisco 49ers,16,20,2009,1,domingo,Regular Season,0-1,0,1,0,17,13,4,1-0,1,0,0,18,22,-4,San Francisco 49ers,9
2009-09-10,Pittsburgh Steelers,Tennessee Titans,13,10,2009,1,quinta,Regular Season,1-0,1,0,0,1,1,0,0-1,0,1,0,9,7,2,Pittsburgh Steelers,6
2008-12-28,Tampa Bay Buccaneers,Oakland Raiders,24,31,2008,17,domingo,Regular Season,9-7,9,7,0,16,12,4,5-11,5,11,0,26,27,-1,Oakland Raiders,15
2008-12-28,San Francisco 49ers,Washington Redskins,27,24,2008,17,domingo,Regular Season,7-9,7,9,0,20,23,-3,8-8,8,8,0,21,18,3,San Francisco 49ers,5
2008-12-28,Los Angeles Chargers,Denver Broncos,52,21,2008,17,domingo,Regular Season,8-8,8,8,0,12,16,-4,8-8,8,8,0,22,20,2,Los Angeles Chargers,4
2008-12-28,Pittsburgh Steelers,Cleveland Browns,31,0,2008,17,domingo,Regular Season,12-4,12,4,0,3,4,-1,4-12,4,12,0,29,28,1,Pittsburgh Steelers,24
2008-12-28,Philadelphia Eagles,Dallas Cowboys,44,6,2008,17,domingo,Regular Season,9-6,9,6,0,11,15,-4,9-7,9,7,0,14,10,4,Philadelphia Eagles,5
2008-12-28,New York Jets,Miami Dolphins,17,24,2008,17,domingo,Regular Season,9-7,9,7,0,17,14,3,11-5,11,5,0,8,9,-1,Miami Dolphins,5
2008-12-28,New Orleans Saints,Carolina Panthers,31,33,2008,17,domingo,Regular Season,8-8,8,8,0,19,17,2,12-4,12,4,0,4,3,1,Carolina Panthers,14
2008-12-28,Minnesota Vikings,New York Giants,20,19,2008,17,domingo,Regular Season,10-6,10,6,0,10,11,-1,12-4,12,4,0,2,2,0,Minnesota Vikings,9
2008-12-28,Indianapolis Colts,Tennessee Titans,23,0,2008,17,domingo,Regular Season,12-4,12,4,0,5,5,0,13-3,13,3,0,1,1,0,Indianapolis Colts,4
2008-12-28,Houston Texans,Chicago Bears,31,24,2008,17,domingo,Regular Season,8-8,8,8,0,18,21,-3,9-7,9,7,0,15,13,2,Houston Texans,8
2008-12-28,Green Bay Packers,Detroit Lions,31,21,2008,17,domingo,Regular Season,6-10,6,10,0,24,24,0,0-16,0,16,0,32,32,0,Green Bay Packers,8
2008-12-28,Cincinnati Bengals,Kansas City Chiefs,16,6,2008,17,domingo,Regular Season,4-11,4,11,0,27,29,-2,2-14,2,14,0,30,30,0,Cincinnati Bengals,1
2008-12-28,Buffalo Bills,New England Patriots,0,13,2008,17,domingo,Regular Season,7-9,7,9,0,23,22,1,11-5,11,5,0,9,8,1,New England Patriots,14
2008-12-28,Baltimore Ravens,Jacksonville Jaguars,27,7,2008,17,domingo,Regular Season,11-5,11,5,0,6,6,0,5-11,5,11,0,25,25,0,Baltimore Ravens,19
2008-12-28,Atlanta Falcons,Los Angeles Rams,31,27,2008,17,domingo,Regular Season,11-5,11,5,0,7,7,0,2-14,2,14,0,31,31,0,Atlanta Falcons,24
2008-12-28,Arizona Cardinals,Seattle Seahawks,34,21,2008,17,domingo,Regular Season,9-7,9,7,0,13,19,-6,4-12,4,12,0,28,26,2,Arizona Cardinals,7
2008-12-22,Chicago Bears,Green Bay Packers,20,17,2008,16,segunda,Regular Season,9-6,9,6,0,13,16,-3,5-10,5,10,0,24,25,-1,Chicago Bears,9
2008-12-21,Washington Redskins,Philadelphia Eagles,10,3,2008,16,domingo,Regular Season,8-7,8,7,0,18,20,-2,8-6,8,6,0,15,13,2,Washington Redskins,7
2008-12-21,Tennessee Titans,Pittsburgh Steelers,31,14,2008,16,domingo,Regular Season,13-2,13,2,0,1,2,-1,11-4,11,4,0,4,1,3,Tennessee Titans,1
2008-12-21,Tampa Bay Buccaneers,Los Angeles Chargers,24,41,2008,16,domingo,Regular Season,9-6,9,6,0,12,10,2,7-8,7,8,0,16,21,-5,Los Angeles Chargers,11
2008-12-21,Los Angeles Rams,San Francisco 49ers,16,17,2008,16,domingo,Regular Season,2-13,2,13,0,31,31,0,6-9,6,9,0,23,24,-1,San Francisco 49ers,7
2008-12-21,Seattle Seahawks,New York Jets,13,3,2008,16,domingo,Regular Season,4-11,4,11,0,26,27,-1,9-6,9,6,0,14,14,0,Seattle Seahawks,13
2008-12-21,Oakland Raiders,Houston Texans,27,16,2008,16,domingo,Regular Season,4-11,4,11,0,27,30,-3,7-8,7,8,0,21,18,3,Oakland Raiders,12
2008-12-21,New York Giants,Carolina Panthers,34,28,2008,16,domingo,Regular Season,12-3,12,3,0,2,4,-2,11-4,11,4,0,3,3,0,New York Giants,1
2008-12-21,New England Patriots,Arizona Cardinals,47,7,2008,16,domingo,Regular Season,10-5,10,5,0,8,9,-1,8-7,8,7,0,19,15,4,New England Patriots,6
2008-12-21,Minnesota Vikings,Atlanta Falcons,17,24,2008,16,domingo,Regular Season,9-6,9,6,0,11,12,-1,10-5,10,5,0,7,8,-1,Atlanta Falcons,4
2008-12-21,Kansas City Chiefs,Miami Dolphins,31,38,2008,16,domingo,Regular Season,2-13,2,13,0,30,28,2,10-5,10,5,0,9,11,-2,Miami Dolphins,17
2008-12-21,Detroit Lions,New Orleans Saints,7,42,2008,16,domingo,Regular Season,0-15,0,15,0,32,32,0,8-7,8,7,0,17,19,-2,New Orleans Saints,13
2008-12-21,Denver Broncos,Buffalo Bills,23,30,2008,16,domingo,Regular Season,8-7,8,7,0,20,17,3,7-8,7,8,0,22,22,0,Buffalo Bills,5
2008-12-21,Cleveland Browns,Cincinnati Bengals,0,14,2008,16,domingo,Regular Season,4-11,4,11,0,28,26,2,3-11,3,11,0,29,29,0,Cincinnati Bengals,3
2008-12-20,Dallas Cowboys,Baltimore Ravens,24,33,2008,16,sábado,Regular Season,9-6,9,6,0,10,6,4,10-5,10,5,0,6,7,-1,Baltimore Ravens,1
2008-12-18,Jacksonville Jaguars,Indianapolis Colts,24,31,2008,16,quinta,Regular Season,5-10,5,10,0,25,23,2,11-4,11,4,0,5,5,0,Indianapolis Colts,18
2008-12-15,Philadelphia Eagles,Cleveland Browns,30,10,2008,15,segunda,Regular Season,8-5,8,5,0,13,14,-1,4-10,4,10,0,26,26,0,Philadelphia Eagles,12
2008-12-14,Los Angeles Rams,Seattle Seahawks,20,23,2008,15,domingo,Regular Season,2-12,2,12,0,31,30,1,3-11,3,11,0,27,28,-1,Seattle Seahawks,2
2008-12-14,Oakland Raiders,New England Patriots,26,49,2008,15,domingo,Regular Season,3-11,3,11,0,30,29,1,9-5,9,5,0,9,10,-1,New England Patriots,19
2008-12-14,New York Jets,Buffalo Bills,31,27,2008,15,domingo,Regular Season,9-5,9,5,0,14,13,1,6-8,6,8,0,22,22,0,New York Jets,9
2008-12-14,Miami Dolphins,San Francisco 49ers,14,9,2008,15,domingo,Regular Season,9-5,9,5,0,11,12,-1,5-9,5,9,0,24,24,0,Miami Dolphins,12
2008-12-14,Kansas City Chiefs,Los Angeles Chargers,21,22,2008,15,domingo,Regular Season,2-12,2,12,0,28,27,1,6-8,6,8,0,21,21,0,Los Angeles Chargers,6
2008-12-14,Jacksonville Jaguars,Green Bay Packers,20,16,2008,15,domingo,Regular Season,5-9,5,9,0,23,25,-2,5-9,5,9,0,25,23,2,Jacksonville Jaguars,2
2008-12-14,Indianapolis Colts,Detroit Lions,31,21,2008,15,domingo,Regular Season,10-4,10,4,0,5,5,0,0-14,0,14,0,32,32,0,Indianapolis Colts,27
2008-12-14,Houston Texans,Tennessee Titans,13,12,2008,15,domingo,Regular Season,7-7,7,7,0,18,20,-2,12-2,12,2,0,2,1,1,Houston Texans,19
2008-12-14,Dallas Cowboys,New York Giants,20,8,2008,15,domingo,Regular Season,9-5,9,5,0,6,8,-2,11-3,11,3,0,4,2,2,Dallas Cowboys,6
2008-12-14,Cincinnati Bengals,Washington Redskins,20,13,2008,15,domingo,Regular Season,2-11,2,11,0,29,31,-2,7-7,7,7,0,20,18,2,Cincinnati Bengals,13
2008-12-14,Carolina Panthers,Denver Broncos,30,10,2008,15,domingo,Regular Season,11-3,11,3,0,3,4,-1,8-6,8,6,0,17,16,1,Carolina Panthers,12
2008-12-14,Baltimore Ravens,Pittsburgh Steelers,9,13,2008,15,domingo,Regular Season,9-5,9,5,0,7,7,0,11-3,11,3,0,1,3,-2,Pittsburgh Steelers,4
2008-12-14,Atlanta Falcons,Tampa Bay Buccaneers,13,10,2008,15,domingo,Regular Season,9-5,9,5,0,8,11,-3,9-5,9,5,0,10,6,4,Atlanta Falcons,5
2008-12-14,Arizona Cardinals,Minnesota Vikings,14,35,2008,15,domingo,Regular Season,8-6,8,6,0,15,9,6,9-5,9,5,0,12,15,-3,Minnesota Vikings,6
2008-12-11,Chicago Bears,New Orleans Saints,27,24,2008,15,quinta,Regular Season,8-6,8,6,0,16,19,-3,7-7,7,7,0,19,17,2,Chicago Bears,2
2008-12-08,Carolina Panthers,Tampa Bay Buccaneers,38,23,2008,14,segunda,Regular Season,10-3,10,3,0,4,5,-1,9-4,9,4,0,6,4,2,Carolina Panthers,1
2008-12-07,Tennessee Titans,Cleveland Browns,28,9,2008,14,domingo,Regular Season,12-1,12,1,0,1,2,-1,4-9,4,9,0,26,26,0,Tennessee Titans,24
2008-12-07,Seattle Seahawks,New England Patriots,21,24,2008,14,domingo,Regular Season,2-11,2,11,0,28,29,-1,8-5,8,5,0,10,11,-1,New England Patriots,18
2008-12-07,San Francisco 49ers,New York Jets,24,14,2008,14,domingo,Regular Season,5-8,5,8,0,24,25,-1,8-5,8,5,0,13,7,6,San Francisco 49ers,18
2008-12-07,Pittsburgh Steelers,Dallas Cowboys,20,13,2008,14,domingo,Regular Season,10-3,10,3,0,3,3,0,8-5,8,5,0,8,8,0,Pittsburgh Steelers,5
2008-12-07,New York Giants,Philadelphia Eagles,14,20,2008,14,domingo,Regular Season,11-2,11,2,0,2,1,1,7-5,7,5,0,14,17,-3,Philadelphia Eagles,16
2008-12-07,New Orleans Saints,Atlanta Falcons,29,25,2008,14,domingo,Regular Season,7-6,7,6,0,17,18,-1,8-5,8,5,0,11,9,2,New Orleans Saints,9
2008-12-07,Indianapolis Colts,Cincinnati Bengals,35,3,2008,14,domingo,Regular Season,9-4,9,4,0,5,6,-1,1-11,1,11,0,31,31,0,Indianapolis Colts,25
2008-12-07,Green Bay Packers,Houston Texans,21,24,2008,14,domingo,Regular Season,5-8,5,8,0,23,20,3,6-7,6,7,0,20,22,-2,Houston Texans,2
2008-12-07,Detroit Lions,Minnesota Vikings,16,20,2008,14,domingo,Regular Season,0-13,0,13,0,32,32,0,8-5,8,5,0,15,15,0,Minnesota Vikings,17
2008-12-07,Denver Broncos,Kansas City Chiefs,24,17,2008,14,domingo,Regular Season,8-5,8,5,0,16,14,2,2-11,2,11,0,27,27,0,Denver Broncos,13
2008-12-07,Chicago Bears,Jacksonville Jaguars,23,10,2008,14,domingo,Regular Season,7-6,7,6,0,19,19,0,4-9,4,9,0,25,24,1,Chicago Bears,5
2008-12-07,Buffalo Bills,Miami Dolphins,3,16,2008,14,domingo,Regular Season,6-7,6,7,0,22,21,1,8-5,8,5,0,12,16,-4,Miami Dolphins,5
2008-12-07,Baltimore Ravens,Washington Redskins,24,10,2008,14,domingo,Regular Season,9-4,9,4,0,7,10,-3,7-6,7,6,0,18,13,5,Baltimore Ravens,3
2008-12-07,Arizona Cardinals,Los Angeles Rams,34,10,2008,14,domingo,Regular Season,8-5,8,5,0,9,12,-3,2-11,2,11,0,30,30,0,Arizona Cardinals,18
2008-12-04,Los Angeles Chargers,Oakland Raiders,34,7,2008,14,quinta,Regular Season,5-8,5,8,0,21,23,-2,3-10,3,10,0,29,28,1,Los Angeles Chargers,5
2008-12-01,Houston Texans,Jacksonville Jaguars,30,17,2008,13,segunda,Regular Season,5-7,5,7,0,22,23,-1,4-8,4,8,0,24,24,0,Houston Texans,1
2008-11-30,Washington Redskins,New York Giants,7,23,2008,13,domingo,Regular Season,7-5,7,5,0,13,12,1,11-1,11,1,0,1,1,0,New York Giants,11
2008-11-30,Tampa Bay Buccaneers,New Orleans Saints,23,20,2008,13,domingo,Regular Season,9-3,9,3,0,4,5,-1,6-6,6,6,0,18,16,2,Tampa Bay Buccaneers,11
2008-11-30,Los Angeles Rams,Miami Dolphins,12,16,2008,13,domingo,Regular Season,2-10,2,10,0,30,29,1,7-5,7,5,0,16,14,2,Miami Dolphins,15
2008-11-30,Los Angeles Chargers,Atlanta Falcons,16,22,2008,13,domingo,Regular Season,4-8,4,8,0,23,22,1,8-4,8,4,0,9,10,-1,Atlanta Falcons,12
2008-11-30,Oakland Raiders,Kansas City Chiefs,13,20,2008,13,domingo,Regular Season,3-9,3,9,0,28,26,2,2-10,2,10,0,27,31,-4,Kansas City Chiefs,5
2008-11-30,New York Jets,Denver Broncos,17,34,2008,13,domingo,Regular Season,8-4,8,4,0,7,3,4,7-5,7,5,0,14,19,-5,Denver Broncos,16
2008-11-30,New England Patriots,Pittsburgh Steelers,10,33,2008,13,domingo,Regular Season,7-5,7,5,0,11,8,3,9-3,9,3,0,3,4,-1,Pittsburgh Steelers,4
2008-11-30,Minnesota Vikings,Chicago Bears,34,14,2008,13,domingo,Regular Season,7-5,7,5,0,15,17,-2,6-6,6,6,0,19,15,4,Minnesota Vikings,2
2008-11-30,Green Bay Packers,Carolina Panthers,31,35,2008,13,domingo,Regular Season,5-7,5,7,0,20,20,0,9-3,9,3,0,5,7,-2,Carolina Panthers,13
2008-11-30,Cleveland Browns,Indianapolis Colts,6,10,2008,13,domingo,Regular Season,4-8,4,8,0,26,25,1,8-4,8,4,0,6,6,0,Indianapolis Colts,19
2008-11-30,Cincinnati Bengals,Baltimore Ravens,3,34,2008,13,domingo,Regular Season,1-10,1,10,0,31,30,1,8-4,8,4,0,10,13,-3,Baltimore Ravens,17
2008-11-30,Buffalo Bills,San Francisco 49ers,3,10,2008,13,domingo,Regular Season,6-6,6,6,0,21,18,3,4-8,4,8,0,25,27,-2,San Francisco 49ers,9
2008-11-27,Philadelphia Eagles,Arizona Cardinals,48,20,2008,13,quinta,Regular Season,6-5,6,5,0,17,21,-4,7-5,7,5,0,12,11,1,Philadelphia Eagles,10
2008-11-27,Detroit Lions,Tennessee Titans,10,47,2008,13,quinta,Regular Season,0-12,0,12,0,32,32,0,11-1,11,1,0,2,2,0,Tennessee Titans,30
2008-11-27,Dallas Cowboys,Seattle Seahawks,34,9,2008,13,quinta,Regular Season,8-4,8,4,0,8,9,-1,2-10,2,10,0,29,28,1,Dallas Cowboys,19
2008-11-24,New Orleans Saints,Green Bay Packers,51,29,2008,12,segunda,Regular Season,6-5,6,5,0,16,20,-4,5-6,5,6,0,20,16,4,New Orleans Saints,4
2008-11-23,Tennessee Titans,New York Jets,13,34,2008,12,domingo,Regular Season,10-1,10,1,0,2,1,1,8-3,8,3,0,3,6,-3,New York Jets,5
2008-11-23,Los Angeles Rams,Chicago Bears,3,27,2008,12,domingo,Regular Season,2-9,2,9,0,29,28,1,6-5,6,5,0,15,19,-4,Chicago Bears,9
2008-11-23,Seattle Seahawks,Washington Redskins,17,20,2008,12,domingo,Regular Season,2-9,2,9,0,28,27,1,7-4,7,4,0,12,9,3,Washington Redskins,18
2008-11-23,Los Angeles Chargers,Indianapolis Colts,20,23,2008,12,domingo,Regular Season,4-7,4,7,0,22,22,0,7-4,7,4,0,6,8,-2,Indianapolis Colts,14
2008-11-23,Miami Dolphins,New England Patriots,28,48,2008,12,domingo,Regular Season,6-5,6,5,0,14,12,2,7-4,7,4,0,8,10,-2,New England Patriots,2
2008-11-23,Kansas City Chiefs,Buffalo Bills,31,54,2008,12,domingo,Regular Season,1-10,1,10,0,31,30,1,6-5,6,5,0,18,18,0,Buffalo Bills,12
2008-11-23,Jacksonville Jaguars,Minnesota Vikings,12,30,2008,12,domingo,Regular Season,4-7,4,7,0,24,23,1,6-5,6,5,0,17,21,-4,Minnesota Vikings,2
2008-11-23,Detroit Lions,Tampa Bay Buccaneers,20,38,2008,12,domingo,Regular Season,0-11,0,11,0,32,32,0,8-3,8,3,0,5,5,0,Tampa Bay Buccaneers,27
2008-11-23,Denver Broncos,Oakland Raiders,10,31,2008,12,domingo,Regular Season,6-5,6,5,0,19,15,4,3-8,3,8,0,26,31,-5,Oakland Raiders,16
2008-11-23,Dallas Cowboys,San Francisco 49ers,35,22,2008,12,domingo,Regular Season,7-4,7,4,0,9,11,-2,3-8,3,8,0,27,26,1,Dallas Cowboys,15
2008-11-23,Cleveland Browns,Houston Texans,6,16,2008,12,domingo,Regular Season,4-7,4,7,0,25,24,1,4-7,4,7,0,23,25,-2,Houston Texans,1
2008-11-23,Baltimore Ravens,Philadelphia Eagles,36,7,2008,12,domingo,Regular Season,7-4,7,4,0,13,13,0,5-5,5,5,0,21,17,4,Baltimore Ravens,4
2008-11-23,Atlanta Falcons,Carolina Panthers,45,28,2008,12,domingo,Regular Season,7-4,7,4,0,10,14,-4,8-3,8,3,0,7,3,4,Atlanta Falcons,11
2008-11-23,Arizona Cardinals,New York Giants,29,37,2008,12,domingo,Regular Season,7-4,7,4,0,11,7,4,10-1,10,1,0,1,2,-1,New York Giants,5
2008-11-20,Pittsburgh Steelers,Cincinnati Bengals,27,10,2008,12,quinta,Regular Season,8-3,8,3,0,4,4,0,1-9,1,9,0,30,29,1,Pittsburgh Steelers,25
2008-11-17,Buffalo Bills,Cleveland Browns,27,29,2008,11,segunda,Regular Season,5-5,5,5,0,18,17,1,4-6,4,6,0,24,24,0,Cleveland Browns,7
2008-11-16,Washington Redskins,Dallas Cowboys,10,14,2008,11,domingo,Regular Season,6-4,6,4,0,9,5,4,6-4,6,4,0,11,16,-5,Dallas Cowboys,11
2008-11-16,Tampa Bay Buccaneers,Minnesota Vikings,19,13,2008,11,domingo,Regular Season,7-3,7,3,0,5,6,-1,5-5,5,5,0,21,18,3,Tampa Bay Buccaneers,12
2008-11-16,Seattle Seahawks,Arizona Cardinals,20,26,2008,11,domingo,Regular Season,2-8,2,8,0,27,27,0,7-3,7,3,0,7,11,-4,Arizona Cardinals,16
2008-11-16,San Francisco 49ers,Los Angeles Rams,35,16,2008,11,domingo,Regular Season,3-7,3,7,0,26,26,0,2-8,2,8,0,28,28,0,San Francisco 49ers,2
2008-11-16,Pittsburgh Steelers,Los Angeles Chargers,11,10,2008,11,domingo,Regular Season,7-3,7,3,0,4,4,0,4-6,4,6,0,22,20,2,Pittsburgh Steelers,16
2008-11-16,New York Giants,Baltimore Ravens,30,10,2008,11,domingo,Regular Season,9-1,9,1,0,2,2,0,6-4,6,4,0,13,12,1,New York Giants,10
2008-11-16,Miami Dolphins,Oakland Raiders,17,15,2008,11,domingo,Regular Season,6-4,6,4,0,12,15,-3,2-8,2,8,0,31,31,0,Miami Dolphins,16
2008-11-16,Kansas City Chiefs,New Orleans Saints,20,30,2008,11,domingo,Regular Season,1-9,1,9,0,30,29,1,5-5,5,5,0,20,23,-3,New Orleans Saints,6
2008-11-16,Jacksonville Jaguars,Tennessee Titans,14,24,2008,11,domingo,Regular Season,4-6,4,6,0,23,22,1,10-0,10,0,0,1,1,0,Tennessee Titans,21
2008-11-16,Indianapolis Colts,Houston Texans,33,27,2008,11,domingo,Regular Season,6-4,6,4,0,8,10,-2,3-7,3,7,0,25,25,0,Indianapolis Colts,15
2008-11-16,Green Bay Packers,Chicago Bears,37,3,2008,11,domingo,Regular Season,5-5,5,5,0,16,21,-5,5-5,5,5,0,19,14,5,Green Bay Packers,7
2008-11-16,Cincinnati Bengals,Philadelphia Eagles,13,13,2008,11,domingo,Regular Season,1-8,1,8,0,29,30,-1,5-4,5,4,0,17,13,4,Draw,17
2008-11-16,Carolina Panthers,Detroit Lions,31,22,2008,11,domingo,Regular Season,8-2,8,2,0,3,3,0,0-10,0,10,0,32,32,0,Carolina Panthers,29
2008-11-16,Atlanta Falcons,Denver Broncos,20,24,2008,11,domingo,Regular Season,6-4,6,4,0,14,8,6,6-4,6,4,0,15,19,-4,Denver Broncos,11
2008-11-13,New England Patriots,New York Jets,31,34,2008,11,quinta,Regular Season,6-4,6,4,0,10,7,3,7-3,7,3,0,6,9,-3,New York Jets,2
2008-11-10,Arizona Cardinals,San Francisco 49ers,29,24,2008,10,segunda,Regular Season,6-3,6,3,0,11,8,3,2-7,2,7,0,26,28,-2,Arizona Cardinals,20
2008-11-09,Los Angeles Chargers,Kansas City Chiefs,20,19,2008,10,domingo,Regular Season,4-5,4,5,0,20,21,-1,1-8,1,8,0,29,31,-2,Los Angeles Chargers,10
2008-11-09,Pittsburgh Steelers,Indianapolis Colts,20,24,2008,10,domingo,Regular Season,6-3,6,3,0,4,3,1,5-4,5,4,0,10,15,-5,Indianapolis Colts,12
2008-11-09,Philadelphia Eagles,New York Giants,31,36,2008,10,domingo,Regular Season,5-4,5,4,0,13,6,7,8-1,8,1,0,2,2,0,New York Giants,4
2008-11-09,Oakland Raiders,Carolina Panthers,6,17,2008,10,domingo,Regular Season,2-7,2,7,0,31,30,1,7-2,7,2,0,3,4,-1,Carolina Panthers,26
2008-11-09,New York Jets,Los Angeles Rams,47,3,2008,10,domingo,Regular Season,6-3,6,3,0,9,11,-2,2-7,2,7,0,28,26,2,New York Jets,15
2008-11-09,New England Patriots,Buffalo Bills,20,10,2008,10,domingo,Regular Season,6-3,6,3,0,7,12,-5,5-4,5,4,0,17,14,3,New England Patriots,2
2008-11-09,Minnesota Vikings,Green Bay Packers,28,27,2008,10,domingo,Regular Season,5-4,5,4,0,18,20,-2,4-5,4,5,0,21,16,5,Minnesota Vikings,4
2008-11-09,Miami Dolphins,Seattle Seahawks,21,19,2008,10,domingo,Regular Season,5-4,5,4,0,15,17,-2,2-7,2,7,0,27,27,0,Miami Dolphins,10
2008-11-09,Houston Texans,Baltimore Ravens,13,41,2008,10,domingo,Regular Season,3-6,3,6,0,25,25,0,6-3,6,3,0,12,13,-1,Baltimore Ravens,12
2008-11-09,Detroit Lions,Jacksonville Jaguars,14,38,2008,10,domingo,Regular Season,0-9,0,9,0,32,32,0,4-5,4,5,0,22,23,-1,Jacksonville Jaguars,9
2008-11-09,Chicago Bears,Tennessee Titans,14,21,2008,10,domingo,Regular Season,5-4,5,4,0,14,9,5,9-0,9,0,0,1,1,0,Tennessee Titans,8
2008-11-09,Atlanta Falcons,New Orleans Saints,34,20,2008,10,domingo,Regular Season,6-3,6,3,0,8,10,-2,4-5,4,5,0,23,18,5,Atlanta Falcons,8
2008-11-06,Cleveland Browns,Denver Broncos,30,34,2008,10,quinta,Regular Season,3-6,3,6,0,24,24,0,5-4,5,4,0,19,22,-3,Denver Broncos,2
2008-11-03,Washington Redskins,Pittsburgh Steelers,6,23,2008,9,segunda,Regular Season,6-3,6,3,0,5,5,0,6-2,6,2,0,3,4,-1,Pittsburgh Steelers,1
2008-11-02,Tennessee Titans,Green Bay Packers,19,16,2008,9,domingo,Regular Season,8-0,8,0,0,1,1,0,4-4,4,4,0,16,11,5,Tennessee Titans,10
2008-11-02,Los Angeles Rams,Arizona Cardinals,13,34,2008,9,domingo,Regular Season,2-6,2,6,0,26,26,0,5-3,5,3,0,8,13,-5,Arizona Cardinals,13
2008-11-02,Seattle Seahawks,Philadelphia Eagles,7,26,2008,9,domingo,Regular Season,2-6,2,6,0,27,27,0,5-3,5,3,0,6,10,-4,Philadelphia Eagles,17
2008-11-02,Oakland Raiders,Atlanta Falcons,0,24,2008,9,domingo,Regular Season,2-6,2,6,0,30,28,2,5-3,5,3,0,10,16,-6,Atlanta Falcons,12
2008-11-02,New York Giants,Dallas Cowboys,35,14,2008,9,domingo,Regular Season,7-1,7,1,0,2,2,0,5-4,5,4,0,19,8,11,New York Giants,6
2008-11-02,Minnesota Vikings,Houston Texans,28,21,2008,9,domingo,Regular Season,4-4,4,4,0,20,23,-3,3-5,3,5,0,25,25,0,Minnesota Vikings,2
2008-11-02,Kansas City Chiefs,Tampa Bay Buccaneers,27,30,2008,9,domingo,Regular Season,1-7,1,7,0,31,30,1,6-3,6,3,0,7,9,-2,Tampa Bay Buccaneers,21
2008-11-02,Indianapolis Colts,New England Patriots,18,15,2008,9,domingo,Regular Season,4-4,4,4,0,15,18,-3,5-3,5,3,0,12,7,5,Indianapolis Colts,11
2008-11-02,Denver Broncos,Miami Dolphins,17,26,2008,9,domingo,Regular Season,4-4,4,4,0,22,15,7,4-4,4,4,0,17,24,-7,Miami Dolphins,9
2008-11-02,Cleveland Browns,Baltimore Ravens,27,37,2008,9,domingo,Regular Season,3-5,3,5,0,24,22,2,5-3,5,3,0,13,14,-1,Baltimore Ravens,8
2008-11-02,Cincinnati Bengals,Jacksonville Jaguars,21,19,2008,9,domingo,Regular Season,1-8,1,8,0,29,31,-2,3-5,3,5,0,23,20,3,Cincinnati Bengals,11
2008-11-02,Chicago Bears,Detroit Lions,27,23,2008,9,domingo,Regular Season,5-3,5,3,0,9,12,-3,0-8,0,8,0,32,32,0,Chicago Bears,20
2008-11-02,Buffalo Bills,New York Jets,17,26,2008,9,domingo,Regular Season,5-3,5,3,0,14,6,8,5-3,5,3,0,11,19,-8,New York Jets,13
2008-10-27,Tennessee Titans,Indianapolis Colts,31,21,2008,8,segunda,Regular Season,7-0,7,0,0,1,1,0,3-4,3,4,0,18,16,2,Tennessee Titans,15
2008-10-26,San Francisco 49ers,Seattle Seahawks,13,34,2008,8,domingo,Regular Season,2-6,2,6,0,29,28,1,2-5,2,5,0,27,29,-2,Seattle Seahawks,1
2008-10-26,Pittsburgh Steelers,New York Giants,14,21,2008,8,domingo,Regular Season,5-2,5,2,0,4,3,1,6-1,6,1,0,2,2,0,New York Giants,1
2008-10-26,Philadelphia Eagles,Atlanta Falcons,27,14,2008,8,domingo,Regular Season,4-3,4,3,0,10,11,-1,4-3,4,3,0,16,14,2,Philadelphia Eagles,3
2008-10-26,New York Jets,Kansas City Chiefs,28,24,2008,8,domingo,Regular Season,4-3,4,3,0,19,19,0,1-6,1,6,0,30,30,0,New York Jets,11
2008-10-26,New Orleans Saints,Los Angeles Chargers,37,32,2008,8,domingo,Regular Season,4-4,4,4,0,17,21,-4,3-5,3,5,0,21,17,4,New Orleans Saints,4
2008-10-26,New England Patriots,Los Angeles Rams,23,16,2008,8,domingo,Regular Season,5-2,5,2,0,7,9,-2,2-5,2,5,0,26,25,1,New England Patriots,16
2008-10-26,Miami Dolphins,Buffalo Bills,25,16,2008,8,domingo,Regular Season,3-4,3,4,0,24,26,-2,5-2,5,2,0,6,4,2,Miami Dolphins,22
2008-10-26,Jacksonville Jaguars,Cleveland Browns,17,23,2008,8,domingo,Regular Season,3-4,3,4,0,20,12,8,3-4,3,4,0,22,24,-2,Cleveland Browns,12
2008-10-26,Houston Texans,Cincinnati Bengals,35,6,2008,8,domingo,Regular Season,3-4,3,4,0,25,23,2,0-8,0,8,0,31,31,0,Houston Texans,8
2008-10-26,Detroit Lions,Washington Redskins,17,25,2008,8,domingo,Regular Season,0-7,0,7,0,32,32,0,6-2,6,2,0,5,5,0,Washington Redskins,27
2008-10-26,Dallas Cowboys,Tampa Bay Buccaneers,13,9,2008,8,domingo,Regular Season,5-3,5,3,0,8,15,-7,5-3,5,3,0,9,6,3,Dallas Cowboys,9
2008-10-26,Carolina Panthers,Arizona Cardinals,27,23,2008,8,domingo,Regular Season,6-2,6,2,0,3,7,-4,4-3,4,3,0,13,8,5,Carolina Panthers,1
2008-10-26,Baltimore Ravens,Oakland Raiders,29,10,2008,8,domingo,Regular Season,4-3,4,3,0,14,20,-6,2-5,2,5,0,28,27,1,Baltimore Ravens,7
2008-10-20,New England Patriots,Denver Broncos,41,7,2008,7,segunda,Regular Season,4-2,4,2,0,9,17,-8,4-3,4,3,0,18,12,6,New England Patriots,5
2008-10-19,Washington Redskins,Cleveland Browns,14,11,2008,7,domingo,Regular Season,5-2,5,2,0,5,5,0,2-4,2,4,0,24,22,2,Washington Redskins,17
2008-10-19,Tampa Bay Buccaneers,Seattle Seahawks,20,10,2008,7,domingo,Regular Season,5-2,5,2,0,6,7,-1,1-5,1,5,0,29,27,2,Tampa Bay Buccaneers,20
2008-10-19,Los Angeles Rams,Dallas Cowboys,34,14,2008,7,domingo,Regular Season,2-4,2,4,0,25,28,-3,4-3,4,3,0,15,6,9,Los Angeles Rams,22
2008-10-19,Oakland Raiders,New York Jets,16,13,2008,7,domingo,Regular Season,2-4,2,4,0,27,29,-2,3-3,3,3,0,19,16,3,Oakland Raiders,13
2008-10-19,New York Giants,San Francisco 49ers,29,17,2008,7,domingo,Regular Season,5-1,5,1,0,2,2,0,2-5,2,5,0,28,25,3,New York Giants,23
2008-10-19,Miami Dolphins,Baltimore Ravens,13,27,2008,7,domingo,Regular Season,2-4,2,4,0,26,24,2,3-3,3,3,0,20,23,-3,Baltimore Ravens,1
2008-10-19,Kansas City Chiefs,Tennessee Titans,10,34,2008,7,domingo,Regular Season,1-5,1,5,0,30,30,0,6-0,6,0,0,1,1,0,Tennessee Titans,29
2008-10-19,Houston Texans,Detroit Lions,28,21,2008,7,domingo,Regular Season,2-4,2,4,0,23,26,-3,0-6,0,6,0,32,32,0,Houston Texans,6
2008-10-19,Green Bay Packers,Indianapolis Colts,34,14,2008,7,domingo,Regular Season,4-3,4,3,0,10,19,-9,3-3,3,3,0,16,8,8,Green Bay Packers,11
2008-10-19,Cincinnati Bengals,Pittsburgh Steelers,10,38,2008,7,domingo,Regular Season,0-7,0,7,0,31,31,0,5-1,5,1,0,3,3,0,Pittsburgh Steelers,28
2008-10-19,Chicago Bears,Minnesota Vikings,48,41,2008,7,domingo,Regular Season,4-3,4,3,0,13,20,-7,3-4,3,4,0,22,21,1,Chicago Bears,1
2008-10-19,Carolina Panthers,New Orleans Saints,30,7,2008,7,domingo,Regular Season,5-2,5,2,0,7,10,-3,3-4,3,4,0,21,18,3,Carolina Panthers,8
2008-10-19,Buffalo Bills,Los Angeles Chargers,23,14,2008,7,domingo,Regular Season,5-1,5,1,0,4,4,0,3-4,3,4,0,17,11,6,Buffalo Bills,7
2008-10-13,Cleveland Browns,New York Giants,35,14,2008,6,segunda,Regular Season,2-3,2,3,0,22,25,-3,4-1,4,1,0,2,1,1,Cleveland Browns,24
2008-10-12,Washington Redskins,Los Angeles Rams,17,19,2008,6,domingo,Regular Season,4-2,4,2,0,5,3,2,1-4,1,4,0,28,32,-4,Los Angeles Rams,29
2008-10-12,Tampa Bay Buccaneers,Carolina Panthers,27,3,2008,6,domingo,Regular Season,4-2,4,2,0,7,13,-6,4-2,4,2,0,10,6,4,Tampa Bay Buccaneers,7
2008-10-12,Seattle Seahawks,Green Bay Packers,17,27,2008,6,domingo,Regular Season,1-4,1,4,0,27,26,1,3-3,3,3,0,19,21,-2,Green Bay Packers,5
2008-10-12,San Francisco 49ers,Philadelphia Eagles,26,40,2008,6,domingo,Regular Season,2-4,2,4,0,25,24,1,3-3,3,3,0,13,12,1,Philadelphia Eagles,12
2008-10-12,Los Angeles Chargers,New England Patriots,30,10,2008,6,domingo,Regular Season,3-3,3,3,0,11,16,-5,3-2,3,2,0,17,9,8,Los Angeles Chargers,7
2008-10-12,New York Jets,Cincinnati Bengals,26,14,2008,6,domingo,Regular Season,3-2,3,2,0,16,18,-2,0-6,0,6,0,31,30,1,New York Jets,12
2008-10-12,New Orleans Saints,Oakland Raiders,34,3,2008,6,domingo,Regular Season,3-3,3,3,0,18,22,-4,1-4,1,4,0,29,27,2,New Orleans Saints,5
2008-10-12,Minnesota Vikings,Detroit Lions,12,10,2008,6,domingo,Regular Season,3-3,3,3,0,21,19,2,0-5,0,5,0,32,31,1,Minnesota Vikings,12
2008-10-12,Indianapolis Colts,Baltimore Ravens,31,3,2008,6,domingo,Regular Season,3-2,3,2,0,8,11,-3,2-3,2,3,0,23,15,8,Indianapolis Colts,4
2008-10-12,Houston Texans,Miami Dolphins,29,28,2008,6,domingo,Regular Season,1-4,1,4,0,26,28,-2,2-3,2,3,0,24,23,1,Houston Texans,5
2008-10-12,Denver Broncos,Jacksonville Jaguars,17,24,2008,6,domingo,Regular Season,4-2,4,2,0,12,7,5,3-3,3,3,0,14,17,-3,Jacksonville Jaguars,10
2008-10-12,Atlanta Falcons,Chicago Bears,22,20,2008,6,domingo,Regular Season,4-2,4,2,0,15,20,-5,3-3,3,3,0,20,10,10,Atlanta Falcons,10
2008-10-12,Arizona Cardinals,Dallas Cowboys,30,24,2008,6,domingo,Regular Season,4-2,4,2,0,9,14,-5,4-2,4,2,0,6,4,2,Arizona Cardinals,10
2008-10-06,New Orleans Saints,Minnesota Vikings,27,30,2008,5,segunda,Regular Season,2-3,2,3,0,22,16,6,2-3,2,3,0,19,21,-2,Minnesota Vikings,5
2008-10-05,San Francisco 49ers,New England Patriots,21,30,2008,5,domingo,Regular Season,2-3,2,3,0,24,22,2,3-1,3,1,0,9,13,-4,New England Patriots,9
2008-10-05,Philadelphia Eagles,Washington Redskins,17,23,2008,5,domingo,Regular Season,2-3,2,3,0,12,9,3,4-1,4,1,0,3,6,-3,Washington Redskins,3
2008-10-05,New York Giants,Seattle Seahawks,44,6,2008,5,domingo,Regular Season,4-0,4,0,0,1,1,0,1-3,1,3,0,26,23,3,New York Giants,22
2008-10-05,Miami Dolphins,Los Angeles Chargers,17,10,2008,5,domingo,Regular Season,2-2,2,2,0,23,26,-3,2-3,2,3,0,16,8,8,Miami Dolphins,18
2008-10-05,Jacksonville Jaguars,Pittsburgh Steelers,21,26,2008,5,domingo,Regular Season,2-3,2,3,0,17,12,5,4-1,4,1,0,5,5,0,Pittsburgh Steelers,7
2008-10-05,Houston Texans,Indianapolis Colts,27,31,2008,5,domingo,Regular Season,0-4,0,4,0,28,27,1,2-2,2,2,0,11,17,-6,Indianapolis Colts,10
2008-10-05,Green Bay Packers,Atlanta Falcons,24,27,2008,5,domingo,Regular Season,2-3,2,3,0,21,15,6,3-2,3,2,0,20,24,-4,Atlanta Falcons,9
2008-10-05,Detroit Lions,Chicago Bears,7,34,2008,5,domingo,Regular Season,0-4,0,4,0,31,31,0,3-2,3,2,0,10,18,-8,Chicago Bears,13
2008-10-05,Denver Broncos,Tampa Bay Buccaneers,16,13,2008,5,domingo,Regular Season,4-1,4,1,0,7,11,-4,3-2,3,2,0,13,10,3,Denver Broncos,1
2008-10-05,Dallas Cowboys,Cincinnati Bengals,31,22,2008,5,domingo,Regular Season,4-1,4,1,0,4,3,1,0-5,0,5,0,30,30,0,Dallas Cowboys,27
2008-10-05,Carolina Panthers,Kansas City Chiefs,34,0,2008,5,domingo,Regular Season,4-1,4,1,0,6,7,-1,1-4,1,4,0,29,29,0,Carolina Panthers,22
2008-10-05,Baltimore Ravens,Tennessee Titans,10,13,2008,5,domingo,Regular Season,2-2,2,2,0,15,14,1,5-0,5,0,0,2,2,0,Tennessee Titans,12
2008-10-05,Arizona Cardinals,Buffalo Bills,41,17,2008,5,domingo,Regular Season,3-2,3,2,0,14,20,-6,4-1,4,1,0,8,4,4,Arizona Cardinals,16
2008-09-29,Pittsburgh Steelers,Baltimore Ravens,20,23,2008,4,segunda,Regular Season,3-1,3,1,0,5,5,0,2-1,2,1,0,14,17,-3,Baltimore Ravens,12
2008-09-28,Tennessee Titans,Minnesota Vikings,30,17,2008,4,domingo,Regular Season,4-0,4,0,0,2,4,-2,1-3,1,3,0,21,19,2,Tennessee Titans,15
2008-09-28,Tampa Bay Buccaneers,Green Bay Packers,30,21,2008,4,domingo,Regular Season,3-1,3,1,0,10,13,-3,2-2,2,2,0,15,8,7,Tampa Bay Buccaneers,5
2008-09-28,Los Angeles Rams,Buffalo Bills,14,31,2008,4,domingo,Regular Season,0-4,0,4,0,32,32,0,4-0,4,0,0,4,6,-2,Buffalo Bills,26
2008-09-28,Oakland Raiders,Los Angeles Chargers,18,28,2008,4,domingo,Regular Season,1-3,1,3,0,28,29,-1,2-2,2,2,0,8,9,-1,Los Angeles Chargers,20
2008-09-28,New York Jets,Arizona Cardinals,56,35,2008,4,domingo,Regular Season,2-2,2,2,0,19,21,-2,2-2,2,2,0,20,18,2,New York Jets,3
2008-09-28,New Orleans Saints,San Francisco 49ers,31,17,2008,4,domingo,Regular Season,2-2,2,2,0,16,16,0,2-2,2,2,0,22,22,0,New Orleans Saints,6
2008-09-28,Kansas City Chiefs,Denver Broncos,33,19,2008,4,domingo,Regular Season,1-3,1,3,0,29,31,-2,3-1,3,1,0,11,7,4,Kansas City Chiefs,24
2008-09-28,Jacksonville Jaguars,Houston Texans,30,27,2008,4,domingo,Regular Season,2-2,2,2,0,12,14,-2,0-3,0,3,0,27,27,0,Jacksonville Jaguars,13
2008-09-28,Dallas Cowboys,Washington Redskins,24,26,2008,4,domingo,Regular Season,3-1,3,1,0,3,1,2,3-1,3,1,0,6,15,-9,Washington Redskins,14
2008-09-28,Cincinnati Bengals,Cleveland Browns,12,20,2008,4,domingo,Regular Season,0-4,0,4,0,30,28,2,1-3,1,3,0,25,26,-1,Cleveland Browns,2
2008-09-28,Chicago Bears,Philadelphia Eagles,24,20,2008,4,domingo,Regular Season,2-2,2,2,0,18,20,-2,2-2,2,2,0,9,3,6,Chicago Bears,17
2008-09-28,Carolina Panthers,Atlanta Falcons,24,9,2008,4,domingo,Regular Season,3-1,3,1,0,7,10,-3,2-2,2,2,0,24,24,0,Carolina Panthers,14
2008-09-22,Los Angeles Chargers,New York Jets,48,29,2008,3,segunda,Regular Season,1-2,1,2,0,9,13,-4,1-2,1,2,0,21,16,5,Los Angeles Chargers,3
2008-09-21,Washington Redskins,Arizona Cardinals,24,17,2008,3,domingo,Regular Season,2-1,2,1,0,15,19,-4,2-1,2,1,0,18,14,4,Washington Redskins,5
2008-09-21,Tennessee Titans,Houston Texans,31,12,2008,3,domingo,Regular Season,3-0,3,0,0,4,9,-5,0-2,0,2,0,27,24,3,Tennessee Titans,15
2008-09-21,Seattle Seahawks,Los Angeles Rams,37,13,2008,3,domingo,Regular Season,1-2,1,2,0,23,23,0,0-3,0,3,0,32,32,0,Seattle Seahawks,9
2008-09-21,San Francisco 49ers,Detroit Lions,31,13,2008,3,domingo,Regular Season,2-1,2,1,0,22,25,-3,0-3,0,3,0,30,29,1,San Francisco 49ers,4
2008-09-21,Philadelphia Eagles,Pittsburgh Steelers,15,6,2008,3,domingo,Regular Season,2-1,2,1,0,3,5,-2,2-1,2,1,0,5,2,3,Philadelphia Eagles,3
2008-09-21,New York Giants,Cincinnati Bengals,26,23,2008,3,domingo,Regular Season,3-0,3,0,0,2,3,-1,0-3,0,3,0,28,28,0,New York Giants,25
2008-09-21,New England Patriots,Miami Dolphins,13,38,2008,3,domingo,Regular Season,2-1,2,1,0,11,6,5,1-2,1,2,0,25,30,-5,Miami Dolphins,24
2008-09-21,Minnesota Vikings,Carolina Panthers,20,10,2008,3,domingo,Regular Season,1-2,1,2,0,19,21,-2,2-1,2,1,0,10,8,2,Minnesota Vikings,13
2008-09-21,Indianapolis Colts,Jacksonville Jaguars,21,23,2008,3,domingo,Regular Season,1-2,1,2,0,12,7,5,1-2,1,2,0,14,18,-4,Jacksonville Jaguars,11
2008-09-21,Green Bay Packers,Dallas Cowboys,16,27,2008,3,domingo,Regular Season,2-1,2,1,0,8,4,4,3-0,3,0,0,1,1,0,Dallas Cowboys,3
2008-09-21,Denver Broncos,New Orleans Saints,34,32,2008,3,domingo,Regular Season,3-0,3,0,0,7,11,-4,1-2,1,2,0,16,12,4,Denver Broncos,1
2008-09-21,Chicago Bears,Tampa Bay Buccaneers,24,27,2008,3,domingo,Regular Season,1-2,1,2,0,20,15,5,2-1,2,1,0,13,17,-4,Tampa Bay Buccaneers,2
2008-09-21,Buffalo Bills,Oakland Raiders,24,23,2008,3,domingo,Regular Season,3-0,3,0,0,6,10,-4,1-2,1,2,0,29,27,2,Buffalo Bills,17
2008-09-21,Baltimore Ravens,Cleveland Browns,28,10,2008,3,domingo,Regular Season,2-0,2,0,0,17,20,-3,0-3,0,3,0,26,22,4,Baltimore Ravens,2
2008-09-21,Atlanta Falcons,Kansas City Chiefs,38,14,2008,3,domingo,Regular Season,2-1,2,1,0,24,26,-2,0-3,0,3,0,31,31,0,Atlanta Falcons,5
2008-09-15,Dallas Cowboys,Philadelphia Eagles,41,37,2008,2,segunda,Regular Season,2-0,2,0,0,1,1,0,1-1,1,1,0,5,6,-1,Dallas Cowboys,5
2008-09-14,Washington Redskins,New Orleans Saints,29,24,2008,2,domingo,Regular Season,1-1,1,1,0,19,23,-4,1-1,1,1,0,12,4,8,Washington Redskins,19
2008-09-14,Tampa Bay Buccaneers,Atlanta Falcons,24,9,2008,2,domingo,Regular Season,1-1,1,1,0,17,20,-3,1-1,1,1,0,26,25,1,Tampa Bay Buccaneers,5
2008-09-14,Los Angeles Rams,New York Giants,13,41,2008,2,domingo,Regular Season,0-2,0,2,0,32,32,0,2-0,2,0,0,3,5,-2,New York Giants,27
2008-09-14,Seattle Seahawks,San Francisco 49ers,30,33,2008,2,domingo,Regular Season,0-2,0,2,0,23,18,5,1-1,1,1,0,25,27,-2,San Francisco 49ers,9
2008-09-14,New York Jets,New England Patriots,10,19,2008,2,domingo,Regular Season,1-1,1,1,0,16,14,2,2-0,2,0,0,6,9,-3,New England Patriots,5
2008-09-14,Minnesota Vikings,Indianapolis Colts,15,18,2008,2,domingo,Regular Season,0-2,0,2,0,21,16,5,1-1,1,1,0,7,8,-1,Indianapolis Colts,8
2008-09-14,Kansas City Chiefs,Oakland Raiders,8,23,2008,2,domingo,Regular Season,0-2,0,2,0,31,29,2,1-1,1,1,0,27,30,-3,Oakland Raiders,1
2008-09-14,Jacksonville Jaguars,Buffalo Bills,16,20,2008,2,domingo,Regular Season,0-2,0,2,0,18,10,8,2-0,2,0,0,10,13,-3,Buffalo Bills,3
2008-09-14,Detroit Lions,Green Bay Packers,25,48,2008,2,domingo,Regular Season,0-2,0,2,0,29,31,-2,2-0,2,0,0,4,7,-3,Green Bay Packers,24
2008-09-14,Denver Broncos,Los Angeles Chargers,39,38,2008,2,domingo,Regular Season,2-0,2,0,0,11,19,-8,0-2,0,2,0,13,3,10,Denver Broncos,16
2008-09-14,Cleveland Browns,Pittsburgh Steelers,6,10,2008,2,domingo,Regular Season,0-2,0,2,0,22,17,5,2-0,2,0,0,2,2,0,Pittsburgh Steelers,15
2008-09-14,Cincinnati Bengals,Tennessee Titans,7,24,2008,2,domingo,Regular Season,0-2,0,2,0,28,26,2,2-0,2,0,0,9,11,-2,Tennessee Titans,15
2008-09-14,Carolina Panthers,Chicago Bears,20,17,2008,2,domingo,Regular Season,2-0,2,0,0,8,12,-4,1-1,1,1,0,15,15,0,Carolina Panthers,3
2008-09-14,Arizona Cardinals,Miami Dolphins,31,10,2008,2,domingo,Regular Season,2-0,2,0,0,14,21,-7,0-2,0,2,0,30,28,2,Arizona Cardinals,7
2008-09-08,Oakland Raiders,Denver Broncos,14,41,2008,1,segunda,Regular Season,0-1,0,1,0,30,27,3,1-0,1,0,0,19,22,-3,Denver Broncos,5
2008-09-08,Green Bay Packers,Minnesota Vikings,24,19,2008,1,segunda,Regular Season,1-0,1,0,0,7,10,-3,0-1,0,1,0,16,11,5,Green Bay Packers,1
2008-09-07,Tennessee Titans,Jacksonville Jaguars,17,10,2008,1,domingo,Regular Season,1-0,1,0,0,11,14,-3,0-1,0,1,0,10,5,5,Tennessee Titans,9
2008-09-07,San Francisco 49ers,Arizona Cardinals,13,23,2008,1,domingo,Regular Season,0-1,0,1,0,27,29,-2,1-0,1,0,0,21,21,0,Arizona Cardinals,8
2008-09-07,Los Angeles Chargers,Carolina Panthers,24,26,2008,1,domingo,Regular Season,0-1,0,1,0,3,2,1,1-0,1,0,0,12,17,-5,Carolina Panthers,15
2008-09-07,Pittsburgh Steelers,Houston Texans,38,17,2008,1,domingo,Regular Season,1-0,1,0,0,2,6,-4,0-1,0,1,0,24,20,4,Pittsburgh Steelers,14
2008-09-07,Philadelphia Eagles,Los Angeles Rams,38,3,2008,1,domingo,Regular Season,1-0,1,0,0,6,12,-6,0-1,0,1,0,32,28,4,Philadelphia Eagles,16
2008-09-07,New Orleans Saints,Tampa Bay Buccaneers,24,20,2008,1,domingo,Regular Season,1-0,1,0,0,4,7,-3,0-1,0,1,0,20,15,5,New Orleans Saints,8
2008-09-07,New England Patriots,Kansas City Chiefs,17,10,2008,1,domingo,Regular Season,1-0,1,0,0,9,1,8,0-1,0,1,0,29,31,-2,New England Patriots,30
2008-09-07,Miami Dolphins,New York Jets,14,20,2008,1,domingo,Regular Season,0-1,0,1,0,28,30,-2,1-0,1,0,0,14,16,-2,New York Jets,14
2008-09-07,Indianapolis Colts,Chicago Bears,13,29,2008,1,domingo,Regular Season,0-1,0,1,0,8,4,4,1-0,1,0,0,15,25,-10,Chicago Bears,21
2008-09-07,Cleveland Browns,Dallas Cowboys,10,28,2008,1,domingo,Regular Season,0-1,0,1,0,17,13,4,1-0,1,0,0,1,3,-2,Dallas Cowboys,10
2008-09-07,Buffalo Bills,Seattle Seahawks,34,10,2008,1,domingo,Regular Season,1-0,1,0,0,13,18,-5,0-1,0,1,0,18,9,9,Buffalo Bills,9
2008-09-07,Baltimore Ravens,Cincinnati Bengals,17,10,2008,1,domingo,Regular Season,1-0,1,0,0,22,24,-2,0-1,0,1,0,26,23,3,Baltimore Ravens,1
2008-09-07,Atlanta Falcons,Detroit Lions,34,21,2008,1,domingo,Regular Season,1-0,1,0,0,25,32,-7,0-1,0,1,0,31,26,5,Atlanta Falcons,6
2008-09-04,New York Giants,Washington Redskins,16,7,2008,1,quinta,Regular Season,1-0,1,0,0,5,8,-3,0-1,0,1,0,23,19,4,New York Giants,11
2007-12-30,Washington Redskins,Dallas Cowboys,27,6,2007,17,domingo,Regular Season,9-7,9,7,0,10,13,-3,13-3,13,3,0,3,3,0,Washington Redskins,10
2007-12-30,Tampa Bay Buccaneers,Carolina Panthers,23,31,2007,17,domingo,Regular Season,9-7,9,7,0,12,12,0,7-9,7,9,0,23,24,-1,Carolina Panthers,12
2007-12-30,Philadelphia Eagles,Buffalo Bills,17,9,2007,17,domingo,Regular Season,8-8,8,8,0,14,15,-1,7-9,7,9,0,19,16,3,Philadelphia Eagles,1
2007-12-30,Oakland Raiders,Los Angeles Chargers,17,30,2007,17,domingo,Regular Season,4-12,4,12,0,27,27,0,11-5,11,5,0,6,6,0,Los Angeles Chargers,21
2007-12-30,New York Jets,Kansas City Chiefs,13,10,2007,17,domingo,Regular Season,4-12,4,12,0,30,30,0,4-12,4,12,0,28,28,0,New York Jets,2
2007-12-30,Miami Dolphins,Cincinnati Bengals,25,38,2007,17,domingo,Regular Season,1-15,1,15,0,32,32,0,7-9,7,9,0,22,23,-1,Cincinnati Bengals,9
2007-12-30,Indianapolis Colts,Tennessee Titans,10,16,2007,17,domingo,Regular Season,13-3,13,3,0,2,2,0,10-6,10,6,0,11,9,2,Tennessee Titans,7
2007-12-30,Houston Texans,Jacksonville Jaguars,42,28,2007,17,domingo,Regular Season,8-8,8,8,0,16,18,-2,11-5,11,5,0,4,4,0,Houston Texans,14
2007-12-30,Green Bay Packers,Detroit Lions,34,13,2007,17,domingo,Regular Season,13-3,13,3,0,5,5,0,7-9,7,9,0,24,21,3,Green Bay Packers,16
2007-12-30,Denver Broncos,Minnesota Vikings,22,19,2007,17,domingo,Regular Season,7-9,7,9,0,21,22,-1,8-8,8,8,0,15,14,1,Denver Broncos,8
2007-12-30,Cleveland Browns,San Francisco 49ers,20,7,2007,17,domingo,Regular Season,10-6,10,6,0,13,11,2,5-11,5,11,0,26,25,1,Cleveland Browns,14
2007-12-30,Chicago Bears,New Orleans Saints,33,25,2007,17,domingo,Regular Season,7-9,7,9,0,20,20,0,7-9,7,9,0,18,17,1,Chicago Bears,3
2007-12-30,Baltimore Ravens,Pittsburgh Steelers,27,21,2007,17,domingo,Regular Season,5-11,5,11,0,25,26,-1,10-6,10,6,0,8,8,0,Baltimore Ravens,18
2007-12-30,Atlanta Falcons,Seattle Seahawks,44,41,2007,17,domingo,Regular Season,4-12,4,12,0,31,31,0,10-6,10,6,0,7,7,0,Atlanta Falcons,24
2007-12-30,Arizona Cardinals,Los Angeles Rams,48,19,2007,17,domingo,Regular Season,8-8,8,8,0,17,19,-2,3-13,3,13,0,29,29,0,Arizona Cardinals,10
2007-12-29,New York Giants,New England Patriots,35,38,2007,17,sábado,Regular Season,10-6,10,6,0,9,10,-1,16-0,16,0,0,1,1,0,New England Patriots,9
2007-12-24,Los Angeles Chargers,Denver Broncos,23,3,2007,16,segunda,Regular Season,10-5,10,5,0,6,6,0,6-9,6,9,0,22,19,3,Los Angeles Chargers,13
2007-12-23,Tennessee Titans,New York Jets,10,6,2007,16,domingo,Regular Season,9-6,9,6,0,9,13,-4,3-12,3,12,0,30,30,0,Tennessee Titans,17
2007-12-23,Seattle Seahawks,Baltimore Ravens,27,6,2007,16,domingo,Regular Season,10-5,10,5,0,7,10,-3,4-11,4,11,0,26,27,-1,Seattle Seahawks,17
2007-12-23,San Francisco 49ers,Tampa Bay Buccaneers,21,19,2007,16,domingo,Regular Season,5-10,5,10,0,25,28,-3,9-6,9,6,0,12,9,3,San Francisco 49ers,19
2007-12-23,New Orleans Saints,Philadelphia Eagles,23,38,2007,16,domingo,Regular Season,7-8,7,8,0,17,14,3,7-8,7,8,0,15,18,-3,Philadelphia Eagles,4
2007-12-23,New England Patriots,Miami Dolphins,28,7,2007,16,domingo,Regular Season,15-0,15,0,0,1,1,0,1-14,1,14,0,32,32,0,New England Patriots,31
2007-12-23,Minnesota Vikings,Washington Redskins,21,32,2007,16,domingo,Regular Season,8-7,8,7,0,14,11,3,8-7,8,7,0,13,16,-3,Washington Redskins,5
2007-12-23,Jacksonville Jaguars,Oakland Raiders,49,11,2007,16,domingo,Regular Season,11-4,11,4,0,4,5,-1,4-11,4,11,0,27,25,2,Jacksonville Jaguars,20
2007-12-23,Indianapolis Colts,Houston Texans,38,15,2007,16,domingo,Regular Season,13-2,13,2,0,2,2,0,7-8,7,8,0,18,15,3,Indianapolis Colts,13
2007-12-23,Detroit Lions,Kansas City Chiefs,25,20,2007,16,domingo,Regular Season,7-8,7,8,0,21,22,-1,4-11,4,11,0,28,26,2,Detroit Lions,4
2007-12-23,Cincinnati Bengals,Cleveland Browns,19,14,2007,16,domingo,Regular Season,6-9,6,9,0,23,23,0,9-6,9,6,0,11,7,4,Cincinnati Bengals,16
2007-12-23,Chicago Bears,Green Bay Packers,35,7,2007,16,domingo,Regular Season,6-9,6,9,0,20,24,-4,12-3,12,3,0,5,4,1,Chicago Bears,20
2007-12-23,Buffalo Bills,New York Giants,21,38,2007,16,domingo,Regular Season,7-8,7,8,0,16,17,-1,10-5,10,5,0,10,12,-2,New York Giants,5
2007-12-23,Arizona Cardinals,Atlanta Falcons,30,27,2007,16,domingo,Regular Season,7-8,7,8,0,19,20,-1,3-12,3,12,0,31,31,0,Arizona Cardinals,11
2007-12-22,Carolina Panthers,Dallas Cowboys,13,20,2007,16,sábado,Regular Season,6-9,6,9,0,24,21,3,13-2,13,2,0,3,3,0,Dallas Cowboys,18
2007-12-20,Los Angeles Rams,Pittsburgh Steelers,24,41,2007,16,quinta,Regular Season,3-12,3,12,0,29,29,0,10-5,10,5,0,8,8,0,Pittsburgh Steelers,21
2007-12-17,Minnesota Vikings,Chicago Bears,20,13,2007,15,segunda,Regular Season,8-6,8,6,0,11,12,-1,5-9,5,9,0,24,23,1,Minnesota Vikings,11
2007-12-16,Tampa Bay Buccaneers,Atlanta Falcons,37,3,2007,15,domingo,Regular Season,9-5,9,5,0,9,11,-2,3-11,3,11,0,31,30,1,Tampa Bay Buccaneers,19
2007-12-16,Los Angeles Rams,Green Bay Packers,14,33,2007,15,domingo,Regular Season,3-11,3,11,0,29,28,1,12-2,12,2,0,4,4,0,Green Bay Packers,24
2007-12-16,Los Angeles Chargers,Detroit Lions,51,14,2007,15,domingo,Regular Season,9-5,9,5,0,6,7,-1,6-8,6,8,0,22,20,2,Los Angeles Chargers,13
2007-12-16,Pittsburgh Steelers,Jacksonville Jaguars,22,29,2007,15,domingo,Regular Season,9-5,9,5,0,8,8,0,10-4,10,4,0,5,5,0,Jacksonville Jaguars,3
2007-12-16,Oakland Raiders,Indianapolis Colts,14,21,2007,15,domingo,Regular Season,4-10,4,10,0,25,26,-1,12-2,12,2,0,2,3,-1,Indianapolis Colts,23
2007-12-16,New York Giants,Washington Redskins,10,22,2007,15,domingo,Regular Season,9-5,9,5,0,12,9,3,7-7,7,7,0,16,17,-1,Washington Redskins,8
2007-12-16,New Orleans Saints,Arizona Cardinals,31,24,2007,15,domingo,Regular Season,7-7,7,7,0,14,16,-2,6-8,6,8,0,20,18,2,New Orleans Saints,2
2007-12-16,New England Patriots,New York Jets,20,10,2007,15,domingo,Regular Season,14-0,14,0,0,1,1,0,3-11,3,11,0,30,29,1,New England Patriots,28
2007-12-16,Miami Dolphins,Baltimore Ravens,22,16,2007,15,domingo,Regular Season,1-13,1,13,0,32,32,0,4-10,4,10,0,27,25,2,Miami Dolphins,7
2007-12-16,Kansas City Chiefs,Tennessee Titans,17,26,2007,15,domingo,Regular Season,4-10,4,10,0,26,27,-1,8-6,8,6,0,13,13,0,Tennessee Titans,14
2007-12-16,Dallas Cowboys,Philadelphia Eagles,6,10,2007,15,domingo,Regular Season,12-2,12,2,0,3,2,1,6-8,6,8,0,18,21,-3,Philadelphia Eagles,19
2007-12-16,Cleveland Browns,Buffalo Bills,8,0,2007,15,domingo,Regular Season,9-5,9,5,0,7,10,-3,7-7,7,7,0,17,14,3,Cleveland Browns,4
2007-12-16,Carolina Panthers,Seattle Seahawks,13,10,2007,15,domingo,Regular Season,6-8,6,8,0,21,24,-3,9-5,9,5,0,10,6,4,Carolina Panthers,18
2007-12-15,San Francisco 49ers,Cincinnati Bengals,20,13,2007,15,sábado,Regular Season,4-10,4,10,0,28,31,-3,5-9,5,9,0,23,22,1,San Francisco 49ers,9
2007-12-13,Houston Texans,Denver Broncos,31,13,2007,15,quinta,Regular Season,7-7,7,7,0,15,19,-4,6-8,6,8,0,19,15,4,Houston Texans,4
2007-12-10,Atlanta Falcons,New Orleans Saints,14,34,2007,14,segunda,Regular Season,3-10,3,10,0,30,31,-1,6-7,6,7,0,16,17,-1,New Orleans Saints,14
2007-12-09,Tennessee Titans,Los Angeles Chargers,17,23,2007,14,domingo,Regular Season,7-6,7,6,0,13,12,1,8-5,8,5,0,7,9,-2,Los Angeles Chargers,3
2007-12-09,Seattle Seahawks,Arizona Cardinals,42,21,2007,14,domingo,Regular Season,9-4,9,4,0,6,7,-1,6-7,6,7,0,18,14,4,Seattle Seahawks,7
2007-12-09,San Francisco 49ers,Minnesota Vikings,7,27,2007,14,domingo,Regular Season,3-10,3,10,0,31,30,1,7-6,7,6,0,12,13,-1,Minnesota Vikings,17
2007-12-09,Philadelphia Eagles,New York Giants,13,16,2007,14,domingo,Regular Season,5-8,5,8,0,21,19,2,9-4,9,4,0,9,10,-1,New York Giants,9
2007-12-09,New York Jets,Cleveland Browns,18,24,2007,14,domingo,Regular Season,3-10,3,10,0,29,29,0,8-5,8,5,0,10,11,-1,Cleveland Browns,18
2007-12-09,New England Patriots,Pittsburgh Steelers,34,13,2007,14,domingo,Regular Season,13-0,13,0,0,1,1,0,9-4,9,4,0,8,5,3,New England Patriots,4
2007-12-09,Jacksonville Jaguars,Carolina Panthers,37,6,2007,14,domingo,Regular Season,9-4,9,4,0,5,6,-1,5-8,5,8,0,24,23,1,Jacksonville Jaguars,17
2007-12-09,Houston Texans,Tampa Bay Buccaneers,28,14,2007,14,domingo,Regular Season,6-7,6,7,0,19,22,-3,8-5,8,5,0,11,8,3,Houston Texans,14
2007-12-09,Green Bay Packers,Oakland Raiders,38,7,2007,14,domingo,Regular Season,11-2,11,2,0,4,4,0,4-9,4,9,0,26,26,0,Green Bay Packers,22
2007-12-09,Detroit Lions,Dallas Cowboys,27,28,2007,14,domingo,Regular Season,6-7,6,7,0,20,18,2,12-1,12,1,0,2,2,0,Dallas Cowboys,16
2007-12-09,Denver Broncos,Kansas City Chiefs,41,7,2007,14,domingo,Regular Season,6-7,6,7,0,15,20,-5,4-9,4,9,0,27,27,0,Denver Broncos,7
2007-12-09,Cincinnati Bengals,Los Angeles Rams,19,10,2007,14,domingo,Regular Season,5-8,5,8,0,22,25,-3,3-10,3,10,0,28,28,0,Cincinnati Bengals,3
2007-12-09,Buffalo Bills,Miami Dolphins,38,17,2007,14,domingo,Regular Season,7-6,7,6,0,14,15,-1,0-13,0,13,0,32,32,0,Buffalo Bills,17
2007-12-09,Baltimore Ravens,Indianapolis Colts,20,44,2007,14,domingo,Regular Season,4-9,4,9,0,25,24,1,11-2,11,2,0,3,3,0,Indianapolis Colts,21
2007-12-06,Washington Redskins,Chicago Bears,24,16,2007,14,quinta,Regular Season,6-7,6,7,0,17,21,-4,5-8,5,8,0,23,16,7,Washington Redskins,5
2007-12-03,Baltimore Ravens,New England Patriots,24,27,2007,13,segunda,Regular Season,4-8,4,8,0,24,25,-1,12-0,12,0,0,1,1,0,New England Patriots,24
2007-12-02,Washington Redskins,Buffalo Bills,16,17,2007,13,domingo,Regular Season,5-7,5,7,0,21,20,1,6-6,6,6,0,15,22,-7,Buffalo Bills,2
2007-12-02,Tennessee Titans,Houston Texans,28,20,2007,13,domingo,Regular Season,7-5,7,5,0,12,12,0,5-7,5,7,0,22,21,1,Tennessee Titans,9
2007-12-02,Los Angeles Rams,Atlanta Falcons,28,16,2007,13,domingo,Regular Season,3-9,3,9,0,28,29,-1,3-9,3,9,0,31,30,1,Los Angeles Rams,1
2007-12-02,Pittsburgh Steelers,Cincinnati Bengals,24,10,2007,13,domingo,Regular Season,9-3,9,3,0,5,6,-1,4-8,4,8,0,25,23,2,Pittsburgh Steelers,17
2007-12-02,Philadelphia Eagles,Seattle Seahawks,24,28,2007,13,domingo,Regular Season,5-7,5,7,0,19,15,4,8-4,8,4,0,7,8,-1,Seattle Seahawks,7
2007-12-02,Oakland Raiders,Denver Broncos,34,20,2007,13,domingo,Regular Season,4-8,4,8,0,26,27,-1,5-7,5,7,0,20,17,3,Oakland Raiders,10
2007-12-02,New Orleans Saints,Tampa Bay Buccaneers,23,27,2007,13,domingo,Regular Season,5-7,5,7,0,17,13,4,8-4,8,4,0,8,9,-1,Tampa Bay Buccaneers,4
2007-12-02,Minnesota Vikings,Detroit Lions,42,10,2007,13,domingo,Regular Season,6-6,6,6,0,13,18,-5,6-6,6,6,0,18,14,4,Minnesota Vikings,4
2007-12-02,Miami Dolphins,New York Jets,13,40,2007,13,domingo,Regular Season,0-12,0,12,0,32,32,0,3-9,3,9,0,29,31,-2,New York Jets,1
2007-12-02,Kansas City Chiefs,Los Angeles Chargers,10,24,2007,13,domingo,Regular Season,4-8,4,8,0,27,24,3,7-5,7,5,0,9,10,-1,Los Angeles Chargers,14
2007-12-02,Indianapolis Colts,Jacksonville Jaguars,28,25,2007,13,domingo,Regular Season,10-2,10,2,0,3,4,-1,8-4,8,4,0,6,5,1,Indianapolis Colts,1
2007-12-02,Chicago Bears,New York Giants,16,21,2007,13,domingo,Regular Season,5-7,5,7,0,16,16,0,8-4,8,4,0,10,11,-1,New York Giants,5
2007-12-02,Carolina Panthers,San Francisco 49ers,31,14,2007,13,domingo,Regular Season,5-7,5,7,0,23,26,-3,3-9,3,9,0,30,28,2,Carolina Panthers,2
2007-12-02,Arizona Cardinals,Cleveland Browns,27,21,2007,13,domingo,Regular Season,6-6,6,6,0,14,19,-5,7-5,7,5,0,11,7,4,Arizona Cardinals,12
2007-11-29,Dallas Cowboys,Green Bay Packers,37,27,2007,13,quinta,Regular Season,11-1,11,1,0,2,2,0,10-2,10,2,0,4,3,1,Dallas Cowboys,1
2007-11-26,Pittsburgh Steelers,Miami Dolphins,3,0,2007,12,segunda,Regular Season,8-3,8,3,0,6,7,-1,0-11,0,11,0,32,32,0,Pittsburgh Steelers,25
2007-11-25,Tampa Bay Buccaneers,Washington Redskins,19,13,2007,12,domingo,Regular Season,7-4,7,4,0,9,10,-1,5-6,5,6,0,20,18,2,Tampa Bay Buccaneers,8
2007-11-25,Los Angeles Rams,Seattle Seahawks,19,24,2007,12,domingo,Regular Season,2-9,2,9,0,29,28,1,7-4,7,4,0,8,9,-1,Seattle Seahawks,19
2007-11-25,Los Angeles Chargers,Baltimore Ravens,32,14,2007,12,domingo,Regular Season,6-5,6,5,0,10,13,-3,4-7,4,7,0,25,24,1,Los Angeles Chargers,11
2007-11-25,New York Giants,Minnesota Vikings,17,41,2007,12,domingo,Regular Season,7-4,7,4,0,11,6,5,5-6,5,6,0,18,23,-5,Minnesota Vikings,17
2007-11-25,New England Patriots,Philadelphia Eagles,31,28,2007,12,domingo,Regular Season,11-0,11,0,0,1,1,0,5-6,5,6,0,15,15,0,New England Patriots,14
2007-11-25,Kansas City Chiefs,Oakland Raiders,17,20,2007,12,domingo,Regular Season,4-7,4,7,0,24,21,3,3-8,3,8,0,27,30,-3,Oakland Raiders,9
2007-11-25,Jacksonville Jaguars,Buffalo Bills,36,14,2007,12,domingo,Regular Season,8-3,8,3,0,5,5,0,5-6,5,6,0,22,19,3,Jacksonville Jaguars,14
2007-11-25,Cleveland Browns,Houston Texans,27,17,2007,12,domingo,Regular Season,7-4,7,4,0,7,8,-1,5-6,5,6,0,21,17,4,Cleveland Browns,9
2007-11-25,Cincinnati Bengals,Tennessee Titans,35,6,2007,12,domingo,Regular Season,4-7,4,7,0,23,26,-3,6-5,6,5,0,12,11,1,Cincinnati Bengals,15
2007-11-25,Chicago Bears,Denver Broncos,37,34,2007,12,domingo,Regular Season,5-6,5,6,0,16,22,-6,5-6,5,6,0,17,14,3,Chicago Bears,8
2007-11-25,Carolina Panthers,New Orleans Saints,6,31,2007,12,domingo,Regular Season,4-7,4,7,0,26,25,1,5-6,5,6,0,13,20,-7,New Orleans Saints,5
2007-11-25,Arizona Cardinals,San Francisco 49ers,31,37,2007,12,domingo,Regular Season,5-6,5,6,0,19,16,3,3-8,3,8,0,28,31,-3,San Francisco 49ers,15
2007-11-22,Detroit Lions,Green Bay Packers,26,37,2007,12,quinta,Regular Season,6-5,6,5,0,14,12,2,10-1,10,1,0,3,3,0,Green Bay Packers,9
2007-11-22,Dallas Cowboys,New York Jets,34,3,2007,12,quinta,Regular Season,10-1,10,1,0,2,2,0,2-9,2,9,0,31,29,2,Dallas Cowboys,27
2007-11-22,Atlanta Falcons,Indianapolis Colts,13,31,2007,12,quinta,Regular Season,3-8,3,8,0,30,27,3,9-2,9,2,0,4,4,0,Indianapolis Colts,23
2007-11-19,Denver Broncos,Tennessee Titans,34,20,2007,11,segunda,Regular Season,5-5,5,5,0,14,18,-4,6-4,6,4,0,11,8,3,Denver Broncos,10
2007-11-18,Seattle Seahawks,Chicago Bears,30,23,2007,11,domingo,Regular Season,6-4,6,4,0,9,13,-4,4-6,4,6,0,22,21,1,Seattle Seahawks,8
2007-11-18,San Francisco 49ers,Los Angeles Rams,9,13,2007,11,domingo,Regular Season,2-8,2,8,0,31,28,3,2-8,2,8,0,28,30,-2,Los Angeles Rams,2
2007-11-18,Philadelphia Eagles,Miami Dolphins,17,7,2007,11,domingo,Regular Season,5-5,5,5,0,15,17,-2,0-10,0,10,0,32,32,0,Philadelphia Eagles,15
2007-11-18,New York Jets,Pittsburgh Steelers,19,16,2007,11,domingo,Regular Season,2-8,2,8,0,29,31,-2,7-3,7,3,0,7,5,2,New York Jets,26
2007-11-18,Minnesota Vikings,Oakland Raiders,29,22,2007,11,domingo,Regular Season,4-6,4,6,0,23,27,-4,2-8,2,8,0,30,29,1,Minnesota Vikings,2
2007-11-18,Jacksonville Jaguars,Los Angeles Chargers,24,17,2007,11,domingo,Regular Season,7-3,7,3,0,5,6,-1,5-5,5,5,0,13,9,4,Jacksonville Jaguars,3
2007-11-18,Indianapolis Colts,Kansas City Chiefs,13,10,2007,11,domingo,Regular Season,8-2,8,2,0,4,3,1,4-6,4,6,0,21,20,1,Indianapolis Colts,17
2007-11-18,Houston Texans,New Orleans Saints,23,10,2007,11,domingo,Regular Season,5-5,5,5,0,17,22,-5,4-6,4,6,0,20,16,4,Houston Texans,6
2007-11-18,Green Bay Packers,Carolina Panthers,31,17,2007,11,domingo,Regular Season,9-1,9,1,0,3,4,-1,4-6,4,6,0,25,23,2,Green Bay Packers,19
2007-11-18,Detroit Lions,New York Giants,10,16,2007,11,domingo,Regular Season,6-4,6,4,0,12,10,2,7-3,7,3,0,6,7,-1,New York Giants,3
2007-11-18,Dallas Cowboys,Washington Redskins,28,23,2007,11,domingo,Regular Season,9-1,9,1,0,2,2,0,5-5,5,5,0,18,14,4,Dallas Cowboys,12
2007-11-18,Cincinnati Bengals,Arizona Cardinals,27,35,2007,11,domingo,Regular Season,3-7,3,7,0,26,25,1,5-5,5,5,0,16,19,-3,Arizona Cardinals,6
2007-11-18,Buffalo Bills,New England Patriots,10,56,2007,11,domingo,Regular Season,5-5,5,5,0,19,15,4,10-0,10,0,0,1,1,0,New England Patriots,14
2007-11-18,Baltimore Ravens,Cleveland Browns,30,33,2007,11,domingo,Regular Season,4-6,4,6,0,24,24,0,6-4,6,4,0,8,11,-3,Cleveland Browns,13
2007-11-18,Atlanta Falcons,Tampa Bay Buccaneers,7,31,2007,11,domingo,Regular Season,3-7,3,7,0,27,26,1,6-4,6,4,0,10,12,-2,Tampa Bay Buccaneers,14
2007-11-12,Seattle Seahawks,San Francisco 49ers,24,0,2007,10,segunda,Regular Season,5-4,5,4,0,13,16,-3,2-7,2,7,0,28,29,-1,Seattle Seahawks,13
2007-11-11,Washington Redskins,Philadelphia Eagles,25,33,2007,10,domingo,Regular Season,5-4,5,4,0,14,12,2,4-5,4,5,0,17,22,-5,Philadelphia Eagles,10
2007-11-11,Tennessee Titans,Jacksonville Jaguars,13,28,2007,10,domingo,Regular Season,6-3,6,3,0,8,7,1,6-3,6,3,0,6,10,-4,Jacksonville Jaguars,3
2007-11-11,Los Angeles Chargers,Indianapolis Colts,23,21,2007,10,domingo,Regular Season,5-4,5,4,0,9,14,-5,7-2,7,2,0,3,2,1,Los Angeles Chargers,12
2007-11-11,Pittsburgh Steelers,Cleveland Browns,31,28,2007,10,domingo,Regular Season,7-2,7,2,0,5,4,1,5-4,5,4,0,11,9,2,Pittsburgh Steelers,5
2007-11-11,Oakland Raiders,Chicago Bears,6,17,2007,10,domingo,Regular Season,2-7,2,7,0,29,27,2,4-5,4,5,0,21,24,-3,Chicago Bears,3
2007-11-11,New York Giants,Dallas Cowboys,20,31,2007,10,domingo,Regular Season,6-3,6,3,0,7,6,1,8-1,8,1,0,2,3,-1,Dallas Cowboys,3
2007-11-11,New Orleans Saints,Los Angeles Rams,29,37,2007,10,domingo,Regular Season,4-5,4,5,0,16,11,5,1-8,1,8,0,30,31,-1,Los Angeles Rams,20
2007-11-11,Miami Dolphins,Buffalo Bills,10,13,2007,10,domingo,Regular Season,0-9,0,9,0,32,32,0,5-4,5,4,0,15,18,-3,Buffalo Bills,14
2007-11-11,Kansas City Chiefs,Denver Broncos,11,27,2007,10,domingo,Regular Season,4-5,4,5,0,20,15,5,4-5,4,5,0,18,25,-7,Denver Broncos,10
2007-11-11,Green Bay Packers,Minnesota Vikings,34,0,2007,10,domingo,Regular Season,8-1,8,1,0,4,5,-1,3-6,3,6,0,27,23,4,Green Bay Packers,18
2007-11-11,Carolina Panthers,Atlanta Falcons,13,20,2007,10,domingo,Regular Season,4-5,4,5,0,23,19,4,3-6,3,6,0,26,28,-2,Atlanta Falcons,9
2007-11-11,Baltimore Ravens,Cincinnati Bengals,7,21,2007,10,domingo,Regular Season,4-5,4,5,0,24,17,7,3-6,3,6,0,25,26,-1,Cincinnati Bengals,9
2007-11-11,Arizona Cardinals,Detroit Lions,31,21,2007,10,domingo,Regular Season,4-5,4,5,0,19,21,-2,6-3,6,3,0,10,8,2,Arizona Cardinals,13
2007-11-05,Pittsburgh Steelers,Baltimore Ravens,38,7,2007,9,segunda,Regular Season,6-2,6,2,0,4,6,-2,4-4,4,4,0,17,14,3,Pittsburgh Steelers,8
2007-11-04,Tennessee Titans,Carolina Panthers,20,7,2007,9,domingo,Regular Season,6-2,6,2,0,7,9,-2,4-4,4,4,0,19,18,1,Tennessee Titans,9
2007-11-04,Tampa Bay Buccaneers,Arizona Cardinals,17,10,2007,9,domingo,Regular Season,5-4,5,4,0,13,17,-4,3-5,3,5,0,21,21,0,Tampa Bay Buccaneers,4
2007-11-04,Philadelphia Eagles,Dallas Cowboys,17,38,2007,9,domingo,Regular Season,3-5,3,5,0,22,20,2,7-1,7,1,0,3,3,0,Dallas Cowboys,17
2007-11-04,Oakland Raiders,Houston Texans,17,24,2007,9,domingo,Regular Season,2-6,2,6,0,27,27,0,4-5,4,5,0,20,24,-4,Houston Texans,3
2007-11-04,New York Jets,Washington Redskins,20,23,2007,9,domingo,Regular Season,1-8,1,8,0,30,30,0,5-3,5,3,0,12,15,-3,Washington Redskins,15
2007-11-04,New Orleans Saints,Jacksonville Jaguars,41,24,2007,9,domingo,Regular Season,4-4,4,4,0,11,19,-8,5-3,5,3,0,10,8,2,New Orleans Saints,11
2007-11-04,Minnesota Vikings,Los Angeles Chargers,35,17,2007,9,domingo,Regular Season,3-5,3,5,0,23,26,-3,4-4,4,4,0,14,7,7,Minnesota Vikings,19
2007-11-04,Kansas City Chiefs,Green Bay Packers,22,33,2007,9,domingo,Regular Season,4-4,4,4,0,15,11,4,7-1,7,1,0,5,4,1,Green Bay Packers,7
2007-11-04,Indianapolis Colts,New England Patriots,20,24,2007,9,domingo,Regular Season,7-1,7,1,0,2,2,0,9-0,9,0,0,1,1,0,New England Patriots,1
2007-11-04,Detroit Lions,Denver Broncos,44,7,2007,9,domingo,Regular Season,6-2,6,2,0,8,10,-2,3-5,3,5,0,25,16,9,Detroit Lions,6
2007-11-04,Cleveland Browns,Seattle Seahawks,33,30,2007,9,domingo,Regular Season,5-3,5,3,0,9,13,-4,4-4,4,4,0,16,12,4,Cleveland Browns,1
2007-11-04,Buffalo Bills,Cincinnati Bengals,33,21,2007,9,domingo,Regular Season,4-4,4,4,0,18,22,-4,2-6,2,6,0,26,25,1,Buffalo Bills,3
2007-11-04,Atlanta Falcons,San Francisco 49ers,20,16,2007,9,domingo,Regular Season,2-6,2,6,0,28,29,-1,2-6,2,6,0,29,28,1,Atlanta Falcons,1
2007-10-29,Denver Broncos,Green Bay Packers,13,19,2007,8,segunda,Regular Season,3-4,3,4,0,16,17,-1,6-1,6,1,0,4,5,-1,Green Bay Packers,12
2007-10-28,Tennessee Titans,Oakland Raiders,13,9,2007,8,domingo,Regular Season,5-2,5,2,0,9,8,1,2-5,2,5,0,27,27,0,Tennessee Titans,19
2007-10-28,Tampa Bay Buccaneers,Jacksonville Jaguars,23,24,2007,8,domingo,Regular Season,4-4,4,4,0,17,16,1,5-2,5,2,0,8,7,1,Jacksonville Jaguars,9
2007-10-28,Los Angeles Rams,Cleveland Browns,20,27,2007,8,domingo,Regular Season,0-8,0,8,0,31,31,0,4-3,4,3,0,13,19,-6,Cleveland Browns,12
2007-10-28,San Francisco 49ers,New Orleans Saints,10,31,2007,8,domingo,Regular Season,2-5,2,5,0,28,28,0,3-4,3,4,0,19,24,-5,New Orleans Saints,4
2007-10-28,Los Angeles Chargers,Houston Texans,35,10,2007,8,domingo,Regular Season,4-3,4,3,0,7,9,-2,3-5,3,5,0,24,21,3,Los Angeles Chargers,12
2007-10-28,New York Jets,Buffalo Bills,3,13,2007,8,domingo,Regular Season,1-7,1,7,0,30,30,0,3-4,3,4,0,22,25,-3,Buffalo Bills,5
2007-10-28,New England Patriots,Washington Redskins,52,7,2007,8,domingo,Regular Season,8-0,8,0,0,1,1,0,4-3,4,3,0,15,10,5,New England Patriots,9
2007-10-28,Minnesota Vikings,Philadelphia Eagles,16,23,2007,8,domingo,Regular Season,2-5,2,5,0,26,26,0,3-4,3,4,0,20,22,-2,Philadelphia Eagles,4
2007-10-28,Miami Dolphins,New York Giants,10,13,2007,8,domingo,Regular Season,0-8,0,8,0,32,32,0,6-2,6,2,0,5,4,1,New York Giants,28
2007-10-28,Cincinnati Bengals,Pittsburgh Steelers,13,24,2007,8,domingo,Regular Season,2-5,2,5,0,25,23,2,5-2,5,2,0,6,6,0,Pittsburgh Steelers,17
2007-10-28,Chicago Bears,Detroit Lions,7,16,2007,8,domingo,Regular Season,3-5,3,5,0,23,18,5,5-2,5,2,0,10,11,-1,Detroit Lions,7
2007-10-28,Carolina Panthers,Indianapolis Colts,7,31,2007,8,domingo,Regular Season,4-3,4,3,0,18,12,6,7-0,7,0,0,2,2,0,Indianapolis Colts,10
2007-10-22,Jacksonville Jaguars,Indianapolis Colts,7,29,2007,7,segunda,Regular Season,4-2,4,2,0,7,5,2,6-0,6,0,0,2,2,0,Indianapolis Colts,3
2007-10-21,Washington Redskins,Arizona Cardinals,21,19,2007,7,domingo,Regular Season,4-2,4,2,0,10,11,-1,3-4,3,4,0,20,18,2,Washington Redskins,7
2007-10-21,Seattle Seahawks,Los Angeles Rams,33,6,2007,7,domingo,Regular Season,4-3,4,3,0,15,14,1,0-7,0,7,0,31,31,0,Seattle Seahawks,17
2007-10-21,Philadelphia Eagles,Chicago Bears,16,19,2007,7,domingo,Regular Season,2-4,2,4,0,22,17,5,3-4,3,4,0,18,23,-5,Chicago Bears,6
2007-10-21,Oakland Raiders,Kansas City Chiefs,10,12,2007,7,domingo,Regular Season,2-4,2,4,0,27,25,2,4-3,4,3,0,13,16,-3,Kansas City Chiefs,9
2007-10-21,New York Giants,San Francisco 49ers,33,15,2007,7,domingo,Regular Season,5-2,5,2,0,4,9,-5,2-4,2,4,0,28,24,4,New York Giants,15
2007-10-21,New Orleans Saints,Atlanta Falcons,22,16,2007,7,domingo,Regular Season,2-4,2,4,0,24,26,-2,1-6,1,6,0,29,29,0,New Orleans Saints,3
2007-10-21,Miami Dolphins,New England Patriots,28,49,2007,7,domingo,Regular Season,0-7,0,7,0,32,32,0,7-0,7,0,0,1,1,0,New England Patriots,31
2007-10-21,Houston Texans,Tennessee Titans,36,38,2007,7,domingo,Regular Season,3-4,3,4,0,21,20,1,4-2,4,2,0,8,12,-4,Tennessee Titans,8
2007-10-21,Detroit Lions,Tampa Bay Buccaneers,23,16,2007,7,domingo,Regular Season,4-2,4,2,0,11,15,-4,4-3,4,3,0,16,8,8,Detroit Lions,7
2007-10-21,Denver Broncos,Pittsburgh Steelers,31,28,2007,7,domingo,Regular Season,3-3,3,3,0,17,21,-4,4-2,4,2,0,6,3,3,Denver Broncos,18
2007-10-21,Dallas Cowboys,Minnesota Vikings,24,14,2007,7,domingo,Regular Season,6-1,6,1,0,3,4,-1,2-4,2,4,0,26,22,4,Dallas Cowboys,18
2007-10-21,Cincinnati Bengals,New York Jets,38,31,2007,7,domingo,Regular Season,2-4,2,4,0,23,27,-4,1-6,1,6,0,30,30,0,Cincinnati Bengals,3
2007-10-21,Buffalo Bills,Baltimore Ravens,19,14,2007,7,domingo,Regular Season,2-4,2,4,0,25,28,-3,4-3,4,3,0,14,7,7,Buffalo Bills,21
2007-10-15,Atlanta Falcons,New York Giants,10,31,2007,6,segunda,Regular Season,1-5,1,5,0,29,29,0,4-2,4,2,0,9,14,-5,New York Giants,15
2007-10-14,Tampa Bay Buccaneers,Tennessee Titans,13,10,2007,6,domingo,Regular Season,4-2,4,2,0,8,11,-3,3-2,3,2,0,12,7,5,Tampa Bay Buccaneers,4
2007-10-14,Seattle Seahawks,New Orleans Saints,17,28,2007,6,domingo,Regular Season,3-3,3,3,0,14,10,4,1-4,1,4,0,26,30,-4,New Orleans Saints,20
2007-10-14,Los Angeles Chargers,Oakland Raiders,28,14,2007,6,domingo,Regular Season,3-3,3,3,0,10,12,-2,2-3,2,3,0,25,20,5,Los Angeles Chargers,8
2007-10-14,New York Jets,Philadelphia Eagles,9,16,2007,6,domingo,Regular Season,1-5,1,5,0,30,28,2,2-3,2,3,0,17,22,-5,Philadelphia Eagles,6
2007-10-14,Kansas City Chiefs,Cincinnati Bengals,27,20,2007,6,domingo,Regular Season,3-3,3,3,0,16,25,-9,1-4,1,4,0,27,23,4,Kansas City Chiefs,2
2007-10-14,Jacksonville Jaguars,Houston Texans,37,17,2007,6,domingo,Regular Season,4-1,4,1,0,5,6,-1,3-3,3,3,0,20,16,4,Jacksonville Jaguars,10
2007-10-14,Green Bay Packers,Washington Redskins,17,14,2007,6,domingo,Regular Season,5-1,5,1,0,6,5,1,3-2,3,2,0,11,8,3,Green Bay Packers,3
2007-10-14,Dallas Cowboys,New England Patriots,27,48,2007,6,domingo,Regular Season,5-1,5,1,0,4,3,1,6-0,6,0,0,1,1,0,New England Patriots,2
2007-10-14,Cleveland Browns,Miami Dolphins,41,31,2007,6,domingo,Regular Season,3-3,3,3,0,19,24,-5,0-6,0,6,0,32,32,0,Cleveland Browns,8
2007-10-14,Chicago Bears,Minnesota Vikings,31,34,2007,6,domingo,Regular Season,2-4,2,4,0,23,15,8,2-3,2,3,0,22,27,-5,Minnesota Vikings,12
2007-10-14,Baltimore Ravens,Los Angeles Rams,22,3,2007,6,domingo,Regular Season,4-2,4,2,0,7,9,-2,0-6,0,6,0,31,31,0,Baltimore Ravens,22
2007-10-14,Arizona Cardinals,Carolina Panthers,10,25,2007,6,domingo,Regular Season,3-3,3,3,0,18,13,5,4-2,4,2,0,13,17,-4,Carolina Panthers,4
2007-10-08,Buffalo Bills,Dallas Cowboys,24,25,2007,5,segunda,Regular Season,1-4,1,4,0,26,30,-4,5-0,5,0,0,3,3,0,Dallas Cowboys,27
2007-10-07,Washington Redskins,Detroit Lions,34,3,2007,5,domingo,Regular Season,3-1,3,1,0,8,13,-5,3-2,3,2,0,18,12,6,Washington Redskins,1
2007-10-07,Tennessee Titans,Atlanta Falcons,20,13,2007,5,domingo,Regular Season,3-1,3,1,0,7,7,0,1-4,1,4,0,29,28,1,Tennessee Titans,21
2007-10-07,Los Angeles Rams,Arizona Cardinals,31,34,2007,5,domingo,Regular Season,0-5,0,5,0,31,32,-1,3-2,3,2,0,13,15,-2,Arizona Cardinals,17
2007-10-07,San Francisco 49ers,Baltimore Ravens,7,9,2007,5,domingo,Regular Season,2-3,2,3,0,21,19,2,3-2,3,2,0,9,11,-2,Baltimore Ravens,8
2007-10-07,Pittsburgh Steelers,Seattle Seahawks,21,0,2007,5,domingo,Regular Season,4-1,4,1,0,4,6,-2,3-2,3,2,0,10,5,5,Pittsburgh Steelers,1
2007-10-07,New York Giants,New York Jets,35,24,2007,5,domingo,Regular Season,3-2,3,2,0,14,18,-4,1-4,1,4,0,28,26,2,New York Giants,8
2007-10-07,New Orleans Saints,Carolina Panthers,13,16,2007,5,domingo,Regular Season,0-4,0,4,0,30,29,1,3-2,3,2,0,17,14,3,Carolina Panthers,15
2007-10-07,New England Patriots,Cleveland Browns,34,17,2007,5,domingo,Regular Season,5-0,5,0,0,1,1,0,2-3,2,3,0,24,25,-1,New England Patriots,24
2007-10-07,Kansas City Chiefs,Jacksonville Jaguars,7,17,2007,5,domingo,Regular Season,2-3,2,3,0,25,21,4,3-1,3,1,0,6,8,-2,Jacksonville Jaguars,13
2007-10-07,Indianapolis Colts,Tampa Bay Buccaneers,33,14,2007,5,domingo,Regular Season,5-0,5,0,0,2,2,0,3-2,3,2,0,11,9,2,Indianapolis Colts,7
2007-10-07,Houston Texans,Miami Dolphins,22,19,2007,5,domingo,Regular Season,3-2,3,2,0,16,17,-1,0-5,0,5,0,32,31,1,Houston Texans,14
2007-10-07,Green Bay Packers,Chicago Bears,20,27,2007,5,domingo,Regular Season,4-1,4,1,0,5,4,1,2-3,2,3,0,15,20,-5,Chicago Bears,16
2007-10-07,Denver Broncos,Los Angeles Chargers,3,41,2007,5,domingo,Regular Season,2-3,2,3,0,19,10,9,2-3,2,3,0,12,16,-4,Los Angeles Chargers,6
2007-10-01,Cincinnati Bengals,New England Patriots,13,34,2007,4,segunda,Regular Season,1-3,1,3,0,23,18,5,4-0,4,0,0,1,1,0,New England Patriots,17
2007-09-30,San Francisco 49ers,Seattle Seahawks,3,23,2007,4,domingo,Regular Season,2-2,2,2,0,19,15,4,3-1,3,1,0,5,7,-2,Seattle Seahawks,8
2007-09-30,Los Angeles Chargers,Kansas City Chiefs,16,30,2007,4,domingo,Regular Season,1-3,1,3,0,16,9,7,2-2,2,2,0,21,28,-7,Kansas City Chiefs,19
2007-09-30,New York Giants,Philadelphia Eagles,16,3,2007,4,domingo,Regular Season,2-2,2,2,0,18,23,-5,1-3,1,3,0,22,16,6,New York Giants,7
2007-09-30,Minnesota Vikings,Green Bay Packers,16,23,2007,4,domingo,Regular Season,1-3,1,3,0,27,25,2,4-0,4,0,0,4,6,-2,Green Bay Packers,19
2007-09-30,Miami Dolphins,Oakland Raiders,17,35,2007,4,domingo,Regular Season,0-4,0,4,0,31,31,0,2-2,2,2,0,24,24,0,Oakland Raiders,7
2007-09-30,Indianapolis Colts,Denver Broncos,38,20,2007,4,domingo,Regular Season,4-0,4,0,0,2,2,0,2-2,2,2,0,10,8,2,Indianapolis Colts,6
2007-09-30,Detroit Lions,Chicago Bears,37,27,2007,4,domingo,Regular Season,3-1,3,1,0,12,20,-8,1-3,1,3,0,20,13,7,Detroit Lions,7
2007-09-30,Dallas Cowboys,Los Angeles Rams,35,7,2007,4,domingo,Regular Season,4-0,4,0,0,3,3,0,0-4,0,4,0,32,30,2,Dallas Cowboys,27
2007-09-30,Cleveland Browns,Baltimore Ravens,27,13,2007,4,domingo,Regular Season,2-2,2,2,0,25,27,-2,2-2,2,2,0,11,5,6,Cleveland Browns,22
2007-09-30,Carolina Panthers,Tampa Bay Buccaneers,7,20,2007,4,domingo,Regular Season,2-2,2,2,0,14,12,2,3-1,3,1,0,9,19,-10,Tampa Bay Buccaneers,7
2007-09-30,Buffalo Bills,New York Jets,17,14,2007,4,domingo,Regular Season,1-3,1,3,0,30,29,1,1-3,1,3,0,26,21,5,Buffalo Bills,8
2007-09-30,Atlanta Falcons,Houston Texans,26,16,2007,4,domingo,Regular Season,1-3,1,3,0,28,32,-4,2-2,2,2,0,17,17,0,Atlanta Falcons,15
2007-09-30,Arizona Cardinals,Pittsburgh Steelers,21,14,2007,4,domingo,Regular Season,2-2,2,2,0,15,22,-7,3-1,3,1,0,6,4,2,Arizona Cardinals,18
2007-09-24,New Orleans Saints,Tennessee Titans,14,31,2007,3,segunda,Regular Season,0-3,0,3,0,26,19,7,2-1,2,1,0,11,15,-4,Tennessee Titans,4
2007-09-23,Washington Redskins,New York Giants,17,24,2007,3,domingo,Regular Season,2-1,2,1,0,14,14,0,1-2,1,2,0,23,27,-4,New York Giants,13
2007-09-23,Tampa Bay Buccaneers,Los Angeles Rams,24,3,2007,3,domingo,Regular Season,2-1,2,1,0,19,23,-4,0-3,0,3,0,30,25,5,Tampa Bay Buccaneers,2
2007-09-23,Seattle Seahawks,Cincinnati Bengals,24,21,2007,3,domingo,Regular Season,2-1,2,1,0,7,9,-2,1-2,1,2,0,18,13,5,Seattle Seahawks,4
2007-09-23,Pittsburgh Steelers,San Francisco 49ers,37,16,2007,3,domingo,Regular Season,3-0,3,0,0,4,5,-1,2-1,2,1,0,15,10,5,Pittsburgh Steelers,5
2007-09-23,Philadelphia Eagles,Detroit Lions,56,21,2007,3,domingo,Regular Season,1-2,1,2,0,16,20,-4,2-1,2,1,0,20,18,2,Philadelphia Eagles,2
2007-09-23,Oakland Raiders,Cleveland Browns,26,24,2007,3,domingo,Regular Season,1-2,1,2,0,24,30,-6,1-2,1,2,0,27,26,1,Oakland Raiders,4
2007-09-23,New York Jets,Miami Dolphins,31,28,2007,3,domingo,Regular Season,1-2,1,2,0,21,24,-3,0-3,0,3,0,31,28,3,New York Jets,4
2007-09-23,New England Patriots,Buffalo Bills,38,7,2007,3,domingo,Regular Season,3-0,3,0,0,1,1,0,0-3,0,3,0,29,29,0,New England Patriots,28
2007-09-23,Kansas City Chiefs,Minnesota Vikings,13,10,2007,3,domingo,Regular Season,1-2,1,2,0,28,31,-3,1-2,1,2,0,25,22,3,Kansas City Chiefs,9
2007-09-23,Houston Texans,Indianapolis Colts,24,30,2007,3,domingo,Regular Season,2-1,2,1,0,17,11,6,3-0,3,0,0,2,2,0,Indianapolis Colts,9
2007-09-23,Green Bay Packers,Los Angeles Chargers,31,24,2007,3,domingo,Regular Season,3-0,3,0,0,6,12,-6,1-2,1,2,0,9,4,5,Green Bay Packers,8
2007-09-23,Denver Broncos,Jacksonville Jaguars,14,23,2007,3,domingo,Regular Season,2-1,2,1,0,8,8,0,2-1,2,1,0,10,17,-7,Jacksonville Jaguars,9
2007-09-23,Chicago Bears,Dallas Cowboys,10,34,2007,3,domingo,Regular Season,1-2,1,2,0,13,6,7,3-0,3,0,0,3,3,0,Dallas Cowboys,3
2007-09-23,Baltimore Ravens,Arizona Cardinals,26,23,2007,3,domingo,Regular Season,2-1,2,1,0,5,7,-2,1-2,1,2,0,22,21,1,Baltimore Ravens,14
2007-09-23,Atlanta Falcons,Carolina Panthers,20,27,2007,3,domingo,Regular Season,0-3,0,3,0,32,32,0,2-1,2,1,0,12,16,-4,Carolina Panthers,16
2007-09-17,Philadelphia Eagles,Washington Redskins,12,20,2007,2,segunda,Regular Season,0-2,0,2,0,20,13,7,2-0,2,0,0,14,19,-5,Washington Redskins,6
2007-09-16,Tennessee Titans,Indianapolis Colts,20,22,2007,2,domingo,Regular Season,1-1,1,1,0,15,14,1,2-0,2,0,0,2,2,0,Indianapolis Colts,12
2007-09-16,Tampa Bay Buccaneers,New Orleans Saints,31,14,2007,2,domingo,Regular Season,1-1,1,1,0,23,28,-5,0-2,0,2,0,19,11,8,Tampa Bay Buccaneers,17
2007-09-16,Los Angeles Rams,San Francisco 49ers,16,17,2007,2,domingo,Regular Season,0-2,0,2,0,25,20,5,2-0,2,0,0,10,15,-5,San Francisco 49ers,5
2007-09-16,Pittsburgh Steelers,Buffalo Bills,26,3,2007,2,domingo,Regular Season,2-0,2,0,0,5,9,-4,0-2,0,2,0,29,26,3,Pittsburgh Steelers,17
2007-09-16,New York Giants,Green Bay Packers,13,35,2007,2,domingo,Regular Season,0-2,0,2,0,27,22,5,2-0,2,0,0,12,17,-5,Green Bay Packers,5
2007-09-16,New England Patriots,Los Angeles Chargers,38,14,2007,2,domingo,Regular Season,2-0,2,0,0,1,1,0,1-1,1,1,0,4,3,1,New England Patriots,2
2007-09-16,Miami Dolphins,Dallas Cowboys,20,37,2007,2,domingo,Regular Season,0-2,0,2,0,28,27,1,2-0,2,0,0,3,5,-2,Dallas Cowboys,22
2007-09-16,Jacksonville Jaguars,Atlanta Falcons,13,7,2007,2,domingo,Regular Season,1-1,1,1,0,17,16,1,0-2,0,2,0,32,31,1,Jacksonville Jaguars,15
2007-09-16,Detroit Lions,Minnesota Vikings,20,17,2007,2,domingo,Regular Season,2-0,2,0,0,18,21,-3,1-1,1,1,0,22,24,-2,Detroit Lions,3
2007-09-16,Denver Broncos,Oakland Raiders,23,20,2007,2,domingo,Regular Season,2-0,2,0,0,8,10,-2,0-2,0,2,0,30,29,1,Denver Broncos,19
2007-09-16,Cleveland Browns,Cincinnati Bengals,51,45,2007,2,domingo,Regular Season,1-1,1,1,0,26,32,-6,1-1,1,1,0,13,6,7,Cleveland Browns,26
2007-09-16,Chicago Bears,Kansas City Chiefs,20,10,2007,2,domingo,Regular Season,1-1,1,1,0,6,4,2,0-2,0,2,0,31,30,1,Chicago Bears,26
2007-09-16,Carolina Panthers,Houston Texans,21,34,2007,2,domingo,Regular Season,1-1,1,1,0,16,12,4,2-0,2,0,0,11,25,-14,Houston Texans,13
2007-09-16,Baltimore Ravens,New York Jets,20,13,2007,2,domingo,Regular Season,1-1,1,1,0,7,7,0,0-2,0,2,0,24,18,6,Baltimore Ravens,11
2007-09-16,Arizona Cardinals,Seattle Seahawks,23,20,2007,2,domingo,Regular Season,1-1,1,1,0,21,23,-2,1-1,1,1,0,9,8,1,Arizona Cardinals,15
2007-09-10,San Francisco 49ers,Arizona Cardinals,20,17,2007,1,segunda,Regular Season,1-0,1,0,0,15,16,-1,0-1,0,1,0,23,23,0,San Francisco 49ers,7
2007-09-10,Cincinnati Bengals,Baltimore Ravens,27,20,2007,1,segunda,Regular Season,1-0,1,0,0,6,11,-5,0-1,0,1,0,7,5,2,Cincinnati Bengals,6
2007-09-09,Washington Redskins,Miami Dolphins,16,13,2007,1,domingo,Regular Season,1-0,1,0,0,19,19,0,0-1,0,1,0,27,20,7,Washington Redskins,1
2007-09-09,Los Angeles Rams,Carolina Panthers,13,27,2007,1,domingo,Regular Season,0-1,0,1,0,20,17,3,1-0,1,0,0,12,15,-3,Carolina Panthers,2
2007-09-09,Seattle Seahawks,Tampa Bay Buccaneers,20,6,2007,1,domingo,Regular Season,1-0,1,0,0,8,10,-2,0-1,0,1,0,28,28,0,Seattle Seahawks,18
2007-09-09,Los Angeles Chargers,Chicago Bears,14,3,2007,1,domingo,Regular Season,1-0,1,0,0,3,3,0,0-1,0,1,0,4,4,0,Los Angeles Chargers,1
2007-09-09,Oakland Raiders,Detroit Lions,21,36,2007,1,domingo,Regular Season,0-1,0,1,0,29,30,-1,1-0,1,0,0,21,25,-4,Detroit Lions,5
2007-09-09,New York Jets,New England Patriots,14,38,2007,1,domingo,Regular Season,0-1,0,1,0,18,14,4,1-0,1,0,0,1,1,0,New England Patriots,13
2007-09-09,Minnesota Vikings,Atlanta Falcons,24,3,2007,1,domingo,Regular Season,1-0,1,0,0,24,27,-3,0-1,0,1,0,31,31,0,Minnesota Vikings,4
2007-09-09,Jacksonville Jaguars,Tennessee Titans,10,13,2007,1,domingo,Regular Season,0-1,0,1,0,16,12,4,1-0,1,0,0,14,22,-8,Tennessee Titans,10
2007-09-09,Houston Texans,Kansas City Chiefs,20,3,2007,1,domingo,Regular Season,1-0,1,0,0,25,29,-4,0-1,0,1,0,30,26,4,Houston Texans,3
2007-09-09,Green Bay Packers,Philadelphia Eagles,16,13,2007,1,domingo,Regular Season,1-0,1,0,0,17,24,-7,0-1,0,1,0,13,7,6,Green Bay Packers,17
2007-09-09,Dallas Cowboys,New York Giants,45,35,2007,1,domingo,Regular Season,1-0,1,0,0,5,8,-3,0-1,0,1,0,22,18,4,Dallas Cowboys,10
2007-09-09,Cleveland Browns,Pittsburgh Steelers,7,34,2007,1,domingo,Regular Season,0-1,0,1,0,32,32,0,1-0,1,0,0,9,13,-4,Pittsburgh Steelers,19
2007-09-09,Buffalo Bills,Denver Broncos,14,15,2007,1,domingo,Regular Season,0-1,0,1,0,26,21,5,1-0,1,0,0,10,9,1,Denver Broncos,12
2007-09-06,Indianapolis Colts,New Orleans Saints,41,10,2007,1,quinta,Regular Season,1-0,1,0,0,2,2,0,0-1,0,1,0,11,6,5,Indianapolis Colts,4
2006-12-31,Tennessee Titans,New England Patriots,23,40,2006,17,domingo,Regular Season,8-8,8,8,0,15,11,4,12-4,12,4,0,3,5,-2,New England Patriots,6
2006-12-31,Tampa Bay Buccaneers,Seattle Seahawks,7,23,2006,17,domingo,Regular Season,4-12,4,12,0,29,29,0,9-7,9,7,0,9,15,-6,Seattle Seahawks,14
2006-12-31,Los Angeles Chargers,Arizona Cardinals,27,20,2006,17,domingo,Regular Season,14-2,14,2,0,1,1,0,5-11,5,11,0,28,27,1,Los Angeles Chargers,26
2006-12-31,Philadelphia Eagles,Atlanta Falcons,24,17,2006,17,domingo,Regular Season,10-6,10,6,0,7,7,0,7-9,7,9,0,22,21,1,Philadelphia Eagles,14
2006-12-31,New York Jets,Oakland Raiders,23,3,2006,17,domingo,Regular Season,10-6,10,6,0,8,10,-2,2-14,2,14,0,32,31,1,New York Jets,21
2006-12-31,New Orleans Saints,Carolina Panthers,21,31,2006,17,domingo,Regular Season,10-6,10,6,0,6,4,2,8-8,8,8,0,20,22,-2,Carolina Panthers,18
2006-12-31,Minnesota Vikings,Los Angeles Rams,21,41,2006,17,domingo,Regular Season,6-10,6,10,0,26,25,1,8-8,8,8,0,18,18,0,Los Angeles Rams,7
2006-12-31,Kansas City Chiefs,Jacksonville Jaguars,35,30,2006,17,domingo,Regular Season,9-7,9,7,0,10,14,-4,8-8,8,8,0,17,13,4,Kansas City Chiefs,1
2006-12-31,Indianapolis Colts,Miami Dolphins,27,22,2006,17,domingo,Regular Season,12-4,12,4,0,4,6,-2,6-10,6,10,0,24,23,1,Indianapolis Colts,17
2006-12-31,Houston Texans,Cleveland Browns,14,6,2006,17,domingo,Regular Season,6-10,6,10,0,25,28,-3,4-12,4,12,0,30,30,0,Houston Texans,2
2006-12-31,Denver Broncos,San Francisco 49ers,23,26,2006,17,domingo,Regular Season,9-7,9,7,0,12,8,4,7-9,7,9,0,23,24,-1,San Francisco 49ers,16
2006-12-31,Dallas Cowboys,Detroit Lions,31,39,2006,17,domingo,Regular Season,9-7,9,7,0,11,9,2,3-13,3,13,0,31,32,-1,Detroit Lions,23
2006-12-31,Cincinnati Bengals,Pittsburgh Steelers,17,23,2006,17,domingo,Regular Season,8-8,8,8,0,14,12,2,8-8,8,8,0,13,19,-6,Pittsburgh Steelers,7
2006-12-31,Chicago Bears,Green Bay Packers,7,26,2006,17,domingo,Regular Season,13-3,13,3,0,5,3,2,8-8,8,8,0,19,17,2,Green Bay Packers,14
2006-12-31,Baltimore Ravens,Buffalo Bills,19,7,2006,17,domingo,Regular Season,13-3,13,3,0,2,2,0,7-9,7,9,0,21,16,5,Baltimore Ravens,14
2006-12-30,Washington Redskins,New York Giants,28,34,2006,17,sábado,Regular Season,5-11,5,11,0,27,26,1,8-8,8,8,0,16,20,-4,New York Giants,6
2006-12-25,Miami Dolphins,New York Jets,10,13,2006,16,segunda,Regular Season,6-9,6,9,0,23,21,2,9-6,9,6,0,10,11,-1,New York Jets,10
2006-12-25,Dallas Cowboys,Philadelphia Eagles,7,23,2006,16,segunda,Regular Season,9-6,9,6,0,9,7,2,9-6,9,6,0,7,9,-2,Philadelphia Eagles,2
2006-12-24,Los Angeles Rams,Washington Redskins,37,31,2006,16,domingo,Regular Season,7-8,7,8,0,18,23,-5,5-10,5,10,0,26,26,0,Los Angeles Rams,3
2006-12-24,Seattle Seahawks,Los Angeles Chargers,17,20,2006,16,domingo,Regular Season,8-7,8,7,0,15,15,0,13-2,13,2,0,1,1,0,Los Angeles Chargers,14
2006-12-24,San Francisco 49ers,Arizona Cardinals,20,26,2006,16,domingo,Regular Season,6-9,6,9,0,24,20,4,5-10,5,10,0,27,27,0,Arizona Cardinals,7
2006-12-24,Pittsburgh Steelers,Baltimore Ravens,7,31,2006,16,domingo,Regular Season,7-8,7,8,0,19,14,5,12-3,12,3,0,2,2,0,Baltimore Ravens,12
2006-12-24,New York Giants,New Orleans Saints,7,30,2006,16,domingo,Regular Season,7-8,7,8,0,20,17,3,10-5,10,5,0,4,6,-2,New Orleans Saints,11
2006-12-24,Jacksonville Jaguars,New England Patriots,21,24,2006,16,domingo,Regular Season,8-7,8,7,0,13,12,1,11-4,11,4,0,5,5,0,New England Patriots,7
2006-12-24,Houston Texans,Indianapolis Colts,27,24,2006,16,domingo,Regular Season,5-10,5,10,0,28,29,-1,11-4,11,4,0,6,3,3,Houston Texans,26
2006-12-24,Detroit Lions,Chicago Bears,21,26,2006,16,domingo,Regular Season,2-13,2,13,0,32,32,0,13-2,13,2,0,3,4,-1,Chicago Bears,28
2006-12-24,Denver Broncos,Cincinnati Bengals,24,23,2006,16,domingo,Regular Season,9-6,9,6,0,8,10,-2,8-7,8,7,0,12,8,4,Denver Broncos,2
2006-12-24,Cleveland Browns,Tampa Bay Buccaneers,7,22,2006,16,domingo,Regular Season,4-11,4,11,0,30,28,2,4-11,4,11,0,29,30,-1,Tampa Bay Buccaneers,2
2006-12-24,Buffalo Bills,Tennessee Titans,29,30,2006,16,domingo,Regular Season,7-8,7,8,0,16,16,0,8-7,8,7,0,11,13,-2,Tennessee Titans,3
2006-12-24,Atlanta Falcons,Carolina Panthers,3,10,2006,16,domingo,Regular Season,7-8,7,8,0,21,18,3,7-8,7,8,0,22,25,-3,Carolina Panthers,7
2006-12-23,Oakland Raiders,Kansas City Chiefs,9,20,2006,16,sábado,Regular Season,2-13,2,13,0,31,31,0,8-7,8,7,0,14,19,-5,Kansas City Chiefs,12
2006-12-21,Green Bay Packers,Minnesota Vikings,9,7,2006,16,quinta,Regular Season,7-8,7,8,0,17,22,-5,6-9,6,9,0,25,24,1,Green Bay Packers,2
2006-12-18,Indianapolis Colts,Cincinnati Bengals,34,16,2006,15,segunda,Regular Season,11-3,11,3,0,3,6,-3,8-6,8,6,0,8,5,3,Indianapolis Colts,1
2006-12-17,Tennessee Titans,Jacksonville Jaguars,24,17,2006,15,domingo,Regular Season,7-7,7,7,0,13,14,-1,8-6,8,6,0,12,9,3,Tennessee Titans,5
2006-12-17,Los Angeles Chargers,Kansas City Chiefs,20,9,2006,15,domingo,Regular Season,12-2,12,2,0,1,1,0,7-7,7,7,0,19,15,4,Los Angeles Chargers,14
2006-12-17,Oakland Raiders,Los Angeles Rams,0,20,2006,15,domingo,Regular Season,2-12,2,12,0,31,31,0,6-8,6,8,0,23,24,-1,Los Angeles Rams,7
2006-12-17,New York Giants,Philadelphia Eagles,22,36,2006,15,domingo,Regular Season,7-7,7,7,0,17,11,6,8-6,8,6,0,9,13,-4,Philadelphia Eagles,2
2006-12-17,New Orleans Saints,Washington Redskins,10,16,2006,15,domingo,Regular Season,9-5,9,5,0,6,3,3,5-9,5,9,0,26,27,-1,Washington Redskins,24
2006-12-17,New England Patriots,Houston Texans,40,7,2006,15,domingo,Regular Season,10-4,10,4,0,5,8,-3,4-10,4,10,0,29,28,1,New England Patriots,20
2006-12-17,Minnesota Vikings,New York Jets,13,26,2006,15,domingo,Regular Season,6-8,6,8,0,24,21,3,8-6,8,6,0,11,16,-5,New York Jets,5
2006-12-17,Green Bay Packers,Detroit Lions,17,9,2006,15,domingo,Regular Season,6-8,6,8,0,22,23,-1,2-12,2,12,0,32,32,0,Green Bay Packers,9
2006-12-17,Chicago Bears,Tampa Bay Buccaneers,34,31,2006,15,domingo,Regular Season,12-2,12,2,0,4,4,0,3-11,3,11,0,30,30,0,Chicago Bears,26
2006-12-17,Carolina Panthers,Pittsburgh Steelers,3,37,2006,15,domingo,Regular Season,6-8,6,8,0,25,22,3,7-7,7,7,0,14,20,-6,Pittsburgh Steelers,2
2006-12-17,Buffalo Bills,Miami Dolphins,21,0,2006,15,domingo,Regular Season,7-7,7,7,0,16,19,-3,6-8,6,8,0,21,18,3,Buffalo Bills,1
2006-12-17,Baltimore Ravens,Cleveland Browns,27,17,2006,15,domingo,Regular Season,11-3,11,3,0,2,2,0,4-10,4,10,0,28,29,-1,Baltimore Ravens,27
2006-12-17,Arizona Cardinals,Denver Broncos,20,37,2006,15,domingo,Regular Season,4-10,4,10,0,27,26,1,8-6,8,6,0,10,17,-7,Denver Broncos,9
2006-12-16,Atlanta Falcons,Dallas Cowboys,28,38,2006,15,sábado,Regular Season,7-7,7,7,0,18,12,6,9-5,9,5,0,7,7,0,Dallas Cowboys,5
2006-12-14,Seattle Seahawks,San Francisco 49ers,14,24,2006,15,quinta,Regular Season,8-6,8,6,0,15,10,5,6-8,6,8,0,20,25,-5,San Francisco 49ers,15
2006-12-11,Los Angeles Rams,Chicago Bears,27,42,2006,14,segunda,Regular Season,5-8,5,8,0,24,23,1,11-2,11,2,0,4,4,0,Chicago Bears,19
2006-12-10,Washington Redskins,Philadelphia Eagles,19,21,2006,14,domingo,Regular Season,4-9,4,9,0,27,25,2,7-6,7,6,0,13,17,-4,Philadelphia Eagles,8
2006-12-10,Tampa Bay Buccaneers,Atlanta Falcons,6,17,2006,14,domingo,Regular Season,3-10,3,10,0,30,30,0,7-6,7,6,0,12,14,-2,Atlanta Falcons,16
2006-12-10,San Francisco 49ers,Green Bay Packers,19,30,2006,14,domingo,Regular Season,5-8,5,8,0,25,22,3,5-8,5,8,0,23,28,-5,Green Bay Packers,6
2006-12-10,Los Angeles Chargers,Denver Broncos,48,20,2006,14,domingo,Regular Season,11-2,11,2,0,1,1,0,7-6,7,6,0,17,13,4,Los Angeles Chargers,12
2006-12-10,New York Jets,Buffalo Bills,13,31,2006,14,domingo,Regular Season,7-6,7,6,0,16,11,5,6-7,6,7,0,19,21,-2,Buffalo Bills,10
2006-12-10,Miami Dolphins,New England Patriots,21,0,2006,14,domingo,Regular Season,6-7,6,7,0,18,20,-2,9-4,9,4,0,8,5,3,Miami Dolphins,15
2006-12-10,Kansas City Chiefs,Baltimore Ravens,10,20,2006,14,domingo,Regular Season,7-6,7,6,0,15,12,3,10-3,10,3,0,2,6,-4,Baltimore Ravens,6
2006-12-10,Jacksonville Jaguars,Indianapolis Colts,44,17,2006,14,domingo,Regular Season,8-5,8,5,0,9,10,-1,10-3,10,3,0,6,2,4,Jacksonville Jaguars,8
2006-12-10,Houston Texans,Tennessee Titans,20,26,2006,14,domingo,Regular Season,4-9,4,9,0,28,27,1,6-7,6,7,0,14,16,-2,Tennessee Titans,11
2006-12-10,Detroit Lions,Minnesota Vikings,20,30,2006,14,domingo,Regular Season,2-11,2,11,0,32,32,0,6-7,6,7,0,21,24,-3,Minnesota Vikings,8
2006-12-10,Dallas Cowboys,New Orleans Saints,17,42,2006,14,domingo,Regular Season,8-5,8,5,0,7,3,4,9-4,9,4,0,3,7,-4,New Orleans Saints,4
2006-12-10,Cincinnati Bengals,Oakland Raiders,27,10,2006,14,domingo,Regular Season,8-5,8,5,0,5,8,-3,2-11,2,11,0,31,31,0,Cincinnati Bengals,23
2006-12-10,Carolina Panthers,New York Giants,13,27,2006,14,domingo,Regular Season,6-7,6,7,0,22,18,4,7-6,7,6,0,11,15,-4,New York Giants,3
2006-12-10,Arizona Cardinals,Seattle Seahawks,27,21,2006,14,domingo,Regular Season,4-9,4,9,0,26,29,-3,8-5,8,5,0,10,9,1,Arizona Cardinals,20
2006-12-07,Pittsburgh Steelers,Cleveland Browns,27,7,2006,14,quinta,Regular Season,6-7,6,7,0,20,19,1,4-9,4,9,0,29,26,3,Pittsburgh Steelers,7
2006-12-04,Philadelphia Eagles,Carolina Panthers,27,24,2006,13,segunda,Regular Season,6-6,6,6,0,17,22,-5,6-6,6,6,0,18,12,6,Philadelphia Eagles,10
2006-12-03,Washington Redskins,Atlanta Falcons,14,24,2006,13,domingo,Regular Season,4-8,4,8,0,25,25,0,6-6,6,6,0,14,18,-4,Atlanta Falcons,7
2006-12-03,Tennessee Titans,Indianapolis Colts,20,17,2006,13,domingo,Regular Season,5-7,5,7,0,16,23,-7,10-2,10,2,0,2,1,1,Tennessee Titans,22
2006-12-03,Los Angeles Rams,Arizona Cardinals,20,34,2006,13,domingo,Regular Season,5-7,5,7,0,23,17,6,3-9,3,9,0,29,31,-2,Arizona Cardinals,14
2006-12-03,Pittsburgh Steelers,Tampa Bay Buccaneers,20,3,2006,13,domingo,Regular Season,5-7,5,7,0,19,24,-5,3-9,3,9,0,30,28,2,Pittsburgh Steelers,4
2006-12-03,Oakland Raiders,Houston Texans,14,23,2006,13,domingo,Regular Season,2-10,2,10,0,31,30,1,4-8,4,8,0,27,27,0,Houston Texans,3
2006-12-03,New York Giants,Dallas Cowboys,20,23,2006,13,domingo,Regular Season,6-6,6,6,0,15,15,0,8-4,8,4,0,3,6,-3,Dallas Cowboys,9
2006-12-03,New Orleans Saints,San Francisco 49ers,34,10,2006,13,domingo,Regular Season,8-4,8,4,0,7,10,-3,5-7,5,7,0,22,20,2,New Orleans Saints,10
2006-12-03,New England Patriots,Detroit Lions,28,21,2006,13,domingo,Regular Season,9-3,9,3,0,5,4,1,2-10,2,10,0,32,32,0,New England Patriots,28
2006-12-03,Miami Dolphins,Jacksonville Jaguars,10,24,2006,13,domingo,Regular Season,5-7,5,7,0,20,16,4,7-5,7,5,0,10,13,-3,Jacksonville Jaguars,3
2006-12-03,Green Bay Packers,New York Jets,10,38,2006,13,domingo,Regular Season,4-8,4,8,0,28,26,2,7-5,7,5,0,11,14,-3,New York Jets,12
2006-12-03,Denver Broncos,Seattle Seahawks,20,23,2006,13,domingo,Regular Season,7-5,7,5,0,13,9,4,8-4,8,4,0,9,8,1,Seattle Seahawks,1
2006-12-03,Cleveland Browns,Kansas City Chiefs,31,28,2006,13,domingo,Regular Season,4-8,4,8,0,26,29,-3,7-5,7,5,0,12,7,5,Cleveland Browns,22
2006-12-03,Chicago Bears,Minnesota Vikings,23,13,2006,13,domingo,Regular Season,10-2,10,2,0,4,5,-1,5-7,5,7,0,24,21,3,Chicago Bears,16
2006-12-03,Buffalo Bills,Los Angeles Chargers,21,24,2006,13,domingo,Regular Season,5-7,5,7,0,21,19,2,10-2,10,2,0,1,2,-1,Los Angeles Chargers,17
2006-11-30,Cincinnati Bengals,Baltimore Ravens,13,7,2006,13,quinta,Regular Season,7-5,7,5,0,8,11,-3,9-3,9,3,0,6,3,3,Cincinnati Bengals,8
2006-11-27,Seattle Seahawks,Green Bay Packers,34,24,2006,12,segunda,Regular Season,7-4,7,4,0,8,11,-3,4-7,4,7,0,26,22,4,Seattle Seahawks,11
2006-11-26,Washington Redskins,Carolina Panthers,17,13,2006,12,domingo,Regular Season,4-7,4,7,0,25,28,-3,6-5,6,5,0,12,8,4,Washington Redskins,20
2006-11-26,Tennessee Titans,New York Giants,24,21,2006,12,domingo,Regular Season,4-7,4,7,0,23,25,-2,6-5,6,5,0,15,14,1,Tennessee Titans,11
2006-11-26,Los Angeles Rams,San Francisco 49ers,20,17,2006,12,domingo,Regular Season,5-6,5,6,0,17,21,-4,5-6,5,6,0,20,18,2,Los Angeles Rams,3
2006-11-26,Los Angeles Chargers,Oakland Raiders,21,14,2006,12,domingo,Regular Season,9-2,9,2,0,2,1,1,2-9,2,9,0,30,32,-2,Los Angeles Chargers,31
2006-11-26,New York Jets,Houston Texans,26,11,2006,12,domingo,Regular Season,6-5,6,5,0,14,17,-3,3-8,3,8,0,27,26,1,New York Jets,9
2006-11-26,New England Patriots,Chicago Bears,17,13,2006,12,domingo,Regular Season,8-3,8,3,0,4,5,-1,9-2,9,2,0,5,3,2,New England Patriots,2
2006-11-26,Minnesota Vikings,Arizona Cardinals,31,26,2006,12,domingo,Regular Season,5-6,5,6,0,21,24,-3,2-9,2,9,0,31,30,1,Minnesota Vikings,6
2006-11-26,Indianapolis Colts,Philadelphia Eagles,45,21,2006,12,domingo,Regular Season,10-1,10,1,0,1,2,-1,5-6,5,6,0,22,20,2,Indianapolis Colts,18
2006-11-26,Cleveland Browns,Cincinnati Bengals,0,30,2006,12,domingo,Regular Season,3-8,3,8,0,29,29,0,6-5,6,5,0,11,12,-1,Cincinnati Bengals,17
2006-11-26,Buffalo Bills,Jacksonville Jaguars,27,24,2006,12,domingo,Regular Season,5-6,5,6,0,19,23,-4,6-5,6,5,0,13,9,4,Buffalo Bills,14
2006-11-26,Baltimore Ravens,Pittsburgh Steelers,27,0,2006,12,domingo,Regular Season,9-2,9,2,0,3,4,-1,4-7,4,7,0,24,15,9,Baltimore Ravens,11
2006-11-26,Atlanta Falcons,New Orleans Saints,13,31,2006,12,domingo,Regular Season,5-6,5,6,0,18,16,2,7-4,7,4,0,10,13,-3,New Orleans Saints,3
2006-11-23,Kansas City Chiefs,Denver Broncos,19,10,2006,12,quinta,Regular Season,7-4,7,4,0,7,10,-3,7-4,7,4,0,9,7,2,Kansas City Chiefs,3
2006-11-23,Detroit Lions,Miami Dolphins,10,27,2006,12,quinta,Regular Season,2-9,2,9,0,32,31,1,5-6,5,6,0,16,19,-3,Miami Dolphins,12
2006-11-23,Dallas Cowboys,Tampa Bay Buccaneers,38,10,2006,12,quinta,Regular Season,7-4,7,4,0,6,6,0,3-8,3,8,0,28,27,1,Dallas Cowboys,21
2006-11-20,Jacksonville Jaguars,New York Giants,26,10,2006,11,segunda,Regular Season,6-4,6,4,0,9,16,-7,6-4,6,4,0,14,8,6,Jacksonville Jaguars,8
2006-11-19,Tampa Bay Buccaneers,Washington Redskins,20,17,2006,11,domingo,Regular Season,3-7,3,7,0,27,28,-1,3-7,3,7,0,28,25,3,Tampa Bay Buccaneers,3
2006-11-19,San Francisco 49ers,Seattle Seahawks,20,14,2006,11,domingo,Regular Season,5-5,5,5,0,18,22,-4,6-4,6,4,0,11,7,4,San Francisco 49ers,15
2006-11-19,Philadelphia Eagles,Tennessee Titans,13,31,2006,11,domingo,Regular Season,5-5,5,5,0,20,11,9,3-7,3,7,0,25,29,-4,Tennessee Titans,18
2006-11-19,New York Jets,Chicago Bears,0,10,2006,11,domingo,Regular Season,5-5,5,5,0,17,14,3,9-1,9,1,0,3,2,1,Chicago Bears,12
2006-11-19,New Orleans Saints,Cincinnati Bengals,16,31,2006,11,domingo,Regular Season,6-4,6,4,0,13,9,4,5-5,5,5,0,12,17,-5,Cincinnati Bengals,8
2006-11-19,Miami Dolphins,Minnesota Vikings,24,20,2006,11,domingo,Regular Season,4-6,4,6,0,19,21,-2,4-6,4,6,0,24,23,1,Miami Dolphins,2
2006-11-19,Kansas City Chiefs,Oakland Raiders,17,13,2006,11,domingo,Regular Season,6-4,6,4,0,10,13,-3,2-8,2,8,0,32,31,1,Kansas City Chiefs,18
2006-11-19,Houston Texans,Buffalo Bills,21,24,2006,11,domingo,Regular Season,3-7,3,7,0,26,26,0,4-6,4,6,0,23,27,-4,Buffalo Bills,1
2006-11-19,Green Bay Packers,New England Patriots,0,35,2006,11,domingo,Regular Season,4-6,4,6,0,22,20,2,7-3,7,3,0,5,6,-1,New England Patriots,14
2006-11-19,Denver Broncos,Los Angeles Chargers,27,35,2006,11,domingo,Regular Season,7-3,7,3,0,7,4,3,8-2,8,2,0,1,3,-2,Los Angeles Chargers,1
2006-11-19,Dallas Cowboys,Indianapolis Colts,21,14,2006,11,domingo,Regular Season,6-4,6,4,0,6,10,-4,9-1,9,1,0,2,1,1,Dallas Cowboys,9
2006-11-19,Cleveland Browns,Pittsburgh Steelers,20,24,2006,11,domingo,Regular Season,3-7,3,7,0,29,24,5,4-6,4,6,0,15,19,-4,Pittsburgh Steelers,5
2006-11-19,Carolina Panthers,Los Angeles Rams,15,0,2006,11,domingo,Regular Season,6-4,6,4,0,8,12,-4,4-6,4,6,0,21,18,3,Carolina Panthers,6
2006-11-19,Baltimore Ravens,Atlanta Falcons,24,10,2006,11,domingo,Regular Season,8-2,8,2,0,4,5,-1,5-5,5,5,0,16,15,1,Baltimore Ravens,10
2006-11-19,Arizona Cardinals,Detroit Lions,17,10,2006,11,domingo,Regular Season,2-8,2,8,0,30,32,-2,2-8,2,8,0,31,30,1,Arizona Cardinals,2
2006-11-13,Carolina Panthers,Tampa Bay Buccaneers,24,10,2006,10,segunda,Regular Season,5-4,5,4,0,12,14,-2,2-7,2,7,0,28,27,1,Carolina Panthers,13
2006-11-12,Tennessee Titans,Baltimore Ravens,26,27,2006,10,domingo,Regular Season,2-7,2,7,0,29,29,0,7-2,7,2,0,5,7,-2,Baltimore Ravens,22
2006-11-12,Seattle Seahawks,Los Angeles Rams,24,22,2006,10,domingo,Regular Season,6-3,6,3,0,7,12,-5,4-5,4,5,0,18,17,1,Seattle Seahawks,5
2006-11-12,Pittsburgh Steelers,New Orleans Saints,38,31,2006,10,domingo,Regular Season,3-6,3,6,0,19,24,-5,6-3,6,3,0,9,8,1,Pittsburgh Steelers,16
2006-11-12,Philadelphia Eagles,Washington Redskins,27,3,2006,10,domingo,Regular Season,5-4,5,4,0,11,16,-5,3-6,3,6,0,25,20,5,Philadelphia Eagles,4
2006-11-12,Oakland Raiders,Denver Broncos,13,17,2006,10,domingo,Regular Season,2-7,2,7,0,31,31,0,7-2,7,2,0,4,2,2,Denver Broncos,29
2006-11-12,New York Giants,Chicago Bears,20,38,2006,10,domingo,Regular Season,6-3,6,3,0,8,6,2,8-1,8,1,0,2,3,-1,Chicago Bears,3
2006-11-12,New England Patriots,New York Jets,14,17,2006,10,domingo,Regular Season,6-3,6,3,0,6,4,2,5-4,5,4,0,14,19,-5,New York Jets,15
2006-11-12,Minnesota Vikings,Green Bay Packers,17,23,2006,10,domingo,Regular Season,4-5,4,5,0,23,18,5,4-5,4,5,0,20,22,-2,Green Bay Packers,4
2006-11-12,Miami Dolphins,Kansas City Chiefs,13,10,2006,10,domingo,Regular Season,3-6,3,6,0,21,25,-4,5-4,5,4,0,13,11,2,Miami Dolphins,14
2006-11-12,Jacksonville Jaguars,Houston Texans,10,13,2006,10,domingo,Regular Season,5-4,5,4,0,16,10,6,3-6,3,6,0,26,28,-2,Houston Texans,18
2006-11-12,Indianapolis Colts,Buffalo Bills,17,16,2006,10,domingo,Regular Season,9-0,9,0,0,1,1,0,3-6,3,6,0,27,21,6,Indianapolis Colts,20
2006-11-12,Detroit Lions,San Francisco 49ers,13,19,2006,10,domingo,Regular Season,2-7,2,7,0,30,26,4,4-5,4,5,0,22,23,-1,San Francisco 49ers,3
2006-11-12,Cincinnati Bengals,Los Angeles Chargers,41,49,2006,10,domingo,Regular Season,4-5,4,5,0,17,13,4,7-2,7,2,0,3,5,-2,Los Angeles Chargers,8
2006-11-12,Atlanta Falcons,Cleveland Browns,13,17,2006,10,domingo,Regular Season,5-4,5,4,0,15,9,6,3-6,3,6,0,24,30,-6,Cleveland Browns,21
2006-11-12,Arizona Cardinals,Dallas Cowboys,10,27,2006,10,domingo,Regular Season,1-8,1,8,0,32,32,0,5-4,5,4,0,10,15,-5,Dallas Cowboys,17
2006-11-06,Seattle Seahawks,Oakland Raiders,16,0,2006,9,segunda,Regular Season,5-3,5,3,0,12,13,-1,2-6,2,6,0,31,28,3,Seattle Seahawks,15
2006-11-05,Washington Redskins,Dallas Cowboys,22,19,2006,9,domingo,Regular Season,3-5,3,5,0,20,23,-3,4-4,4,4,0,15,11,4,Washington Redskins,12
2006-11-05,Tampa Bay Buccaneers,New Orleans Saints,14,31,2006,9,domingo,Regular Season,2-6,2,6,0,27,24,3,6-2,6,2,0,8,9,-1,New Orleans Saints,15
2006-11-05,Los Angeles Rams,Kansas City Chiefs,17,31,2006,9,domingo,Regular Season,4-4,4,4,0,17,18,-1,5-3,5,3,0,11,14,-3,Kansas City Chiefs,4
2006-11-05,San Francisco 49ers,Minnesota Vikings,9,3,2006,9,domingo,Regular Season,3-5,3,5,0,23,29,-6,4-4,4,4,0,18,16,2,San Francisco 49ers,13
2006-11-05,Los Angeles Chargers,Cleveland Browns,32,25,2006,9,domingo,Regular Season,6-2,6,2,0,5,5,0,2-6,2,6,0,30,26,4,Los Angeles Chargers,21
2006-11-05,Pittsburgh Steelers,Denver Broncos,20,31,2006,9,domingo,Regular Season,2-6,2,6,0,24,21,3,6-2,6,2,0,2,6,-4,Denver Broncos,15
2006-11-05,New York Giants,Houston Texans,14,10,2006,9,domingo,Regular Season,6-2,6,2,0,6,4,2,2-6,2,6,0,28,25,3,New York Giants,21
2006-11-05,New England Patriots,Indianapolis Colts,20,27,2006,9,domingo,Regular Season,6-2,6,2,0,4,3,1,8-0,8,0,0,1,2,-1,Indianapolis Colts,1
2006-11-05,Jacksonville Jaguars,Tennessee Titans,37,7,2006,9,domingo,Regular Season,5-3,5,3,0,10,12,-2,2-6,2,6,0,29,22,7,Jacksonville Jaguars,10
2006-11-05,Detroit Lions,Atlanta Falcons,30,14,2006,9,domingo,Regular Season,2-6,2,6,0,26,30,-4,5-3,5,3,0,9,7,2,Detroit Lions,23
2006-11-05,Chicago Bears,Miami Dolphins,13,31,2006,9,domingo,Regular Season,7-1,7,1,0,3,1,2,2-6,2,6,0,25,31,-6,Miami Dolphins,30
2006-11-05,Buffalo Bills,Green Bay Packers,24,10,2006,9,domingo,Regular Season,3-5,3,5,0,21,27,-6,3-5,3,5,0,22,20,2,Buffalo Bills,7
2006-11-05,Baltimore Ravens,Cincinnati Bengals,26,20,2006,9,domingo,Regular Season,6-2,6,2,0,7,8,-1,4-4,4,4,0,13,10,3,Baltimore Ravens,2
2006-10-30,Minnesota Vikings,New England Patriots,7,31,2006,8,segunda,Regular Season,4-3,4,3,0,16,12,4,6-1,6,1,0,3,4,-1,New England Patriots,8
2006-10-29,Tennessee Titans,Houston Texans,28,22,2006,8,domingo,Regular Season,2-5,2,5,0,22,27,-5,2-5,2,5,0,25,22,3,Tennessee Titans,5
2006-10-29,Los Angeles Chargers,Los Angeles Rams,38,24,2006,8,domingo,Regular Season,5-2,5,2,0,5,8,-3,4-3,4,3,0,18,14,4,Los Angeles Chargers,6
2006-10-29,Philadelphia Eagles,Jacksonville Jaguars,6,13,2006,8,domingo,Regular Season,4-4,4,4,0,17,15,2,4-3,4,3,0,12,16,-4,Jacksonville Jaguars,1
2006-10-29,Oakland Raiders,Pittsburgh Steelers,20,13,2006,8,domingo,Regular Season,2-5,2,5,0,28,31,-3,2-5,2,5,0,21,18,3,Oakland Raiders,13
2006-10-29,New York Giants,Tampa Bay Buccaneers,17,3,2006,8,domingo,Regular Season,5-2,5,2,0,4,6,-2,2-5,2,5,0,24,21,3,New York Giants,15
2006-10-29,New Orleans Saints,Baltimore Ravens,22,35,2006,8,domingo,Regular Season,5-2,5,2,0,9,5,4,5-2,5,2,0,8,13,-5,Baltimore Ravens,8
2006-10-29,Kansas City Chiefs,Seattle Seahawks,35,28,2006,8,domingo,Regular Season,4-3,4,3,0,14,19,-5,4-3,4,3,0,13,11,2,Kansas City Chiefs,8
2006-10-29,Green Bay Packers,Arizona Cardinals,31,14,2006,8,domingo,Regular Season,3-4,3,4,0,20,23,-3,1-7,1,7,0,32,32,0,Green Bay Packers,9
2006-10-29,Denver Broncos,Indianapolis Colts,31,34,2006,8,domingo,Regular Season,5-2,5,2,0,6,3,3,7-0,7,0,0,2,2,0,Indianapolis Colts,1
2006-10-29,Cleveland Browns,New York Jets,20,13,2006,8,domingo,Regular Season,2-5,2,5,0,26,30,-4,4-4,4,4,0,19,20,-1,Cleveland Browns,10
2006-10-29,Cincinnati Bengals,Atlanta Falcons,27,29,2006,8,domingo,Regular Season,4-3,4,3,0,10,7,3,5-2,5,2,0,7,9,-2,Atlanta Falcons,2
2006-10-29,Chicago Bears,San Francisco 49ers,41,10,2006,8,domingo,Regular Season,7-0,7,0,0,1,1,0,2-5,2,5,0,29,25,4,Chicago Bears,24
2006-10-29,Carolina Panthers,Dallas Cowboys,14,35,2006,8,domingo,Regular Season,4-4,4,4,0,15,10,5,4-3,4,3,0,11,17,-6,Dallas Cowboys,7
2006-10-23,Dallas Cowboys,New York Giants,22,36,2006,7,segunda,Regular Season,3-3,3,3,0,17,15,2,4-2,4,2,0,6,11,-5,New York Giants,4
2006-10-22,Tampa Bay Buccaneers,Philadelphia Eagles,23,21,2006,7,domingo,Regular Season,2-4,2,4,0,21,22,-1,4-3,4,3,0,15,9,6,Tampa Bay Buccaneers,13
2006-10-22,Seattle Seahawks,Minnesota Vikings,13,31,2006,7,domingo,Regular Season,4-2,4,2,0,11,5,6,4-2,4,2,0,12,18,-6,Minnesota Vikings,13
2006-10-22,Oakland Raiders,Arizona Cardinals,22,9,2006,7,domingo,Regular Season,1-5,1,5,0,31,32,-1,1-6,1,6,0,32,29,3,Oakland Raiders,3
2006-10-22,New York Jets,Detroit Lions,31,24,2006,7,domingo,Regular Season,4-3,4,3,0,20,19,1,1-6,1,6,0,28,25,3,New York Jets,6
2006-10-22,Miami Dolphins,Green Bay Packers,24,34,2006,7,domingo,Regular Season,1-6,1,6,0,29,27,2,2-4,2,4,0,23,31,-8,Green Bay Packers,4
2006-10-22,Kansas City Chiefs,Los Angeles Chargers,30,27,2006,7,domingo,Regular Season,3-3,3,3,0,19,20,-1,4-2,4,2,0,8,3,5,Kansas City Chiefs,17
2006-10-22,Indianapolis Colts,Washington Redskins,36,22,2006,7,domingo,Regular Season,6-0,6,0,0,2,2,0,2-5,2,5,0,24,21,3,Indianapolis Colts,19
2006-10-22,Houston Texans,Jacksonville Jaguars,27,7,2006,7,domingo,Regular Season,2-4,2,4,0,22,30,-8,3-3,3,3,0,16,13,3,Houston Texans,17
2006-10-22,Cleveland Browns,Denver Broncos,7,17,2006,7,domingo,Regular Season,1-5,1,5,0,30,28,2,5-1,5,1,0,3,4,-1,Denver Broncos,24
2006-10-22,Cincinnati Bengals,Carolina Panthers,17,14,2006,7,domingo,Regular Season,4-2,4,2,0,7,12,-5,4-3,4,3,0,10,8,2,Cincinnati Bengals,4
2006-10-22,Buffalo Bills,New England Patriots,6,28,2006,7,domingo,Regular Season,2-5,2,5,0,26,23,3,5-1,5,1,0,4,6,-2,New England Patriots,17
2006-10-22,Atlanta Falcons,Pittsburgh Steelers,41,38,2006,7,domingo,Regular Season,4-2,4,2,0,9,16,-7,2-4,2,4,0,18,17,1,Atlanta Falcons,1
2006-10-16,Arizona Cardinals,Chicago Bears,23,24,2006,6,segunda,Regular Season,1-5,1,5,0,29,27,2,6-0,6,0,0,1,1,0,Chicago Bears,26
2006-10-15,Washington Redskins,Tennessee Titans,22,25,2006,6,domingo,Regular Season,2-4,2,4,0,21,20,1,1-5,1,5,0,26,30,-4,Tennessee Titans,10
2006-10-15,Tampa Bay Buccaneers,Cincinnati Bengals,14,13,2006,6,domingo,Regular Season,1-4,1,4,0,22,28,-6,3-2,3,2,0,12,9,3,Tampa Bay Buccaneers,19
2006-10-15,Los Angeles Rams,Seattle Seahawks,28,30,2006,6,domingo,Regular Season,4-2,4,2,0,14,14,0,4-1,4,1,0,5,8,-3,Seattle Seahawks,6
2006-10-15,San Francisco 49ers,Los Angeles Chargers,19,48,2006,6,domingo,Regular Season,2-4,2,4,0,24,22,2,4-1,4,1,0,3,5,-2,Los Angeles Chargers,17
2006-10-15,Pittsburgh Steelers,Kansas City Chiefs,45,7,2006,6,domingo,Regular Season,2-3,2,3,0,17,18,-1,2-3,2,3,0,20,19,1,Pittsburgh Steelers,1
2006-10-15,New York Jets,Miami Dolphins,20,17,2006,6,domingo,Regular Season,3-3,3,3,0,19,21,-2,1-5,1,5,0,27,25,2,New York Jets,4
2006-10-15,New Orleans Saints,Philadelphia Eagles,27,24,2006,6,domingo,Regular Season,5-1,5,1,0,7,13,-6,4-2,4,2,0,9,4,5,New Orleans Saints,9
2006-10-15,Detroit Lions,Buffalo Bills,20,17,2006,6,domingo,Regular Season,1-5,1,5,0,25,31,-6,2-4,2,4,0,23,23,0,Detroit Lions,8
2006-10-15,Denver Broncos,Oakland Raiders,13,3,2006,6,domingo,Regular Season,4-1,4,1,0,4,3,1,0-5,0,5,0,32,32,0,Denver Broncos,29
2006-10-15,Dallas Cowboys,Houston Texans,34,6,2006,6,domingo,Regular Season,3-2,3,2,0,15,15,0,1-4,1,4,0,30,24,6,Dallas Cowboys,9
2006-10-15,Baltimore Ravens,Carolina Panthers,21,23,2006,6,domingo,Regular Season,4-2,4,2,0,10,6,4,4-2,4,2,0,8,12,-4,Carolina Panthers,6
2006-10-15,Atlanta Falcons,New York Giants,14,27,2006,6,domingo,Regular Season,3-2,3,2,0,16,10,6,3-2,3,2,0,11,16,-5,New York Giants,6
2006-10-09,Denver Broncos,Baltimore Ravens,13,3,2006,5,segunda,Regular Season,3-1,3,1,0,3,8,-5,4-1,4,1,0,6,3,3,Denver Broncos,5
2006-10-08,San Francisco 49ers,Oakland Raiders,34,20,2006,5,domingo,Regular Season,2-3,2,3,0,22,29,-7,0-5,0,5,0,32,32,0,San Francisco 49ers,3
2006-10-08,Los Angeles Chargers,Pittsburgh Steelers,23,13,2006,5,domingo,Regular Season,3-1,3,1,0,5,9,-4,1-3,1,3,0,18,13,5,Los Angeles Chargers,4
2006-10-08,Philadelphia Eagles,Dallas Cowboys,38,24,2006,5,domingo,Regular Season,4-1,4,1,0,4,4,0,2-2,2,2,0,15,11,4,Philadelphia Eagles,7
2006-10-08,New York Giants,Washington Redskins,19,3,2006,5,domingo,Regular Season,2-2,2,2,0,16,18,-2,2-3,2,3,0,20,17,3,New York Giants,1
2006-10-08,New Orleans Saints,Tampa Bay Buccaneers,24,21,2006,5,domingo,Regular Season,4-1,4,1,0,13,15,-2,0-4,0,4,0,28,27,1,New Orleans Saints,12
2006-10-08,New England Patriots,Miami Dolphins,20,10,2006,5,domingo,Regular Season,4-1,4,1,0,7,5,2,1-4,1,4,0,25,23,2,New England Patriots,18
2006-10-08,Minnesota Vikings,Detroit Lions,26,17,2006,5,domingo,Regular Season,3-2,3,2,0,17,20,-3,0-5,0,5,0,31,30,1,Minnesota Vikings,10
2006-10-08,Jacksonville Jaguars,New York Jets,41,0,2006,5,domingo,Regular Season,3-2,3,2,0,11,12,-1,2-3,2,3,0,21,19,2,Jacksonville Jaguars,7
2006-10-08,Indianapolis Colts,Tennessee Titans,14,13,2006,5,domingo,Regular Season,5-0,5,0,0,2,2,0,0-5,0,5,0,30,31,-1,Indianapolis Colts,29
2006-10-08,Green Bay Packers,Los Angeles Rams,20,23,2006,5,domingo,Regular Season,1-4,1,4,0,29,28,1,4-1,4,1,0,14,16,-2,Los Angeles Rams,12
2006-10-08,Chicago Bears,Buffalo Bills,40,7,2006,5,domingo,Regular Season,5-0,5,0,0,1,1,0,2-3,2,3,0,23,21,2,Chicago Bears,20
2006-10-08,Carolina Panthers,Cleveland Browns,20,12,2006,5,domingo,Regular Season,3-2,3,2,0,12,14,-2,1-4,1,4,0,26,24,2,Carolina Panthers,10
2006-10-08,Arizona Cardinals,Kansas City Chiefs,20,23,2006,5,domingo,Regular Season,1-4,1,4,0,27,26,1,2-2,2,2,0,19,22,-3,Kansas City Chiefs,4
2006-10-02,Philadelphia Eagles,Green Bay Packers,31,9,2006,4,segunda,Regular Season,3-1,3,1,0,4,10,-6,1-3,1,3,0,28,26,2,Philadelphia Eagles,16
2006-10-01,Washington Redskins,Jacksonville Jaguars,36,30,2006,4,domingo,Regular Season,2-2,2,2,0,17,20,-3,2-2,2,2,0,12,7,5,Washington Redskins,13
2006-10-01,Tennessee Titans,Dallas Cowboys,14,45,2006,4,domingo,Regular Season,0-4,0,4,0,31,30,1,2-1,2,1,0,11,13,-2,Dallas Cowboys,17
2006-10-01,Los Angeles Rams,Detroit Lions,41,34,2006,4,domingo,Regular Season,3-1,3,1,0,16,17,-1,0-4,0,4,0,30,29,1,Los Angeles Rams,12
2006-10-01,Oakland Raiders,Cleveland Browns,21,24,2006,4,domingo,Regular Season,0-3,0,3,0,32,32,0,1-3,1,3,0,24,28,-4,Cleveland Browns,4
2006-10-01,New York Jets,Indianapolis Colts,28,31,2006,4,domingo,Regular Season,2-2,2,2,0,19,19,0,4-0,4,0,0,2,1,1,Indianapolis Colts,18
2006-10-01,Kansas City Chiefs,San Francisco 49ers,41,0,2006,4,domingo,Regular Season,1-2,1,2,0,22,24,-2,1-3,1,3,0,29,25,4,Kansas City Chiefs,1
2006-10-01,Houston Texans,Miami Dolphins,17,15,2006,4,domingo,Regular Season,1-3,1,3,0,25,31,-6,1-3,1,3,0,23,21,2,Houston Texans,10
2006-10-01,Cincinnati Bengals,New England Patriots,13,38,2006,4,domingo,Regular Season,3-1,3,1,0,7,2,5,3-1,3,1,0,5,11,-6,New England Patriots,9
2006-10-01,Chicago Bears,Seattle Seahawks,37,6,2006,4,domingo,Regular Season,4-0,4,0,0,1,4,-3,3-1,3,1,0,6,3,3,Chicago Bears,1
2006-10-01,Carolina Panthers,New Orleans Saints,21,18,2006,4,domingo,Regular Season,2-2,2,2,0,14,18,-4,3-1,3,1,0,15,14,1,Carolina Panthers,4
2006-10-01,Buffalo Bills,Minnesota Vikings,17,12,2006,4,domingo,Regular Season,2-2,2,2,0,21,23,-2,2-2,2,2,0,20,15,5,Buffalo Bills,8
2006-10-01,Baltimore Ravens,Los Angeles Chargers,16,13,2006,4,domingo,Regular Season,4-0,4,0,0,3,6,-3,2-1,2,1,0,9,5,4,Baltimore Ravens,1
2006-10-01,Atlanta Falcons,Arizona Cardinals,32,10,2006,4,domingo,Regular Season,3-1,3,1,0,10,9,1,1-3,1,3,0,26,22,4,Atlanta Falcons,13
2006-09-25,New Orleans Saints,Atlanta Falcons,23,3,2006,3,segunda,Regular Season,3-0,3,0,0,14,17,-3,2-1,2,1,0,9,5,4,New Orleans Saints,12
2006-09-24,Tampa Bay Buccaneers,Carolina Panthers,24,26,2006,3,domingo,Regular Season,0-3,0,3,0,27,23,4,1-2,1,2,0,18,16,2,Carolina Panthers,7
2006-09-24,Seattle Seahawks,New York Giants,42,30,2006,3,domingo,Regular Season,3-0,3,0,0,3,2,1,1-2,1,2,0,16,11,5,Seattle Seahawks,9
2006-09-24,San Francisco 49ers,Philadelphia Eagles,24,38,2006,3,domingo,Regular Season,1-2,1,2,0,25,25,0,2-1,2,1,0,10,15,-5,Philadelphia Eagles,10
2006-09-24,Pittsburgh Steelers,Cincinnati Bengals,20,28,2006,3,domingo,Regular Season,1-2,1,2,0,12,9,3,3-0,3,0,0,2,3,-1,Cincinnati Bengals,6
2006-09-24,New England Patriots,Denver Broncos,7,17,2006,3,domingo,Regular Season,2-1,2,1,0,11,10,1,2-1,2,1,0,8,12,-4,Denver Broncos,2
2006-09-24,Minnesota Vikings,Chicago Bears,16,19,2006,3,domingo,Regular Season,2-1,2,1,0,15,14,1,3-0,3,0,0,4,6,-2,Chicago Bears,8
2006-09-24,Miami Dolphins,Tennessee Titans,13,10,2006,3,domingo,Regular Season,1-2,1,2,0,21,21,0,0-3,0,3,0,30,31,-1,Miami Dolphins,10
2006-09-24,Indianapolis Colts,Jacksonville Jaguars,21,14,2006,3,domingo,Regular Season,3-0,3,0,0,1,1,0,2-1,2,1,0,7,4,3,Indianapolis Colts,3
2006-09-24,Houston Texans,Washington Redskins,15,31,2006,3,domingo,Regular Season,0-3,0,3,0,31,29,2,1-2,1,2,0,20,24,-4,Washington Redskins,5
2006-09-24,Detroit Lions,Green Bay Packers,24,31,2006,3,domingo,Regular Season,0-3,0,3,0,29,27,2,1-2,1,2,0,26,30,-4,Green Bay Packers,3
2006-09-24,Cleveland Browns,Baltimore Ravens,14,15,2006,3,domingo,Regular Season,0-3,0,3,0,28,28,0,3-0,3,0,0,6,8,-2,Baltimore Ravens,20
2006-09-24,Buffalo Bills,New York Jets,20,28,2006,3,domingo,Regular Season,1-2,1,2,0,23,20,3,2-1,2,1,0,19,22,-3,New York Jets,2
2006-09-24,Arizona Cardinals,Los Angeles Rams,14,16,2006,3,domingo,Regular Season,1-2,1,2,0,22,19,3,2-1,2,1,0,17,18,-1,Los Angeles Rams,1
2006-09-18,Jacksonville Jaguars,Pittsburgh Steelers,9,0,2006,2,segunda,Regular Season,2-0,2,0,0,4,5,-1,1-1,1,1,0,9,1,8,Jacksonville Jaguars,4
2006-09-17,Seattle Seahawks,Arizona Cardinals,21,10,2006,2,domingo,Regular Season,2-0,2,0,0,2,3,-1,1-1,1,1,0,19,19,0,Seattle Seahawks,16
2006-09-17,San Francisco 49ers,Los Angeles Rams,20,13,2006,2,domingo,Regular Season,1-1,1,1,0,25,30,-5,1-1,1,1,0,18,18,0,San Francisco 49ers,12
2006-09-17,Los Angeles Chargers,Tennessee Titans,40,7,2006,2,domingo,Regular Season,2-0,2,0,0,7,9,-2,0-2,0,2,0,31,29,2,Los Angeles Chargers,20
2006-09-17,Philadelphia Eagles,New York Giants,24,30,2006,2,domingo,Regular Season,1-1,1,1,0,15,11,4,1-1,1,1,0,11,14,-3,New York Giants,3
2006-09-17,New York Jets,New England Patriots,17,24,2006,2,domingo,Regular Season,1-1,1,1,0,22,23,-1,2-0,2,0,0,10,10,0,New England Patriots,13
2006-09-17,Minnesota Vikings,Carolina Panthers,16,13,2006,2,domingo,Regular Season,2-0,2,0,0,14,17,-3,0-2,0,2,0,16,12,4,Minnesota Vikings,5
2006-09-17,Miami Dolphins,Buffalo Bills,6,16,2006,2,domingo,Regular Season,0-2,0,2,0,21,16,5,1-1,1,1,0,20,26,-6,Buffalo Bills,10
2006-09-17,Indianapolis Colts,Houston Texans,43,24,2006,2,domingo,Regular Season,2-0,2,0,0,1,2,-1,0-2,0,2,0,29,27,2,Indianapolis Colts,25
2006-09-17,Green Bay Packers,New Orleans Saints,27,34,2006,2,domingo,Regular Season,0-2,0,2,0,30,32,-2,2-0,2,0,0,17,24,-7,New Orleans Saints,8
2006-09-17,Denver Broncos,Kansas City Chiefs,9,6,2006,2,domingo,Regular Season,1-1,1,1,0,12,13,-1,0-2,0,2,0,26,22,4,Denver Broncos,9
2006-09-17,Dallas Cowboys,Washington Redskins,27,10,2006,2,domingo,Regular Season,1-1,1,1,0,13,15,-2,0-2,0,2,0,24,20,4,Dallas Cowboys,5
2006-09-17,Cincinnati Bengals,Cleveland Browns,34,17,2006,2,domingo,Regular Season,2-0,2,0,0,3,4,-1,0-2,0,2,0,28,28,0,Cincinnati Bengals,24
2006-09-17,Chicago Bears,Detroit Lions,34,7,2006,2,domingo,Regular Season,2-0,2,0,0,6,8,-2,0-2,0,2,0,27,25,2,Chicago Bears,17
2006-09-17,Baltimore Ravens,Oakland Raiders,28,6,2006,2,domingo,Regular Season,2-0,2,0,0,8,6,2,0-2,0,2,0,32,31,1,Baltimore Ravens,25
2006-09-17,Atlanta Falcons,Tampa Bay Buccaneers,14,3,2006,2,domingo,Regular Season,2-0,2,0,0,5,7,-2,0-2,0,2,0,23,21,2,Atlanta Falcons,14
2006-09-11,Washington Redskins,Minnesota Vikings,16,19,2006,1,segunda,Regular Season,0-1,0,1,0,20,14,6,1-0,1,0,0,17,19,-2,Minnesota Vikings,5
2006-09-11,Oakland Raiders,Los Angeles Chargers,0,27,2006,1,segunda,Regular Season,0-1,0,1,0,31,25,6,1-0,1,0,0,9,16,-7,Los Angeles Chargers,9
2006-09-10,Tennessee Titans,New York Jets,16,23,2006,1,domingo,Regular Season,0-1,0,1,0,29,26,3,1-0,1,0,0,23,31,-8,New York Jets,5
2006-09-10,Tampa Bay Buccaneers,Baltimore Ravens,0,27,2006,1,domingo,Regular Season,0-1,0,1,0,21,12,9,1-0,1,0,0,6,18,-12,Baltimore Ravens,6
2006-09-10,Los Angeles Rams,Denver Broncos,18,10,2006,1,domingo,Regular Season,1-0,1,0,0,18,22,-4,0-1,0,1,0,13,5,8,Los Angeles Rams,17
2006-09-10,New York Giants,Indianapolis Colts,21,26,2006,1,domingo,Regular Season,0-1,0,1,0,14,10,4,1-0,1,0,0,2,4,-2,Indianapolis Colts,6
2006-09-10,New England Patriots,Buffalo Bills,19,17,2006,1,domingo,Regular Season,1-0,1,0,0,10,7,3,0-1,0,1,0,26,30,-4,New England Patriots,23
2006-09-10,Kansas City Chiefs,Cincinnati Bengals,10,23,2006,1,domingo,Regular Season,0-1,0,1,0,22,20,2,1-0,1,0,0,4,6,-2,Cincinnati Bengals,14
2006-09-10,Jacksonville Jaguars,Dallas Cowboys,24,17,2006,1,domingo,Regular Season,1-0,1,0,0,5,11,-6,0-1,0,1,0,15,8,7,Jacksonville Jaguars,3
2006-09-10,Houston Texans,Philadelphia Eagles,10,24,2006,1,domingo,Regular Season,0-1,0,1,0,27,24,3,1-0,1,0,0,11,15,-4,Philadelphia Eagles,9
2006-09-10,Green Bay Packers,Chicago Bears,0,26,2006,1,domingo,Regular Season,0-1,0,1,0,32,28,4,1-0,1,0,0,8,13,-5,Chicago Bears,15
2006-09-10,Detroit Lions,Seattle Seahawks,6,9,2006,1,domingo,Regular Season,0-1,0,1,0,25,23,2,1-0,1,0,0,3,1,2,Seattle Seahawks,22
2006-09-10,Cleveland Browns,New Orleans Saints,14,19,2006,1,domingo,Regular Season,0-1,0,1,0,28,27,1,1-0,1,0,0,24,29,-5,New Orleans Saints,2
2006-09-10,Carolina Panthers,Atlanta Falcons,6,20,2006,1,domingo,Regular Season,0-1,0,1,0,12,2,10,1-0,1,0,0,7,17,-10,Atlanta Falcons,15
2006-09-10,Arizona Cardinals,San Francisco 49ers,34,27,2006,1,domingo,Regular Season,1-0,1,0,0,19,21,-2,0-1,0,1,0,30,32,-2,Arizona Cardinals,11
2006-09-07,Pittsburgh Steelers,Miami Dolphins,28,17,2006,1,quinta,Regular Season,1-0,1,0,0,1,3,-2,0-1,0,1,0,16,9,7,Pittsburgh Steelers,6
2016-01-03,Seattle Seahawks,Arizona Cardinals,36,6,2015,17,domingo,Regular Season,10-6,10,6,0,3,10,-7,13-3,13,3,0,4,1,3,Seattle Seahawks,9
2016-01-03,Los Angeles Chargers,Denver Broncos,20,27,2015,17,domingo,Regular Season,4-12,4,12,0,28,28,0,12-4,12,4,0,2,4,-2,Denver Broncos,24
2016-01-03,Los Angeles Rams,San Francisco 49ers,16,19,2015,17,domingo,Regular Season,7-9,7,9,0,22,17,5,5-11,5,11,0,29,31,-2,San Francisco 49ers,14
2016-01-03,New Orleans Saints,Atlanta Falcons,20,17,2015,17,domingo,Regular Season,7-9,7,9,0,19,20,-1,8-8,8,8,0,15,15,0,New Orleans Saints,5
2016-01-03,New York Jets,Buffalo Bills,17,22,2015,17,domingo,Regular Season,10-6,10,6,0,12,5,7,8-8,8,8,0,14,16,-2,Buffalo Bills,11
2016-01-03,Tampa Bay Buccaneers,Carolina Panthers,10,38,2015,17,domingo,Regular Season,6-10,6,10,0,24,22,2,15-1,15,1,0,1,2,-1,Carolina Panthers,20
2016-01-03,Detroit Lions,Chicago Bears,24,20,2015,17,domingo,Regular Season,7-9,7,9,0,20,23,-3,6-10,6,10,0,25,25,0,Detroit Lions,2
2016-01-03,Baltimore Ravens,Cincinnati Bengals,16,24,2015,17,domingo,Regular Season,5-11,5,11,0,26,24,2,12-4,12,4,0,6,6,0,Cincinnati Bengals,18
2016-01-03,Pittsburgh Steelers,Cleveland Browns,28,12,2015,17,domingo,Regular Season,10-6,10,6,0,7,9,-2,3-13,3,13,0,32,30,2,Pittsburgh Steelers,21
2016-01-03,Washington Redskins,Dallas Cowboys,34,23,2015,17,domingo,Regular Season,9-7,9,7,0,11,12,-1,4-12,4,12,0,30,29,1,Washington Redskins,17
2016-01-03,Minnesota Vikings,Green Bay Packers,20,13,2015,17,domingo,Regular Season,11-5,11,5,0,9,11,-2,10-6,10,6,0,10,8,2,Minnesota Vikings,3
2016-01-03,Jacksonville Jaguars,Houston Texans,6,30,2015,17,domingo,Regular Season,5-11,5,11,0,27,26,1,9-7,9,7,0,13,14,-1,Houston Texans,12
2016-01-03,Tennessee Titans,Indianapolis Colts,24,30,2015,17,domingo,Regular Season,3-13,3,13,0,31,32,-1,8-8,8,8,0,17,18,-1,Indianapolis Colts,14
2016-01-03,Oakland Raiders,Kansas City Chiefs,17,23,2015,17,domingo,Regular Season,7-9,7,9,0,16,13,3,11-5,11,5,0,8,7,1,Kansas City Chiefs,6
2016-01-03,New England Patriots,Miami Dolphins,10,20,2015,17,domingo,Regular Season,12-4,12,4,0,5,3,2,6-10,6,10,0,21,27,-6,Miami Dolphins,24
2016-01-03,Philadelphia Eagles,New York Giants,35,30,2015,17,domingo,Regular Season,7-9,7,9,0,18,19,-1,6-10,6,10,0,23,21,2,Philadelphia Eagles,2
2015-12-28,Cincinnati Bengals,Denver Broncos,17,20,2015,16,segunda,Regular Season,11-4,11,4,0,6,5,1,11-4,11,4,0,4,8,-4,Denver Broncos,3
2015-12-27,Green Bay Packers,Arizona Cardinals,8,38,2015,16,domingo,Regular Season,10-5,10,5,0,8,6,2,13-2,13,2,0,1,2,-1,Arizona Cardinals,4
2015-12-27,Los Angeles Rams,Seattle Seahawks,23,17,2015,16,domingo,Regular Season,7-8,7,8,0,17,22,-5,9-6,9,6,0,10,7,3,Los Angeles Rams,15
2015-12-27,Jacksonville Jaguars,New Orleans Saints,27,38,2015,16,domingo,Regular Season,5-10,5,10,0,26,20,6,6-9,6,9,0,20,23,-3,New Orleans Saints,3
2015-12-27,Carolina Panthers,Atlanta Falcons,13,20,2015,16,domingo,Regular Season,14-1,14,1,0,2,1,1,8-7,8,7,0,15,16,-1,Atlanta Falcons,15
2015-12-27,Pittsburgh Steelers,Baltimore Ravens,17,20,2015,16,domingo,Regular Season,9-6,9,6,0,9,4,5,5-10,5,10,0,24,28,-4,Baltimore Ravens,24
2015-12-27,Dallas Cowboys,Buffalo Bills,6,16,2015,16,domingo,Regular Season,4-11,4,11,0,29,29,0,7-8,7,8,0,16,18,-2,Buffalo Bills,11
2015-12-27,San Francisco 49ers,Detroit Lions,17,32,2015,16,domingo,Regular Season,4-11,4,11,0,31,30,1,6-9,6,9,0,23,26,-3,Detroit Lions,4
2015-12-27,Cleveland Browns,Kansas City Chiefs,13,17,2015,16,domingo,Regular Season,3-12,3,12,0,30,32,-2,10-5,10,5,0,7,9,-2,Kansas City Chiefs,23
2015-12-27,Indianapolis Colts,Miami Dolphins,18,12,2015,16,domingo,Regular Season,7-8,7,8,0,18,21,-3,5-10,5,10,0,27,25,2,Indianapolis Colts,4
2015-12-27,New York Giants,Minnesota Vikings,17,49,2015,16,domingo,Regular Season,6-9,6,9,0,21,15,6,10-5,10,5,0,11,11,0,Minnesota Vikings,4
2015-12-27,New England Patriots,New York Jets,20,26,2015,16,domingo,Regular Season,12-3,12,3,0,3,3,0,10-5,10,5,0,5,10,-5,New York Jets,7
2015-12-27,Chicago Bears,Tampa Bay Buccaneers,26,21,2015,16,domingo,Regular Season,6-9,6,9,0,25,24,1,6-9,6,9,0,22,17,5,Chicago Bears,7
2015-12-27,Houston Texans,Tennessee Titans,34,6,2015,16,domingo,Regular Season,8-7,8,7,0,14,13,1,3-12,3,12,0,32,31,1,Houston Texans,18
2015-12-26,Washington Redskins,Philadelphia Eagles,38,24,2015,16,sábado,Regular Season,8-7,8,7,0,12,12,0,6-9,6,9,0,19,19,0,Washington Redskins,7
2015-12-24,Los Angeles Chargers,Oakland Raiders,20,23,2015,16,quinta,Regular Season,4-11,4,11,0,28,27,1,7-8,7,8,0,13,14,-1,Oakland Raiders,13
2015-12-21,Detroit Lions,New Orleans Saints,35,27,2015,15,segunda,Regular Season,5-9,5,9,0,26,25,1,5-9,5,9,0,23,22,1,Detroit Lions,3
2015-12-20,Arizona Cardinals,Philadelphia Eagles,40,17,2015,15,domingo,Regular Season,12-2,12,2,0,2,2,0,6-8,6,8,0,19,12,7,Arizona Cardinals,10
2015-12-20,Denver Broncos,Pittsburgh Steelers,27,34,2015,15,domingo,Regular Season,10-4,10,4,0,8,5,3,9-5,9,5,0,4,6,-2,Pittsburgh Steelers,1
2015-12-20,Miami Dolphins,Los Angeles Chargers,14,30,2015,15,domingo,Regular Season,5-9,5,9,0,25,23,2,4-10,4,10,0,27,28,-1,Los Angeles Chargers,5
2015-12-20,Cincinnati Bengals,San Francisco 49ers,24,14,2015,15,domingo,Regular Season,11-3,11,3,0,5,4,1,4-10,4,10,0,30,31,-1,Cincinnati Bengals,27
2015-12-20,Green Bay Packers,Oakland Raiders,30,20,2015,15,domingo,Regular Season,10-4,10,4,0,6,7,-1,6-8,6,8,0,14,14,0,Green Bay Packers,7
2015-12-20,Cleveland Browns,Seattle Seahawks,13,30,2015,15,domingo,Regular Season,3-11,3,11,0,32,32,0,9-5,9,5,0,7,8,-1,Seattle Seahawks,24
2015-12-20,Kansas City Chiefs,Baltimore Ravens,34,14,2015,15,domingo,Regular Season,9-5,9,5,0,9,9,0,4-10,4,10,0,28,29,-1,Kansas City Chiefs,20
2015-12-20,Houston Texans,Indianapolis Colts,16,10,2015,15,domingo,Regular Season,7-7,7,7,0,13,13,0,6-8,6,8,0,21,20,1,Houston Texans,7
2015-12-20,Atlanta Falcons,Jacksonville Jaguars,23,17,2015,15,domingo,Regular Season,7-7,7,7,0,16,27,-11,5-9,5,9,0,20,21,-1,Atlanta Falcons,6
2015-12-20,Chicago Bears,Minnesota Vikings,17,38,2015,15,domingo,Regular Season,5-9,5,9,0,24,19,5,9-5,9,5,0,11,11,0,Minnesota Vikings,8
2015-12-20,Tennessee Titans,New England Patriots,16,33,2015,15,domingo,Regular Season,3-11,3,11,0,31,30,1,12-2,12,2,0,3,3,0,New England Patriots,27
2015-12-20,Carolina Panthers,New York Giants,38,35,2015,15,domingo,Regular Season,14-0,14,0,0,1,1,0,6-8,6,8,0,15,17,-2,Carolina Panthers,16
2015-12-20,Buffalo Bills,Washington Redskins,25,35,2015,15,domingo,Regular Season,6-8,6,8,0,18,16,2,7-7,7,7,0,12,15,-3,Washington Redskins,1
2015-12-19,New York Jets,Dallas Cowboys,19,16,2015,15,sábado,Regular Season,9-5,9,5,0,10,10,0,4-10,4,10,0,29,24,5,New York Jets,14
2015-12-17,Tampa Bay Buccaneers,Los Angeles Rams,23,31,2015,15,quinta,Regular Season,6-8,6,8,0,17,18,-1,6-8,6,8,0,22,26,-4,Los Angeles Rams,8
2015-12-14,New York Giants,Miami Dolphins,31,24,2015,14,segunda,Regular Season,6-7,6,7,0,17,20,-3,5-8,5,8,0,23,24,-1,New York Giants,4
2015-12-13,Seattle Seahawks,Baltimore Ravens,35,6,2015,14,domingo,Regular Season,8-5,8,5,0,8,6,2,4-9,4,9,0,29,30,-1,Seattle Seahawks,24
2015-12-13,Dallas Cowboys,Green Bay Packers,7,28,2015,14,domingo,Regular Season,4-9,4,9,0,24,23,1,9-4,9,4,0,7,7,0,Green Bay Packers,16
2015-12-13,Oakland Raiders,Denver Broncos,15,12,2015,14,domingo,Regular Season,6-7,6,7,0,14,17,-3,10-3,10,3,0,5,4,1,Oakland Raiders,13
2015-12-13,Atlanta Falcons,Carolina Panthers,0,38,2015,14,domingo,Regular Season,6-7,6,7,0,27,15,12,13-0,13,0,0,1,1,0,Carolina Panthers,14
2015-12-13,Washington Redskins,Chicago Bears,24,21,2015,14,domingo,Regular Season,6-7,6,7,0,15,18,-3,5-8,5,8,0,19,21,-2,Washington Redskins,3
2015-12-13,Pittsburgh Steelers,Cincinnati Bengals,33,20,2015,14,domingo,Regular Season,8-5,8,5,0,6,8,-2,10-3,10,3,0,4,3,1,Pittsburgh Steelers,5
2015-12-13,San Francisco 49ers,Cleveland Browns,10,24,2015,14,domingo,Regular Season,4-9,4,9,0,31,26,5,3-10,3,10,0,32,32,0,Cleveland Browns,6
2015-12-13,New England Patriots,Houston Texans,27,6,2015,14,domingo,Regular Season,11-2,11,2,0,3,5,-2,6-7,6,7,0,13,13,0,New England Patriots,8
2015-12-13,Indianapolis Colts,Jacksonville Jaguars,16,51,2015,14,domingo,Regular Season,6-7,6,7,0,20,16,4,5-8,5,8,0,21,29,-8,Jacksonville Jaguars,13
2015-12-13,Los Angeles Chargers,Kansas City Chiefs,3,10,2015,14,domingo,Regular Season,3-10,3,10,0,28,31,-3,8-5,8,5,0,9,9,0,Kansas City Chiefs,22
2015-12-13,Tennessee Titans,New York Jets,8,30,2015,14,domingo,Regular Season,3-10,3,10,0,30,27,3,8-5,8,5,0,10,10,0,New York Jets,17
2015-12-13,Buffalo Bills,Philadelphia Eagles,20,23,2015,14,domingo,Regular Season,6-7,6,7,0,16,12,4,6-7,6,7,0,12,19,-7,Philadelphia Eagles,7
2015-12-13,Detroit Lions,Los Angeles Rams,14,21,2015,14,domingo,Regular Season,4-9,4,9,0,25,22,3,5-8,5,8,0,26,28,-2,Los Angeles Rams,6
2015-12-13,New Orleans Saints,Tampa Bay Buccaneers,24,17,2015,14,domingo,Regular Season,5-8,5,8,0,22,25,-3,6-7,6,7,0,18,14,4,New Orleans Saints,11
2015-12-10,Minnesota Vikings,Arizona Cardinals,20,23,2015,14,quinta,Regular Season,8-5,8,5,0,11,11,0,11-2,11,2,0,2,2,0,Arizona Cardinals,9
2015-12-07,Dallas Cowboys,Washington Redskins,19,16,2015,13,segunda,Regular Season,4-8,4,8,0,23,29,-6,5-7,5,7,0,18,13,5,Dallas Cowboys,16
2015-12-06,Indianapolis Colts,Pittsburgh Steelers,10,45,2015,13,domingo,Regular Season,6-6,6,6,0,16,14,2,7-5,7,5,0,8,9,-1,Pittsburgh Steelers,5
2015-12-06,Philadelphia Eagles,New England Patriots,35,28,2015,13,domingo,Regular Season,5-7,5,7,0,19,24,-5,10-2,10,2,0,5,2,3,Philadelphia Eagles,22
2015-12-06,Carolina Panthers,New Orleans Saints,41,38,2015,13,domingo,Regular Season,12-0,12,0,0,1,1,0,4-8,4,8,0,25,22,3,Carolina Panthers,21
2015-12-06,Kansas City Chiefs,Oakland Raiders,34,20,2015,13,domingo,Regular Season,7-5,7,5,0,9,10,-1,5-7,5,7,0,17,16,1,Kansas City Chiefs,6
2015-12-06,Denver Broncos,Los Angeles Chargers,17,3,2015,13,domingo,Regular Season,10-2,10,2,0,4,3,1,3-9,3,9,0,31,27,4,Denver Broncos,24
2015-12-06,Houston Texans,Buffalo Bills,21,30,2015,13,domingo,Regular Season,6-6,6,6,0,13,11,2,6-6,6,6,0,12,19,-7,Buffalo Bills,8
2015-12-06,San Francisco 49ers,Chicago Bears,26,20,2015,13,domingo,Regular Season,4-8,4,8,0,26,31,-5,5-7,5,7,0,21,20,1,San Francisco 49ers,11
2015-12-06,Cincinnati Bengals,Cleveland Browns,37,3,2015,13,domingo,Regular Season,10-2,10,2,0,3,5,-2,2-10,2,10,0,32,32,0,Cincinnati Bengals,27
2015-12-06,Baltimore Ravens,Miami Dolphins,13,15,2015,13,domingo,Regular Season,4-8,4,8,0,30,25,5,5-7,5,7,0,24,23,1,Miami Dolphins,2
2015-12-06,Seattle Seahawks,Minnesota Vikings,38,7,2015,13,domingo,Regular Season,7-5,7,5,0,6,7,-1,8-4,8,4,0,11,6,5,Seattle Seahawks,1
2015-12-06,New York Jets,New York Giants,23,20,2015,13,domingo,Regular Season,7-5,7,5,0,10,12,-2,5-7,5,7,0,20,18,2,New York Jets,6
2015-12-06,Arizona Cardinals,Los Angeles Rams,27,3,2015,13,domingo,Regular Season,10-2,10,2,0,2,4,-2,4-8,4,8,0,28,26,2,Arizona Cardinals,22
2015-12-06,Atlanta Falcons,Tampa Bay Buccaneers,19,23,2015,13,domingo,Regular Season,6-6,6,6,0,15,15,0,6-6,6,6,0,14,17,-3,Tampa Bay Buccaneers,2
2015-12-06,Jacksonville Jaguars,Tennessee Titans,39,42,2015,13,domingo,Regular Season,4-8,4,8,0,29,28,1,3-9,3,9,0,27,30,-3,Tennessee Titans,2
2015-12-03,Green Bay Packers,Detroit Lions,27,23,2015,13,quinta,Regular Season,8-4,8,4,0,7,8,-1,4-8,4,8,0,22,21,1,Green Bay Packers,13
2015-11-30,Baltimore Ravens,Cleveland Browns,33,27,2015,12,segunda,Regular Season,4-7,4,7,0,25,30,-5,2-9,2,9,0,32,32,0,Baltimore Ravens,2
2015-11-29,New England Patriots,Denver Broncos,24,30,2015,12,domingo,Regular Season,10-1,10,1,0,2,1,1,9-2,9,2,0,3,3,0,Denver Broncos,2
2015-11-29,Pittsburgh Steelers,Seattle Seahawks,30,39,2015,12,domingo,Regular Season,6-5,6,5,0,9,9,0,6-5,6,5,0,7,8,-1,Seattle Seahawks,1
2015-11-29,Arizona Cardinals,San Francisco 49ers,19,13,2015,12,domingo,Regular Season,9-2,9,2,0,4,4,0,3-8,3,8,0,31,29,2,Arizona Cardinals,25
2015-11-29,Minnesota Vikings,Atlanta Falcons,20,10,2015,12,domingo,Regular Season,8-3,8,3,0,6,7,-1,6-5,6,5,0,15,11,4,Minnesota Vikings,4
2015-11-29,Los Angeles Rams,Cincinnati Bengals,7,31,2015,12,domingo,Regular Season,4-7,4,7,0,26,22,4,9-2,9,2,0,5,5,0,Cincinnati Bengals,17
2015-11-29,New Orleans Saints,Houston Texans,6,24,2015,12,domingo,Regular Season,4-7,4,7,0,22,26,-4,6-5,6,5,0,11,17,-6,Houston Texans,9
2015-11-29,Tampa Bay Buccaneers,Indianapolis Colts,12,25,2015,12,domingo,Regular Season,5-6,5,6,0,17,12,5,6-5,6,5,0,14,10,4,Indianapolis Colts,2
2015-11-29,Los Angeles Chargers,Jacksonville Jaguars,31,25,2015,12,domingo,Regular Season,3-8,3,8,0,27,28,-1,4-7,4,7,0,28,27,1,Los Angeles Chargers,1
2015-11-29,Buffalo Bills,Kansas City Chiefs,22,30,2015,12,domingo,Regular Season,5-6,5,6,0,19,14,5,6-5,6,5,0,10,13,-3,Kansas City Chiefs,1
2015-11-29,Miami Dolphins,New York Jets,20,38,2015,12,domingo,Regular Season,4-7,4,7,0,23,23,0,6-5,6,5,0,12,16,-4,New York Jets,7
2015-11-29,Oakland Raiders,Tennessee Titans,24,21,2015,12,domingo,Regular Season,5-6,5,6,0,16,18,-2,2-9,2,9,0,30,31,-1,Oakland Raiders,13
2015-11-29,New York Giants,Washington Redskins,14,20,2015,12,domingo,Regular Season,5-6,5,6,0,18,15,3,5-6,5,6,0,13,20,-7,Washington Redskins,5
2015-11-26,Chicago Bears,Green Bay Packers,17,13,2015,12,quinta,Regular Season,5-6,5,6,0,20,19,1,7-4,7,4,0,8,6,2,Chicago Bears,13
2015-11-26,Carolina Panthers,Dallas Cowboys,33,14,2015,12,quinta,Regular Season,11-0,11,0,0,1,2,-1,3-8,3,8,0,29,21,8,Carolina Panthers,19
2015-11-26,Philadelphia Eagles,Detroit Lions,14,45,2015,12,quinta,Regular Season,4-7,4,7,0,24,25,-1,4-7,4,7,0,21,24,-3,Detroit Lions,1
2015-11-23,Buffalo Bills,New England Patriots,13,20,2015,11,segunda,Regular Season,5-5,5,5,0,14,12,2,10-0,10,0,0,1,1,0,New England Patriots,11
2015-11-22,Cincinnati Bengals,Arizona Cardinals,31,34,2015,11,domingo,Regular Season,8-2,8,2,0,5,4,1,8-2,8,2,0,4,3,1,Arizona Cardinals,1
2015-11-22,Green Bay Packers,Minnesota Vikings,30,13,2015,11,domingo,Regular Season,7-3,7,3,0,6,6,0,7-3,7,3,0,7,5,2,Green Bay Packers,1
2015-11-22,San Francisco 49ers,Seattle Seahawks,13,29,2015,11,domingo,Regular Season,3-7,3,7,0,29,31,-2,5-5,5,5,0,8,11,-3,Seattle Seahawks,20
2015-11-22,Kansas City Chiefs,Los Angeles Chargers,33,3,2015,11,domingo,Regular Season,5-5,5,5,0,13,15,-2,2-8,2,8,0,28,28,0,Kansas City Chiefs,13
2015-11-22,Indianapolis Colts,Atlanta Falcons,24,21,2015,11,domingo,Regular Season,5-5,5,5,0,10,17,-7,6-4,6,4,0,11,8,3,Indianapolis Colts,9
2015-11-22,Los Angeles Rams,Baltimore Ravens,13,16,2015,11,domingo,Regular Season,4-6,4,6,0,22,21,1,3-7,3,7,0,30,29,1,Baltimore Ravens,8
2015-11-22,Washington Redskins,Carolina Panthers,16,44,2015,11,domingo,Regular Season,4-6,4,6,0,20,20,0,10-0,10,0,0,2,2,0,Carolina Panthers,18
2015-11-22,Denver Broncos,Chicago Bears,17,15,2015,11,domingo,Regular Season,8-2,8,2,0,3,7,-4,4-6,4,6,0,19,16,3,Denver Broncos,9
2015-11-22,Oakland Raiders,Detroit Lions,13,18,2015,11,domingo,Regular Season,4-6,4,6,0,18,14,4,3-7,3,7,0,24,30,-6,Detroit Lions,16
2015-11-22,New York Jets,Houston Texans,17,24,2015,11,domingo,Regular Season,5-5,5,5,0,16,13,3,5-5,5,5,0,17,22,-5,Houston Texans,9
2015-11-22,Dallas Cowboys,Miami Dolphins,24,14,2015,11,domingo,Regular Season,3-7,3,7,0,21,27,-6,4-6,4,6,0,23,18,5,Dallas Cowboys,9
2015-11-22,Tampa Bay Buccaneers,Philadelphia Eagles,45,17,2015,11,domingo,Regular Season,5-5,5,5,0,12,23,-11,4-6,4,6,0,25,19,6,Tampa Bay Buccaneers,4
2015-11-19,Tennessee Titans,Jacksonville Jaguars,13,19,2015,11,quinta,Regular Season,2-8,2,8,0,31,25,6,4-6,4,6,0,27,26,1,Jacksonville Jaguars,1
2015-11-16,Houston Texans,Cincinnati Bengals,10,6,2015,10,segunda,Regular Season,4-5,4,5,0,22,27,-5,8-1,8,1,0,4,2,2,Houston Texans,25
2015-11-15,Arizona Cardinals,Seattle Seahawks,39,32,2015,10,domingo,Regular Season,7-2,7,2,0,3,6,-3,4-5,4,5,0,11,7,4,Arizona Cardinals,1
2015-11-15,Kansas City Chiefs,Denver Broncos,29,13,2015,10,domingo,Regular Season,4-5,4,5,0,15,19,-4,7-2,7,2,0,7,4,3,Kansas City Chiefs,15
2015-11-15,New England Patriots,New York Giants,27,26,2015,10,domingo,Regular Season,9-0,9,0,0,1,1,0,5-5,5,5,0,10,15,-5,New England Patriots,14
2015-11-15,Minnesota Vikings,Oakland Raiders,30,14,2015,10,domingo,Regular Season,7-2,7,2,0,5,8,-3,4-5,4,5,0,14,13,1,Minnesota Vikings,5
2015-11-15,Jacksonville Jaguars,Baltimore Ravens,22,20,2015,10,domingo,Regular Season,3-6,3,6,0,26,31,-5,2-7,2,7,0,29,24,5,Jacksonville Jaguars,7
2015-11-15,Detroit Lions,Green Bay Packers,18,16,2015,10,domingo,Regular Season,2-7,2,7,0,30,32,-2,6-3,6,3,0,6,5,1,Detroit Lions,27
2015-11-15,Miami Dolphins,Philadelphia Eagles,20,19,2015,10,domingo,Regular Season,4-5,4,5,0,18,20,-2,4-5,4,5,0,19,16,3,Miami Dolphins,4
2015-11-15,Cleveland Browns,Pittsburgh Steelers,9,30,2015,10,domingo,Regular Season,2-8,2,8,0,32,28,4,6-4,6,4,0,9,9,0,Pittsburgh Steelers,19
2015-11-15,Chicago Bears,Los Angeles Rams,37,13,2015,10,domingo,Regular Season,4-5,4,5,0,16,21,-5,4-5,4,5,0,21,10,11,Chicago Bears,11
2015-11-15,Dallas Cowboys,Tampa Bay Buccaneers,6,10,2015,10,domingo,Regular Season,2-7,2,7,0,27,23,4,4-5,4,5,0,23,25,-2,Tampa Bay Buccaneers,2
2015-11-15,Carolina Panthers,Tennessee Titans,27,10,2015,10,domingo,Regular Season,9-0,9,0,0,2,3,-1,2-7,2,7,0,25,29,-4,Carolina Panthers,26
2015-11-15,New Orleans Saints,Washington Redskins,14,47,2015,10,domingo,Regular Season,4-6,4,6,0,24,18,6,4-5,4,5,0,20,26,-6,Washington Redskins,8
2015-11-12,Buffalo Bills,New York Jets,22,17,2015,10,quinta,Regular Season,5-4,5,4,0,12,17,-5,5-4,5,4,0,13,11,2,Buffalo Bills,6
2015-11-09,Chicago Bears,Los Angeles Chargers,22,19,2015,9,segunda,Regular Season,3-5,3,5,0,21,28,-7,2-7,2,7,0,22,19,3,Chicago Bears,9
2015-11-08,Philadelphia Eagles,Dallas Cowboys,33,27,2015,9,domingo,Regular Season,4-4,4,4,0,16,18,-2,2-6,2,6,0,23,26,-3,Philadelphia Eagles,8
2015-11-08,Denver Broncos,Indianapolis Colts,24,27,2015,9,domingo,Regular Season,7-1,7,1,0,4,2,2,4-5,4,5,0,14,22,-8,Indianapolis Colts,20
2015-11-08,Atlanta Falcons,San Francisco 49ers,16,17,2015,9,domingo,Regular Season,6-3,6,3,0,12,7,5,3-6,3,6,0,30,31,-1,San Francisco 49ers,24
2015-11-08,New York Giants,Tampa Bay Buccaneers,32,18,2015,9,domingo,Regular Season,5-4,5,4,0,15,14,1,3-5,3,5,0,25,21,4,New York Giants,7
2015-11-08,Miami Dolphins,Buffalo Bills,17,33,2015,9,domingo,Regular Season,3-5,3,5,0,20,17,3,4-4,4,4,0,17,16,1,Buffalo Bills,1
2015-11-08,Green Bay Packers,Carolina Panthers,29,37,2015,9,domingo,Regular Season,6-2,6,2,0,5,4,1,8-0,8,0,0,3,5,-2,Carolina Panthers,1
2015-11-08,Los Angeles Rams,Minnesota Vikings,18,21,2015,9,domingo,Regular Season,4-4,4,4,0,10,10,0,6-2,6,2,0,8,11,-3,Minnesota Vikings,1
2015-11-08,Washington Redskins,New England Patriots,10,27,2015,9,domingo,Regular Season,3-5,3,5,0,26,24,2,8-0,8,0,0,1,1,0,New England Patriots,23
2015-11-08,Tennessee Titans,New Orleans Saints,34,28,2015,9,domingo,Regular Season,2-6,2,6,0,29,32,-3,4-5,4,5,0,18,15,3,Tennessee Titans,17
2015-11-08,Jacksonville Jaguars,New York Jets,23,28,2015,9,domingo,Regular Season,2-6,2,6,0,31,29,2,5-3,5,3,0,11,12,-1,New York Jets,17
2015-11-08,Oakland Raiders,Pittsburgh Steelers,35,38,2015,9,domingo,Regular Season,4-4,4,4,0,13,9,4,5-4,5,4,0,9,13,-4,Pittsburgh Steelers,4
2015-11-05,Cleveland Browns,Cincinnati Bengals,10,31,2015,9,quinta,Regular Season,2-7,2,7,0,28,23,5,8-0,8,0,0,2,3,-1,Cincinnati Bengals,20
2015-11-02,Indianapolis Colts,Carolina Panthers,26,29,2015,8,segunda,Regular Season,3-5,3,5,0,22,18,4,7-0,7,0,0,5,5,0,Carolina Panthers,13
2015-11-01,Green Bay Packers,Denver Broncos,10,29,2015,8,domingo,Regular Season,6-1,6,1,0,4,2,2,7-0,7,0,0,2,4,-2,Denver Broncos,2
2015-11-01,Seattle Seahawks,Dallas Cowboys,13,12,2015,8,domingo,Regular Season,4-4,4,4,0,8,9,-1,2-5,2,5,0,26,20,6,Seattle Seahawks,11
2015-11-01,New York Jets,Oakland Raiders,20,34,2015,8,domingo,Regular Season,4-3,4,3,0,12,8,4,4-3,4,3,0,9,16,-7,Oakland Raiders,8
2015-11-01,Tampa Bay Buccaneers,Atlanta Falcons,23,20,2015,8,domingo,Regular Season,3-4,3,4,0,21,28,-7,6-2,6,2,0,7,7,0,Tampa Bay Buccaneers,21
2015-11-01,Los Angeles Chargers,Baltimore Ravens,26,29,2015,8,domingo,Regular Season,2-6,2,6,0,19,21,-2,2-6,2,6,0,27,26,1,Baltimore Ravens,5
2015-11-01,Minnesota Vikings,Chicago Bears,23,20,2015,8,domingo,Regular Season,5-2,5,2,0,11,11,0,2-5,2,5,0,28,25,3,Minnesota Vikings,14
2015-11-01,Arizona Cardinals,Cleveland Browns,34,20,2015,8,domingo,Regular Season,6-2,6,2,0,6,6,0,2-6,2,6,0,23,24,-1,Arizona Cardinals,18
2015-11-01,Tennessee Titans,Houston Texans,6,20,2015,8,domingo,Regular Season,1-6,1,6,0,32,30,2,3-5,3,5,0,25,29,-4,Houston Texans,1
2015-11-01,New York Giants,New Orleans Saints,49,52,2015,8,domingo,Regular Season,4-4,4,4,0,14,14,0,4-4,4,4,0,15,17,-2,New Orleans Saints,3
2015-11-01,Cincinnati Bengals,Pittsburgh Steelers,16,10,2015,8,domingo,Regular Season,7-0,7,0,0,3,3,0,4-4,4,4,0,13,10,3,Cincinnati Bengals,7
2015-11-01,San Francisco 49ers,Los Angeles Rams,6,27,2015,8,domingo,Regular Season,2-6,2,6,0,31,27,4,4-3,4,3,0,10,12,-2,Los Angeles Rams,15
2015-11-01,Detroit Lions,Kansas City Chiefs,10,45,2015,8,domingo,Regular Season,1-7,1,7,0,30,31,-1,3-5,3,5,0,20,22,-2,Kansas City Chiefs,9
2015-10-29,Miami Dolphins,New England Patriots,7,36,2015,8,quinta,Regular Season,3-4,3,4,0,17,13,4,7-0,7,0,0,1,1,0,New England Patriots,12
2015-10-26,Baltimore Ravens,Arizona Cardinals,18,26,2015,7,segunda,Regular Season,1-6,1,6,0,26,28,-2,5-2,5,2,0,6,4,2,Arizona Cardinals,24
2015-10-25,Philadelphia Eagles,Carolina Panthers,16,27,2015,7,domingo,Regular Season,3-4,3,4,0,15,9,6,6-0,6,0,0,5,6,-1,Carolina Panthers,3
2015-10-25,Dallas Cowboys,New York Giants,20,27,2015,7,domingo,Regular Season,2-4,2,4,0,20,16,4,4-3,4,3,0,14,14,0,New York Giants,2
2015-10-25,Oakland Raiders,Los Angeles Chargers,37,29,2015,7,domingo,Regular Season,3-3,3,3,0,16,23,-7,2-5,2,5,0,21,13,8,Oakland Raiders,10
2015-10-25,Minnesota Vikings,Detroit Lions,28,19,2015,7,domingo,Regular Season,4-2,4,2,0,11,15,-4,1-6,1,6,0,31,24,7,Minnesota Vikings,9
2015-10-25,New Orleans Saints,Indianapolis Colts,27,21,2015,7,domingo,Regular Season,3-4,3,4,0,17,20,-3,3-4,3,4,0,18,11,7,New Orleans Saints,9
2015-10-25,Pittsburgh Steelers,Kansas City Chiefs,13,23,2015,7,domingo,Regular Season,4-3,4,3,0,10,10,0,2-5,2,5,0,22,29,-7,Kansas City Chiefs,19
2015-10-25,Houston Texans,Miami Dolphins,26,44,2015,7,domingo,Regular Season,2-5,2,5,0,29,26,3,3-3,3,3,0,13,21,-8,Miami Dolphins,5
2015-10-25,New York Jets,New England Patriots,23,30,2015,7,domingo,Regular Season,4-2,4,2,0,8,8,0,6-0,6,0,0,1,1,0,New England Patriots,7
2015-10-25,Cleveland Browns,Los Angeles Rams,6,24,2015,7,domingo,Regular Season,2-5,2,5,0,24,27,-3,3-3,3,3,0,12,18,-6,Los Angeles Rams,9
2015-10-25,Atlanta Falcons,Tennessee Titans,10,7,2015,7,domingo,Regular Season,6-1,6,1,0,7,7,0,1-5,1,5,0,30,30,0,Atlanta Falcons,23
2015-10-25,Tampa Bay Buccaneers,Washington Redskins,30,31,2015,7,domingo,Regular Season,2-4,2,4,0,28,31,-3,3-4,3,4,0,23,22,1,Washington Redskins,9
2015-10-25,Buffalo Bills,Jacksonville Jaguars,31,34,2015,7,domingo,Regular Season,3-4,3,4,0,19,17,2,2-5,2,5,0,32,32,0,Jacksonville Jaguars,15
2015-10-22,Seattle Seahawks,San Francisco 49ers,20,3,2015,7,quinta,Regular Season,3-4,3,4,0,9,12,-3,2-5,2,5,0,27,19,8,Seattle Seahawks,7
2015-10-19,New York Giants,Philadelphia Eagles,7,27,2015,6,segunda,Regular Season,3-3,3,3,0,14,12,2,3-3,3,3,0,9,15,-6,Philadelphia Eagles,3
2015-10-18,New England Patriots,Indianapolis Colts,34,27,2015,6,domingo,Regular Season,5-0,5,0,0,1,1,0,3-3,3,3,0,11,13,-2,New England Patriots,12
2015-10-18,Los Angeles Chargers,Green Bay Packers,20,27,2015,6,domingo,Regular Season,2-4,2,4,0,13,14,-1,6-0,6,0,0,2,2,0,Green Bay Packers,12
2015-10-18,Baltimore Ravens,San Francisco 49ers,20,25,2015,6,domingo,Regular Season,1-5,1,5,0,28,23,5,2-4,2,4,0,19,25,-6,San Francisco 49ers,2
2015-10-18,Carolina Panthers,Seattle Seahawks,27,23,2015,6,domingo,Regular Season,5-0,5,0,0,6,7,-1,2-4,2,4,0,12,8,4,Carolina Panthers,1
2015-10-18,Cincinnati Bengals,Buffalo Bills,34,21,2015,6,domingo,Regular Season,6-0,6,0,0,5,5,0,3-3,3,3,0,17,10,7,Cincinnati Bengals,5
2015-10-18,Denver Broncos,Cleveland Browns,26,23,2015,6,domingo,Regular Season,6-0,6,0,0,3,4,-1,2-4,2,4,0,27,20,7,Denver Broncos,16
2015-10-18,Chicago Bears,Detroit Lions,34,37,2015,6,domingo,Regular Season,2-4,2,4,0,25,24,1,1-5,1,5,0,24,31,-7,Detroit Lions,7
2015-10-18,Houston Texans,Jacksonville Jaguars,31,20,2015,6,domingo,Regular Season,2-4,2,4,0,26,30,-4,1-5,1,5,0,32,32,0,Houston Texans,2
2015-10-18,Kansas City Chiefs,Minnesota Vikings,10,16,2015,6,domingo,Regular Season,1-5,1,5,0,29,19,10,3-2,3,2,0,15,16,-1,Minnesota Vikings,3
2015-10-18,Washington Redskins,New York Jets,20,34,2015,6,domingo,Regular Season,2-4,2,4,0,22,21,1,4-1,4,1,0,8,11,-3,New York Jets,10
2015-10-18,Arizona Cardinals,Pittsburgh Steelers,13,25,2015,6,domingo,Regular Season,4-2,4,2,0,4,6,-2,4-2,4,2,0,10,9,1,Pittsburgh Steelers,3
2015-10-18,Miami Dolphins,Tennessee Titans,38,10,2015,6,domingo,Regular Season,2-3,2,3,0,21,29,-8,1-4,1,4,0,30,27,3,Miami Dolphins,2
2015-10-15,Atlanta Falcons,New Orleans Saints,21,31,2015,6,quinta,Regular Season,5-1,5,1,0,7,3,4,2-4,2,4,0,20,26,-6,New Orleans Saints,23
2015-10-12,Pittsburgh Steelers,Los Angeles Chargers,24,20,2015,5,segunda,Regular Season,3-2,3,2,0,9,10,-1,2-3,2,3,0,14,17,-3,Pittsburgh Steelers,7
2015-10-11,San Francisco 49ers,New York Giants,27,30,2015,5,domingo,Regular Season,1-4,1,4,0,25,27,-2,3-2,3,2,0,12,15,-3,New York Giants,12
2015-10-11,New England Patriots,Dallas Cowboys,30,6,2015,5,domingo,Regular Season,4-0,4,0,0,1,1,0,2-3,2,3,0,18,13,5,New England Patriots,12
2015-10-11,Denver Broncos,Oakland Raiders,16,10,2015,5,domingo,Regular Season,5-0,5,0,0,4,3,1,2-3,2,3,0,22,20,2,Denver Broncos,17
2015-10-11,Arizona Cardinals,Detroit Lions,42,17,2015,5,domingo,Regular Season,4-1,4,1,0,6,4,2,0-5,0,5,0,31,26,5,Arizona Cardinals,22
2015-10-11,Washington Redskins,Atlanta Falcons,19,25,2015,5,domingo,Regular Season,2-3,2,3,0,21,24,-3,5-0,5,0,0,3,6,-3,Atlanta Falcons,18
2015-10-11,Cleveland Browns,Baltimore Ravens,33,30,2015,5,domingo,Regular Season,2-3,2,3,0,20,25,-5,1-4,1,4,0,23,19,4,Cleveland Browns,6
2015-10-11,Seattle Seahawks,Cincinnati Bengals,24,27,2015,5,domingo,Regular Season,2-3,2,3,0,8,7,1,5-0,5,0,0,5,5,0,Cincinnati Bengals,2
2015-10-11,Los Angeles Rams,Green Bay Packers,10,24,2015,5,domingo,Regular Season,2-3,2,3,0,17,11,6,5-0,5,0,0,2,2,0,Green Bay Packers,9
2015-10-11,Chicago Bears,Kansas City Chiefs,18,17,2015,5,domingo,Regular Season,2-3,2,3,0,24,29,-5,1-4,1,4,0,19,18,1,Chicago Bears,11
2015-10-11,New Orleans Saints,Philadelphia Eagles,17,39,2015,5,domingo,Regular Season,1-4,1,4,0,26,21,5,2-3,2,3,0,15,22,-7,Philadelphia Eagles,1
2015-10-11,Jacksonville Jaguars,Tampa Bay Buccaneers,31,38,2015,5,domingo,Regular Season,1-4,1,4,0,32,31,1,2-3,2,3,0,28,32,-4,Tampa Bay Buccaneers,1
2015-10-11,Buffalo Bills,Tennessee Titans,14,13,2015,5,domingo,Regular Season,3-2,3,2,0,10,12,-2,1-3,1,3,0,27,23,4,Buffalo Bills,11
2015-10-08,Indianapolis Colts,Houston Texans,27,20,2015,5,quinta,Regular Season,3-2,3,2,0,13,16,-3,1-4,1,4,0,30,28,2,Indianapolis Colts,12
2015-10-05,Detroit Lions,Seattle Seahawks,10,13,2015,4,segunda,Regular Season,0-4,0,4,0,26,25,1,2-2,2,2,0,7,7,0,Seattle Seahawks,18
2015-10-04,Dallas Cowboys,New Orleans Saints,20,26,2015,4,domingo,Regular Season,2-2,2,2,0,13,11,2,1-3,1,3,0,21,31,-10,New Orleans Saints,20
2015-10-04,Los Angeles Rams,Arizona Cardinals,24,22,2015,4,domingo,Regular Season,2-2,2,2,0,11,19,-8,3-1,3,1,0,4,2,2,Los Angeles Rams,17
2015-10-04,Minnesota Vikings,Denver Broncos,20,23,2015,4,domingo,Regular Season,2-2,2,2,0,14,13,1,4-0,4,0,0,3,4,-1,Denver Broncos,9
2015-10-04,Green Bay Packers,San Francisco 49ers,17,3,2015,4,domingo,Regular Season,4-0,4,0,0,2,3,-1,1-3,1,3,0,27,28,-1,Green Bay Packers,25
2015-10-04,Cleveland Browns,Los Angeles Chargers,27,30,2015,4,domingo,Regular Season,1-3,1,3,0,25,26,-1,2-2,2,2,0,17,18,-1,Los Angeles Chargers,8
2015-10-04,Houston Texans,Atlanta Falcons,21,48,2015,4,domingo,Regular Season,1-3,1,3,0,28,21,7,4-0,4,0,0,6,6,0,Atlanta Falcons,15
2015-10-04,New York Giants,Buffalo Bills,24,10,2015,4,domingo,Regular Season,2-2,2,2,0,15,16,-1,2-2,2,2,0,12,10,2,New York Giants,6
2015-10-04,Oakland Raiders,Chicago Bears,20,22,2015,4,domingo,Regular Season,2-2,2,2,0,20,20,0,1-3,1,3,0,29,32,-3,Chicago Bears,12
2015-10-04,Kansas City Chiefs,Cincinnati Bengals,21,36,2015,4,domingo,Regular Season,1-3,1,3,0,18,12,6,4-0,4,0,0,5,5,0,Cincinnati Bengals,7
2015-10-04,Jacksonville Jaguars,Indianapolis Colts,13,16,2015,4,domingo,Regular Season,1-3,1,3,0,31,29,2,2-2,2,2,0,16,14,2,Indianapolis Colts,15
2015-10-04,Carolina Panthers,Tampa Bay Buccaneers,37,23,2015,4,domingo,Regular Season,4-0,4,0,0,8,9,-1,1-3,1,3,0,32,30,2,Carolina Panthers,21
2015-10-04,Philadelphia Eagles,Washington Redskins,20,23,2015,4,domingo,Regular Season,1-3,1,3,0,22,17,5,2-2,2,2,0,24,27,-3,Washington Redskins,10
2015-10-03,New York Jets,Miami Dolphins,27,14,2015,4,sábado,Regular Season,3-1,3,1,0,9,15,-6,1-3,1,3,0,30,23,7,New York Jets,8
2015-10-01,Baltimore Ravens,Pittsburgh Steelers,23,20,2015,4,quinta,Regular Season,1-3,1,3,0,19,22,-3,2-2,2,2,0,10,8,2,Baltimore Ravens,14
2015-09-28,Kansas City Chiefs,Green Bay Packers,28,38,2015,3,segunda,Regular Season,1-2,1,2,0,12,10,2,3-0,3,0,0,3,2,1,Green Bay Packers,8
2015-09-27,Denver Broncos,Detroit Lions,24,12,2015,3,domingo,Regular Season,3-0,3,0,0,4,5,-1,0-3,0,3,0,25,24,1,Denver Broncos,19
2015-09-27,Buffalo Bills,Miami Dolphins,41,14,2015,3,domingo,Regular Season,2-1,2,1,0,10,8,2,1-2,1,2,0,23,15,8,Buffalo Bills,7
2015-09-27,Chicago Bears,Seattle Seahawks,0,26,2015,3,domingo,Regular Season,0-3,0,3,0,32,32,0,1-2,1,2,0,7,7,0,Seattle Seahawks,25
2015-09-27,San Francisco 49ers,Arizona Cardinals,7,47,2015,3,domingo,Regular Season,1-2,1,2,0,28,20,8,3-0,3,0,0,2,3,-1,Arizona Cardinals,17
2015-09-27,Cincinnati Bengals,Baltimore Ravens,28,24,2015,3,domingo,Regular Season,3-0,3,0,0,5,6,-1,0-3,0,3,0,22,17,5,Cincinnati Bengals,11
2015-09-27,New Orleans Saints,Carolina Panthers,22,27,2015,3,domingo,Regular Season,0-3,0,3,0,31,30,1,3-0,3,0,0,9,14,-5,Carolina Panthers,16
2015-09-27,Oakland Raiders,Cleveland Browns,27,20,2015,3,domingo,Regular Season,2-1,2,1,0,20,28,-8,1-2,1,2,0,26,21,5,Oakland Raiders,7
2015-09-27,Atlanta Falcons,Dallas Cowboys,39,28,2015,3,domingo,Regular Season,3-0,3,0,0,6,11,-5,2-1,2,1,0,11,12,-1,Atlanta Falcons,1
2015-09-27,Tampa Bay Buccaneers,Houston Texans,9,19,2015,3,domingo,Regular Season,1-2,1,2,0,30,29,1,1-2,1,2,0,21,25,-4,Houston Texans,4
2015-09-27,Los Angeles Chargers,Minnesota Vikings,14,31,2015,3,domingo,Regular Season,1-2,1,2,0,18,13,5,2-1,2,1,0,13,16,-3,Minnesota Vikings,3
2015-09-27,Jacksonville Jaguars,New England Patriots,17,51,2015,3,domingo,Regular Season,1-2,1,2,0,29,31,-2,3-0,3,0,0,1,1,0,New England Patriots,30
2015-09-27,Philadelphia Eagles,New York Jets,24,17,2015,3,domingo,Regular Season,1-2,1,2,0,17,22,-5,2-1,2,1,0,15,9,6,Philadelphia Eagles,13
2015-09-27,Pittsburgh Steelers,Los Angeles Rams,12,6,2015,3,domingo,Regular Season,2-1,2,1,0,8,4,4,1-2,1,2,0,19,19,0,Pittsburgh Steelers,15
2015-09-27,Indianapolis Colts,Tennessee Titans,35,33,2015,3,domingo,Regular Season,1-2,1,2,0,14,18,-4,1-2,1,2,0,24,27,-3,Indianapolis Colts,9
2015-09-24,Washington Redskins,New York Giants,21,32,2015,3,quinta,Regular Season,1-2,1,2,0,27,23,4,1-2,1,2,0,16,26,-10,New York Giants,3
2015-09-21,New York Jets,Indianapolis Colts,20,7,2015,2,segunda,Regular Season,2-0,2,0,0,9,21,-12,0-2,0,2,0,18,11,7,New York Jets,10
2015-09-20,Seattle Seahawks,Green Bay Packers,17,27,2015,2,domingo,Regular Season,0-2,0,2,0,7,3,4,2-0,2,0,0,2,2,0,Green Bay Packers,1
2015-09-20,Dallas Cowboys,Philadelphia Eagles,20,10,2015,2,domingo,Regular Season,2-0,2,0,0,12,5,7,0-2,0,2,0,22,15,7,Dallas Cowboys,10
2015-09-20,Miami Dolphins,Jacksonville Jaguars,20,23,2015,2,domingo,Regular Season,1-1,1,1,0,15,16,-1,1-1,1,1,0,31,30,1,Jacksonville Jaguars,14
2015-09-20,Baltimore Ravens,Oakland Raiders,33,37,2015,2,domingo,Regular Season,0-2,0,2,0,17,12,5,1-1,1,1,0,28,31,-3,Oakland Raiders,19
2015-09-20,New England Patriots,Buffalo Bills,40,32,2015,2,domingo,Regular Season,2-0,2,0,0,1,1,0,1-1,1,1,0,8,9,-1,New England Patriots,8
2015-09-20,Houston Texans,Carolina Panthers,17,24,2015,2,domingo,Regular Season,0-2,0,2,0,25,26,-1,2-0,2,0,0,14,18,-4,Carolina Panthers,8
2015-09-20,Arizona Cardinals,Chicago Bears,48,23,2015,2,domingo,Regular Season,2-0,2,0,0,3,6,-3,0-2,0,2,0,32,27,5,Arizona Cardinals,21
2015-09-20,Los Angeles Chargers,Cincinnati Bengals,19,24,2015,2,domingo,Regular Season,1-1,1,1,0,13,10,3,2-0,2,0,0,6,8,-2,Cincinnati Bengals,2
2015-09-20,Tennessee Titans,Cleveland Browns,14,28,2015,2,domingo,Regular Season,1-1,1,1,0,27,23,4,1-1,1,1,0,21,28,-7,Cleveland Browns,5
2015-09-20,Detroit Lions,Minnesota Vikings,16,26,2015,2,domingo,Regular Season,0-2,0,2,0,24,20,4,1-1,1,1,0,16,25,-9,Minnesota Vikings,5
2015-09-20,Tampa Bay Buccaneers,New Orleans Saints,26,19,2015,2,domingo,Regular Season,1-1,1,1,0,29,32,-3,0-2,0,2,0,30,22,8,Tampa Bay Buccaneers,10
2015-09-20,Atlanta Falcons,New York Giants,24,20,2015,2,domingo,Regular Season,2-0,2,0,0,11,17,-6,0-2,0,2,0,26,24,2,Atlanta Falcons,7
2015-09-20,San Francisco 49ers,Pittsburgh Steelers,18,43,2015,2,domingo,Regular Season,1-1,1,1,0,20,19,1,1-1,1,1,0,4,13,-9,Pittsburgh Steelers,6
2015-09-20,Los Angeles Rams,Washington Redskins,10,24,2015,2,domingo,Regular Season,1-1,1,1,0,19,14,5,1-1,1,1,0,23,29,-6,Washington Redskins,15
2015-09-17,Denver Broncos,Kansas City Chiefs,31,24,2015,2,quinta,Regular Season,2-0,2,0,0,5,4,1,1-1,1,1,0,10,7,3,Denver Broncos,3
2015-09-14,Minnesota Vikings,San Francisco 49ers,3,20,2015,1,segunda,Regular Season,0-1,0,1,0,25,17,8,1-0,1,0,0,19,24,-5,San Francisco 49ers,7
2015-09-14,Philadelphia Eagles,Atlanta Falcons,24,26,2015,1,segunda,Regular Season,0-1,0,1,0,15,9,6,1-0,1,0,0,17,23,-6,Atlanta Falcons,14
2015-09-13,New York Giants,Dallas Cowboys,26,27,2015,1,domingo,Regular Season,0-1,0,1,0,24,21,3,1-0,1,0,0,5,6,-1,Dallas Cowboys,15
2015-09-13,Baltimore Ravens,Denver Broncos,13,19,2015,1,domingo,Regular Season,0-1,0,1,0,12,8,4,1-0,1,0,0,4,5,-1,Denver Broncos,3
2015-09-13,Cincinnati Bengals,Oakland Raiders,33,13,2015,1,domingo,Regular Season,1-0,1,0,0,8,11,-3,0-1,0,1,0,31,28,3,Cincinnati Bengals,17
2015-09-13,Tennessee Titans,Tampa Bay Buccaneers,42,14,2015,1,domingo,Regular Season,1-0,1,0,0,23,30,-7,0-1,0,1,0,32,29,3,Tennessee Titans,1
2015-09-13,New Orleans Saints,Arizona Cardinals,19,31,2015,1,domingo,Regular Season,0-1,0,1,0,22,16,6,1-0,1,0,0,6,10,-4,Arizona Cardinals,6
2015-09-13,Detroit Lions,Los Angeles Chargers,28,33,2015,1,domingo,Regular Season,0-1,0,1,0,20,12,8,1-0,1,0,0,10,13,-3,Los Angeles Chargers,1
2015-09-13,Indianapolis Colts,Buffalo Bills,14,27,2015,1,domingo,Regular Season,0-1,0,1,0,11,4,7,1-0,1,0,0,9,18,-9,Buffalo Bills,14
2015-09-13,Green Bay Packers,Chicago Bears,31,23,2015,1,domingo,Regular Season,1-0,1,0,0,2,3,-1,0-1,0,1,0,27,25,2,Green Bay Packers,22
2015-09-13,Kansas City Chiefs,Houston Texans,27,20,2015,1,domingo,Regular Season,1-0,1,0,0,7,14,-7,0-1,0,1,0,26,20,6,Kansas City Chiefs,6
2015-09-13,Carolina Panthers,Jacksonville Jaguars,20,9,2015,1,domingo,Regular Season,1-0,1,0,0,18,19,-1,0-1,0,1,0,30,31,-1,Carolina Panthers,12
2015-09-13,Cleveland Browns,New York Jets,10,31,2015,1,domingo,Regular Season,0-1,0,1,0,28,27,1,1-0,1,0,0,21,26,-5,New York Jets,1
2015-09-13,Seattle Seahawks,Los Angeles Rams,31,34,2015,1,domingo,Regular Season,0-1,0,1,0,3,1,2,1-0,1,0,0,14,22,-8,Los Angeles Rams,21
2015-09-13,Miami Dolphins,Washington Redskins,17,10,2015,1,domingo,Regular Season,1-0,1,0,0,16,15,1,0-1,0,1,0,29,32,-3,Miami Dolphins,17
2015-09-10,Pittsburgh Steelers,New England Patriots,21,28,2015,1,quinta,Regular Season,0-1,0,1,0,13,7,6,1-0,1,0,0,1,2,-1,New England Patriots,5
2014-12-28,Cincinnati Bengals,Pittsburgh Steelers,17,27,2014,17,domingo,Regular Season,10-5,10,5,0,9,8,1,11-5,11,5,0,6,7,-1,Pittsburgh Steelers,1
2014-12-28,Oakland Raiders,Denver Broncos,14,47,2014,17,domingo,Regular Season,3-13,3,13,0,29,28,1,12-4,12,4,0,4,5,-1,Denver Broncos,23
2014-12-28,Arizona Cardinals,San Francisco 49ers,17,20,2014,17,domingo,Regular Season,11-5,11,5,0,10,9,1,8-8,8,8,0,18,18,0,San Francisco 49ers,9
2014-12-28,Los Angeles Rams,Seattle Seahawks,6,20,2014,17,domingo,Regular Season,6-10,6,10,0,22,25,-3,12-4,12,4,0,1,2,-1,Seattle Seahawks,23
2014-12-28,Carolina Panthers,Atlanta Falcons,34,3,2014,17,domingo,Regular Season,7-8,7,8,0,15,19,-4,6-10,6,10,0,25,20,5,Carolina Panthers,1
2014-12-28,Cleveland Browns,Baltimore Ravens,10,20,2014,17,domingo,Regular Season,7-9,7,9,0,23,21,2,10-6,10,6,0,11,12,-1,Baltimore Ravens,9
2014-12-28,Detroit Lions,Green Bay Packers,20,30,2014,17,domingo,Regular Season,11-5,11,5,0,7,6,1,12-4,12,4,0,3,3,0,Green Bay Packers,3
2014-12-28,Jacksonville Jaguars,Houston Texans,17,23,2014,17,domingo,Regular Season,3-13,3,13,0,30,30,0,9-7,9,7,0,14,15,-1,Houston Texans,15
2014-12-28,Los Angeles Chargers,Kansas City Chiefs,7,19,2014,17,domingo,Regular Season,9-7,9,7,0,16,11,5,9-7,9,7,0,13,14,-1,Kansas City Chiefs,3
2014-12-28,New York Jets,Miami Dolphins,37,24,2014,17,domingo,Regular Season,4-12,4,12,0,27,29,-2,8-8,8,8,0,19,16,3,New York Jets,13
2014-12-28,Chicago Bears,Minnesota Vikings,9,13,2014,17,domingo,Regular Season,5-11,5,11,0,26,26,0,7-9,7,9,0,20,23,-3,Minnesota Vikings,3
2014-12-28,Buffalo Bills,New England Patriots,17,9,2014,17,domingo,Regular Season,9-7,9,7,0,17,17,0,12-4,12,4,0,2,1,1,Buffalo Bills,16
2014-12-28,Philadelphia Eagles,New York Giants,34,26,2014,17,domingo,Regular Season,10-6,10,6,0,12,13,-1,6-10,6,10,0,24,22,2,Philadelphia Eagles,9
2014-12-28,New Orleans Saints,Tampa Bay Buccaneers,23,20,2014,17,domingo,Regular Season,7-9,7,9,0,21,24,-3,2-14,2,14,0,31,31,0,New Orleans Saints,7
2014-12-28,Indianapolis Colts,Tennessee Titans,27,10,2014,17,domingo,Regular Season,11-5,11,5,0,8,10,-2,2-14,2,14,0,32,32,0,Indianapolis Colts,22
2014-12-28,Dallas Cowboys,Washington Redskins,44,17,2014,17,domingo,Regular Season,12-4,12,4,0,5,4,1,4-12,4,12,0,28,27,1,Dallas Cowboys,23
2014-12-22,Denver Broncos,Cincinnati Bengals,28,37,2014,16,segunda,Regular Season,11-4,11,4,0,5,2,3,10-4,10,4,0,8,11,-3,Cincinnati Bengals,9
2014-12-21,Seattle Seahawks,Arizona Cardinals,35,6,2014,16,domingo,Regular Season,11-4,11,4,0,2,3,-1,11-4,11,4,0,9,5,4,Seattle Seahawks,2
2014-12-21,Indianapolis Colts,Dallas Cowboys,7,42,2014,16,domingo,Regular Season,10-5,10,5,0,10,7,3,11-4,11,4,0,4,6,-2,Dallas Cowboys,1
2014-12-21,Buffalo Bills,Oakland Raiders,24,26,2014,16,domingo,Regular Season,8-7,8,7,0,17,15,2,3-12,3,12,0,28,31,-3,Oakland Raiders,16
2014-12-21,New York Giants,Los Angeles Rams,37,27,2014,16,domingo,Regular Season,6-9,6,9,0,22,25,-3,6-9,6,9,0,25,20,5,New York Giants,5
2014-12-21,Cleveland Browns,Carolina Panthers,13,17,2014,16,domingo,Regular Season,7-8,7,8,0,21,21,0,6-8,6,8,0,19,22,-3,Carolina Panthers,1
2014-12-21,Detroit Lions,Chicago Bears,20,14,2014,16,domingo,Regular Season,11-4,11,4,0,6,8,-2,5-10,5,10,0,26,26,0,Detroit Lions,18
2014-12-21,Baltimore Ravens,Houston Texans,13,25,2014,16,domingo,Regular Season,9-6,9,6,0,12,12,0,8-7,8,7,0,15,18,-3,Houston Texans,6
2014-12-21,Minnesota Vikings,Miami Dolphins,35,37,2014,16,domingo,Regular Season,6-9,6,9,0,23,23,0,8-7,8,7,0,16,16,0,Miami Dolphins,7
2014-12-21,Atlanta Falcons,New Orleans Saints,30,14,2014,16,domingo,Regular Season,6-9,6,9,0,20,24,-4,6-9,6,9,0,24,19,5,Atlanta Falcons,5
2014-12-21,New England Patriots,New York Jets,17,16,2014,16,domingo,Regular Season,12-3,12,3,0,1,1,0,3-12,3,12,0,29,27,2,New England Patriots,26
2014-12-21,Kansas City Chiefs,Pittsburgh Steelers,12,20,2014,16,domingo,Regular Season,8-7,8,7,0,14,13,1,10-5,10,5,0,7,10,-3,Pittsburgh Steelers,3
2014-12-21,Green Bay Packers,Tampa Bay Buccaneers,20,3,2014,16,domingo,Regular Season,11-4,11,4,0,3,4,-1,2-13,2,13,0,31,29,2,Green Bay Packers,25
2014-12-20,Los Angeles Chargers,San Francisco 49ers,38,35,2014,16,sábado,Regular Season,9-6,9,6,0,11,14,-3,7-8,7,8,0,18,17,1,Los Angeles Chargers,3
2014-12-20,Philadelphia Eagles,Washington Redskins,24,27,2014,16,sábado,Regular Season,9-6,9,6,0,13,9,4,4-11,4,11,0,27,28,-1,Washington Redskins,19
2014-12-18,Tennessee Titans,Jacksonville Jaguars,13,21,2014,16,quinta,Regular Season,2-13,2,13,0,32,32,0,3-12,3,12,0,30,30,0,Jacksonville Jaguars,2
2014-12-15,New Orleans Saints,Chicago Bears,31,15,2014,15,segunda,Regular Season,6-8,6,8,0,19,23,-4,5-9,5,9,0,26,25,1,New Orleans Saints,2
2014-12-14,Dallas Cowboys,Philadelphia Eagles,38,27,2014,15,domingo,Regular Season,10-4,10,4,0,6,8,-2,9-5,9,5,0,9,7,2,Dallas Cowboys,1
2014-12-14,Minnesota Vikings,Detroit Lions,14,16,2014,15,domingo,Regular Season,6-8,6,8,0,23,22,1,10-4,10,4,0,8,9,-1,Detroit Lions,13
2014-12-14,San Francisco 49ers,Seattle Seahawks,7,17,2014,15,domingo,Regular Season,7-7,7,7,0,17,16,1,10-4,10,4,0,3,4,-1,Seattle Seahawks,12
2014-12-14,Denver Broncos,Los Angeles Chargers,22,10,2014,15,domingo,Regular Season,11-3,11,3,0,2,3,-1,8-6,8,6,0,14,11,3,Denver Broncos,8
2014-12-14,New York Jets,Tennessee Titans,16,11,2014,15,domingo,Regular Season,3-11,3,11,0,27,28,-1,2-12,2,12,0,32,32,0,New York Jets,4
2014-12-14,Pittsburgh Steelers,Atlanta Falcons,27,20,2014,15,domingo,Regular Season,9-5,9,5,0,10,10,0,5-9,5,9,0,24,21,3,Pittsburgh Steelers,11
2014-12-14,Jacksonville Jaguars,Baltimore Ravens,12,20,2014,15,domingo,Regular Season,2-12,2,12,0,30,31,-1,9-5,9,5,0,12,12,0,Baltimore Ravens,19
2014-12-14,Green Bay Packers,Buffalo Bills,13,21,2014,15,domingo,Regular Season,10-4,10,4,0,4,1,3,8-6,8,6,0,15,17,-2,Buffalo Bills,16
2014-12-14,Tampa Bay Buccaneers,Carolina Panthers,17,19,2014,15,domingo,Regular Season,2-12,2,12,0,29,30,-1,5-8,5,8,0,22,24,-2,Carolina Panthers,6
2014-12-14,Cincinnati Bengals,Cleveland Browns,30,0,2014,15,domingo,Regular Season,9-4,9,4,0,11,13,-2,7-7,7,7,0,21,19,2,Cincinnati Bengals,6
2014-12-14,Houston Texans,Indianapolis Colts,10,17,2014,15,domingo,Regular Season,7-7,7,7,0,18,18,0,10-4,10,4,0,7,6,1,Indianapolis Colts,12
2014-12-14,Oakland Raiders,Kansas City Chiefs,13,31,2014,15,domingo,Regular Season,2-12,2,12,0,31,29,2,8-6,8,6,0,13,14,-1,Kansas City Chiefs,15
2014-12-14,Miami Dolphins,New England Patriots,13,41,2014,15,domingo,Regular Season,7-7,7,7,0,16,15,1,11-3,11,3,0,1,2,-1,New England Patriots,13
2014-12-14,Washington Redskins,New York Giants,13,24,2014,15,domingo,Regular Season,3-11,3,11,0,28,27,1,5-9,5,9,0,25,26,-1,New York Giants,1
2014-12-11,Arizona Cardinals,Los Angeles Rams,12,6,2014,15,quinta,Regular Season,11-3,11,3,0,5,5,0,6-8,6,8,0,20,20,0,Arizona Cardinals,15
2014-12-08,Atlanta Falcons,Green Bay Packers,37,43,2014,14,segunda,Regular Season,5-8,5,8,0,21,22,-1,10-3,10,3,0,1,1,0,Green Bay Packers,21
2014-12-07,New England Patriots,Los Angeles Chargers,23,14,2014,14,domingo,Regular Season,10-3,10,3,0,2,2,0,8-5,8,5,0,11,9,2,New England Patriots,7
2014-12-07,San Francisco 49ers,Oakland Raiders,13,24,2014,14,domingo,Regular Season,7-6,7,6,0,16,12,4,2-11,2,11,0,29,32,-3,Oakland Raiders,20
2014-12-07,Seattle Seahawks,Philadelphia Eagles,24,14,2014,14,domingo,Regular Season,9-4,9,4,0,4,5,-1,9-4,9,4,0,7,4,3,Seattle Seahawks,1
2014-12-07,Kansas City Chiefs,Arizona Cardinals,14,17,2014,14,domingo,Regular Season,7-6,7,6,0,14,14,0,10-3,10,3,0,5,7,-2,Arizona Cardinals,7
2014-12-07,Buffalo Bills,Denver Broncos,17,24,2014,14,domingo,Regular Season,7-6,7,6,0,17,17,0,10-3,10,3,0,3,3,0,Denver Broncos,14
2014-12-07,Pittsburgh Steelers,Cincinnati Bengals,42,21,2014,14,domingo,Regular Season,8-5,8,5,0,10,16,-6,8-4,8,4,0,13,10,3,Pittsburgh Steelers,6
2014-12-07,Indianapolis Colts,Cleveland Browns,25,24,2014,14,domingo,Regular Season,9-4,9,4,0,6,6,0,7-6,7,6,0,19,18,1,Indianapolis Colts,12
2014-12-07,Tampa Bay Buccaneers,Detroit Lions,17,34,2014,14,domingo,Regular Season,2-11,2,11,0,30,28,2,9-4,9,4,0,9,11,-2,Detroit Lions,17
2014-12-07,Houston Texans,Jacksonville Jaguars,27,13,2014,14,domingo,Regular Season,7-6,7,6,0,18,20,-2,2-11,2,11,0,31,31,0,Houston Texans,11
2014-12-07,Baltimore Ravens,Miami Dolphins,28,13,2014,14,domingo,Regular Season,8-5,8,5,0,12,13,-1,7-6,7,6,0,15,15,0,Baltimore Ravens,2
2014-12-07,New York Jets,Minnesota Vikings,24,30,2014,14,domingo,Regular Season,2-11,2,11,0,28,29,-1,6-7,6,7,0,22,24,-2,Minnesota Vikings,5
2014-12-07,Carolina Panthers,New Orleans Saints,41,10,2014,14,domingo,Regular Season,4-8,4,8,0,24,25,-1,5-8,5,8,0,23,19,4,Carolina Panthers,6
2014-12-07,New York Giants,Tennessee Titans,36,7,2014,14,domingo,Regular Season,4-9,4,9,0,26,26,0,2-11,2,11,0,32,30,2,New York Giants,4
2014-12-07,Los Angeles Rams,Washington Redskins,24,0,2014,14,domingo,Regular Season,6-7,6,7,0,20,21,-1,3-10,3,10,0,27,27,0,Los Angeles Rams,6
2014-12-04,Dallas Cowboys,Chicago Bears,41,28,2014,14,quinta,Regular Season,9-4,9,4,0,8,8,0,5-8,5,8,0,25,23,2,Dallas Cowboys,15
2014-12-01,Miami Dolphins,New York Jets,16,13,2014,13,segunda,Regular Season,7-5,7,5,0,15,17,-2,2-10,2,10,0,29,30,-1,Miami Dolphins,13
2014-11-30,Denver Broncos,Kansas City Chiefs,29,16,2014,13,domingo,Regular Season,9-3,9,3,0,3,3,0,7-5,7,5,0,14,12,2,Denver Broncos,9
2014-11-30,New England Patriots,Green Bay Packers,21,26,2014,13,domingo,Regular Season,9-3,9,3,0,2,1,1,9-3,9,3,0,1,2,-1,Green Bay Packers,1
2014-11-30,Arizona Cardinals,Atlanta Falcons,18,29,2014,13,domingo,Regular Season,9-3,9,3,0,7,4,3,5-7,5,7,0,22,22,0,Atlanta Falcons,18
2014-11-30,Los Angeles Chargers,Baltimore Ravens,34,33,2014,13,domingo,Regular Season,8-4,8,4,0,9,15,-6,7-5,7,5,0,13,11,2,Los Angeles Chargers,4
2014-11-30,Cleveland Browns,Buffalo Bills,10,26,2014,13,domingo,Regular Season,7-5,7,5,0,18,16,2,7-5,7,5,0,17,18,-1,Buffalo Bills,2
2014-11-30,Tennessee Titans,Houston Texans,21,45,2014,13,domingo,Regular Season,2-10,2,10,0,30,28,2,6-6,6,6,0,20,20,0,Houston Texans,8
2014-11-30,Washington Redskins,Indianapolis Colts,27,49,2014,13,domingo,Regular Season,3-9,3,9,0,27,27,0,8-4,8,4,0,6,8,-2,Indianapolis Colts,19
2014-11-30,New York Giants,Jacksonville Jaguars,24,25,2014,13,domingo,Regular Season,3-9,3,9,0,26,26,0,2-10,2,10,0,31,32,-1,Jacksonville Jaguars,6
2014-11-30,Carolina Panthers,Minnesota Vikings,13,31,2014,13,domingo,Regular Season,3-8,3,8,0,25,25,0,5-7,5,7,0,24,24,0,Minnesota Vikings,1
2014-11-30,New Orleans Saints,Pittsburgh Steelers,35,32,2014,13,domingo,Regular Season,5-7,5,7,0,19,21,-2,7-5,7,5,0,16,14,2,New Orleans Saints,7
2014-11-30,Oakland Raiders,Los Angeles Rams,0,52,2014,13,domingo,Regular Season,1-11,1,11,0,32,31,1,5-7,5,7,0,21,23,-2,Los Angeles Rams,8
2014-11-30,Cincinnati Bengals,Tampa Bay Buccaneers,14,13,2014,13,domingo,Regular Season,8-3,8,3,0,10,10,0,2-10,2,10,0,28,29,-1,Cincinnati Bengals,19
2014-11-27,Seattle Seahawks,San Francisco 49ers,19,3,2014,13,quinta,Regular Season,8-4,8,4,0,5,7,-2,7-5,7,5,0,12,9,3,Seattle Seahawks,2
2014-11-27,Philadelphia Eagles,Dallas Cowboys,33,10,2014,13,quinta,Regular Season,9-3,9,3,0,4,6,-2,8-4,8,4,0,8,5,3,Philadelphia Eagles,1
2014-11-27,Chicago Bears,Detroit Lions,17,34,2014,13,quinta,Regular Season,5-7,5,7,0,23,19,4,8-4,8,4,0,11,13,-2,Detroit Lions,6
2014-11-24,Baltimore Ravens,New Orleans Saints,34,27,2014,12,segunda,Regular Season,7-4,7,4,0,11,14,-3,4-7,4,7,0,21,20,1,Baltimore Ravens,6
2014-11-24,New York Jets,Buffalo Bills,3,38,2014,12,segunda,Regular Season,2-9,2,9,0,30,28,2,6-5,6,5,0,18,19,-1,Buffalo Bills,9
2014-11-23,Dallas Cowboys,New York Giants,31,28,2014,12,domingo,Regular Season,8-3,8,3,0,5,6,-1,3-8,3,8,0,26,26,0,Dallas Cowboys,20
2014-11-23,Miami Dolphins,Denver Broncos,36,39,2014,12,domingo,Regular Season,6-5,6,5,0,17,15,2,8-3,8,3,0,3,4,-1,Denver Broncos,11
2014-11-23,Washington Redskins,San Francisco 49ers,13,17,2014,12,domingo,Regular Season,3-8,3,8,0,27,29,-2,7-4,7,4,0,9,10,-1,San Francisco 49ers,19
2014-11-23,Los Angeles Rams,Los Angeles Chargers,24,27,2014,12,domingo,Regular Season,4-7,4,7,0,23,22,1,7-4,7,4,0,15,16,-1,Los Angeles Chargers,6
2014-11-23,Arizona Cardinals,Seattle Seahawks,3,19,2014,12,domingo,Regular Season,9-2,9,2,0,4,2,2,7-4,7,4,0,7,11,-4,Seattle Seahawks,9
2014-11-23,Cleveland Browns,Atlanta Falcons,26,24,2014,12,domingo,Regular Season,7-4,7,4,0,16,17,-1,4-7,4,7,0,22,21,1,Cleveland Browns,4
2014-11-23,Tampa Bay Buccaneers,Chicago Bears,13,21,2014,12,domingo,Regular Season,2-9,2,9,0,29,30,-1,5-6,5,6,0,19,23,-4,Chicago Bears,7
2014-11-23,Cincinnati Bengals,Houston Texans,22,13,2014,12,domingo,Regular Season,7-3,7,3,0,10,13,-3,5-6,5,6,0,20,18,2,Cincinnati Bengals,5
2014-11-23,Jacksonville Jaguars,Indianapolis Colts,3,23,2014,12,domingo,Regular Season,1-10,1,10,0,32,31,1,7-4,7,4,0,8,9,-1,Indianapolis Colts,22
2014-11-23,Green Bay Packers,Minnesota Vikings,24,21,2014,12,domingo,Regular Season,8-3,8,3,0,2,3,-1,4-7,4,7,0,24,24,0,Green Bay Packers,21
2014-11-23,Detroit Lions,New England Patriots,9,34,2014,12,domingo,Regular Season,7-4,7,4,0,13,7,6,9-2,9,2,0,1,1,0,New England Patriots,6
2014-11-23,Tennessee Titans,Philadelphia Eagles,24,43,2014,12,domingo,Regular Season,2-9,2,9,0,28,27,1,8-3,8,3,0,6,8,-2,Philadelphia Eagles,19
2014-11-20,Kansas City Chiefs,Oakland Raiders,20,24,2014,12,quinta,Regular Season,7-4,7,4,0,12,5,7,1-10,1,10,0,31,32,-1,Oakland Raiders,27
2014-11-17,Pittsburgh Steelers,Tennessee Titans,27,24,2014,11,segunda,Regular Season,7-4,7,4,0,12,14,-2,2-8,2,8,0,27,29,-2,Pittsburgh Steelers,15
2014-11-16,New England Patriots,Indianapolis Colts,42,20,2014,11,domingo,Regular Season,8-2,8,2,0,1,1,0,6-4,6,4,0,9,7,2,New England Patriots,6
2014-11-16,Detroit Lions,Arizona Cardinals,6,14,2014,11,domingo,Regular Season,7-3,7,3,0,7,6,1,9-1,9,1,0,2,2,0,Arizona Cardinals,4
2014-11-16,Philadelphia Eagles,Green Bay Packers,20,53,2014,11,domingo,Regular Season,7-3,7,3,0,8,4,4,7-3,7,3,0,3,5,-2,Green Bay Packers,1
2014-11-16,Oakland Raiders,Los Angeles Chargers,6,13,2014,11,domingo,Regular Season,0-10,0,10,0,32,32,0,6-4,6,4,0,16,15,1,Los Angeles Chargers,17
2014-11-16,Atlanta Falcons,Carolina Panthers,19,17,2014,11,domingo,Regular Season,4-6,4,6,0,21,23,-2,3-7,3,7,0,25,22,3,Atlanta Falcons,1
2014-11-16,Minnesota Vikings,Chicago Bears,13,21,2014,11,domingo,Regular Season,4-6,4,6,0,24,21,3,4-6,4,6,0,23,27,-4,Chicago Bears,6
2014-11-16,Houston Texans,Cleveland Browns,23,7,2014,11,domingo,Regular Season,5-5,5,5,0,18,20,-2,6-4,6,4,0,17,11,6,Houston Texans,9
2014-11-16,Seattle Seahawks,Kansas City Chiefs,20,24,2014,11,domingo,Regular Season,6-4,6,4,0,11,9,2,7-3,7,3,0,5,10,-5,Kansas City Chiefs,1
2014-11-16,Cincinnati Bengals,New Orleans Saints,27,10,2014,11,domingo,Regular Season,6-3,6,3,0,13,16,-3,4-6,4,6,0,20,19,1,Cincinnati Bengals,3
2014-11-16,San Francisco 49ers,New York Giants,16,10,2014,11,domingo,Regular Season,6-4,6,4,0,10,12,-2,3-7,3,7,0,26,24,2,San Francisco 49ers,12
2014-11-16,Denver Broncos,Los Angeles Rams,7,22,2014,11,domingo,Regular Season,7-3,7,3,0,4,3,1,4-6,4,6,0,22,25,-3,Los Angeles Rams,22
2014-11-16,Tampa Bay Buccaneers,Washington Redskins,27,7,2014,11,domingo,Regular Season,2-8,2,8,0,30,30,0,3-7,3,7,0,29,26,3,Tampa Bay Buccaneers,4
2014-11-13,Buffalo Bills,Miami Dolphins,9,22,2014,11,quinta,Regular Season,5-5,5,5,0,19,18,1,6-4,6,4,0,15,17,-2,Miami Dolphins,1
2014-11-10,Carolina Panthers,Philadelphia Eagles,21,45,2014,10,segunda,Regular Season,3-6,3,6,0,22,22,0,7-2,7,2,0,4,4,0,Philadelphia Eagles,18
2014-11-09,Chicago Bears,Green Bay Packers,14,55,2014,10,domingo,Regular Season,3-6,3,6,0,27,21,6,6-3,6,3,0,5,8,-3,Green Bay Packers,13
2014-11-09,Los Angeles Rams,Arizona Cardinals,14,31,2014,10,domingo,Regular Season,3-6,3,6,0,25,25,0,8-1,8,1,0,2,2,0,Arizona Cardinals,23
2014-11-09,New York Giants,Seattle Seahawks,17,38,2014,10,domingo,Regular Season,3-6,3,6,0,24,24,0,6-3,6,3,0,9,10,-1,Seattle Seahawks,14
2014-11-09,Denver Broncos,Oakland Raiders,41,17,2014,10,domingo,Regular Season,7-2,7,2,0,3,3,0,0-9,0,9,0,32,32,0,Denver Broncos,29
2014-11-09,Tennessee Titans,Baltimore Ravens,7,21,2014,10,domingo,Regular Season,2-7,2,7,0,29,28,1,6-4,6,4,0,13,14,-1,Baltimore Ravens,14
2014-11-09,Kansas City Chiefs,Buffalo Bills,17,13,2014,10,domingo,Regular Season,6-3,6,3,0,10,12,-2,5-4,5,4,0,18,18,0,Kansas City Chiefs,6
2014-11-09,Miami Dolphins,Detroit Lions,16,20,2014,10,domingo,Regular Season,5-4,5,4,0,17,13,4,7-2,7,2,0,6,6,0,Detroit Lions,7
2014-11-09,Dallas Cowboys,Jacksonville Jaguars,31,17,2014,10,domingo,Regular Season,7-3,7,3,0,8,9,-1,1-9,1,9,0,31,31,0,Dallas Cowboys,22
2014-11-09,San Francisco 49ers,New Orleans Saints,27,24,2014,10,domingo,Regular Season,5-4,5,4,0,12,16,-4,4-5,4,5,0,19,15,4,San Francisco 49ers,1
2014-11-09,Pittsburgh Steelers,New York Jets,13,20,2014,10,domingo,Regular Season,6-4,6,4,0,14,7,7,2-8,2,8,0,28,30,-2,New York Jets,23
2014-11-09,Atlanta Falcons,Tampa Bay Buccaneers,27,17,2014,10,domingo,Regular Season,3-6,3,6,0,23,27,-4,1-8,1,8,0,30,29,1,Atlanta Falcons,2
2014-11-06,Cleveland Browns,Cincinnati Bengals,24,3,2014,10,quinta,Regular Season,6-3,6,3,0,11,19,-8,5-3,5,3,0,16,11,5,Cleveland Browns,8
2014-11-03,Indianapolis Colts,New York Giants,40,24,2014,9,segunda,Regular Season,6-3,6,3,0,5,9,-4,3-5,3,5,0,24,22,2,Indianapolis Colts,13
2014-11-02,Baltimore Ravens,Pittsburgh Steelers,23,43,2014,9,domingo,Regular Season,5-4,5,4,0,14,13,1,6-3,6,3,0,7,14,-7,Pittsburgh Steelers,1
2014-11-02,Denver Broncos,New England Patriots,21,43,2014,9,domingo,Regular Season,6-2,6,2,0,3,1,2,7-2,7,2,0,1,3,-2,New England Patriots,2
2014-11-02,Oakland Raiders,Seattle Seahawks,24,30,2014,9,domingo,Regular Season,0-8,0,8,0,32,32,0,5-3,5,3,0,10,10,0,Seattle Seahawks,22
2014-11-02,Los Angeles Rams,San Francisco 49ers,13,10,2014,9,domingo,Regular Season,3-5,3,5,0,25,27,-2,4-4,4,4,0,16,11,5,Los Angeles Rams,16
2014-11-02,Jacksonville Jaguars,Cincinnati Bengals,23,33,2014,9,domingo,Regular Season,1-8,1,8,0,31,31,0,5-2,5,2,0,11,12,-1,Cincinnati Bengals,19
2014-11-02,Tampa Bay Buccaneers,Cleveland Browns,17,22,2014,9,domingo,Regular Season,1-7,1,7,0,29,29,0,5-3,5,3,0,19,19,0,Cleveland Browns,10
2014-11-02,Arizona Cardinals,Dallas Cowboys,28,17,2014,9,domingo,Regular Season,7-1,7,1,0,2,2,0,6-3,6,3,0,9,4,5,Arizona Cardinals,2
2014-11-02,Philadelphia Eagles,Houston Texans,31,21,2014,9,domingo,Regular Season,6-2,6,2,0,4,5,-1,4-5,4,5,0,20,21,-1,Philadelphia Eagles,16
2014-11-02,New York Jets,Kansas City Chiefs,10,24,2014,9,domingo,Regular Season,1-8,1,8,0,30,30,0,5-3,5,3,0,12,15,-3,Kansas City Chiefs,15
2014-11-02,Los Angeles Chargers,Miami Dolphins,0,37,2014,9,domingo,Regular Season,5-4,5,4,0,17,8,9,5-3,5,3,0,13,18,-5,Miami Dolphins,10
2014-11-02,Washington Redskins,Minnesota Vikings,26,29,2014,9,domingo,Regular Season,3-6,3,6,0,26,24,2,4-5,4,5,0,23,25,-2,Minnesota Vikings,1
2014-10-30,New Orleans Saints,Carolina Panthers,28,10,2014,9,quinta,Regular Season,4-4,4,4,0,15,17,-2,3-5,3,5,0,22,20,2,New Orleans Saints,3
2014-10-27,Washington Redskins,Dallas Cowboys,20,17,2014,8,segunda,Regular Season,3-5,3,5,0,24,26,-2,6-2,6,2,0,4,2,2,Washington Redskins,24
2014-10-26,Green Bay Packers,New Orleans Saints,23,44,2014,8,domingo,Regular Season,5-3,5,3,0,7,6,1,3-4,3,4,0,17,22,-5,New Orleans Saints,16
2014-10-26,Oakland Raiders,Cleveland Browns,13,23,2014,8,domingo,Regular Season,0-7,0,7,0,32,32,0,4-3,4,3,0,19,20,-1,Cleveland Browns,12
2014-10-26,Indianapolis Colts,Pittsburgh Steelers,34,51,2014,8,domingo,Regular Season,5-3,5,3,0,9,4,5,5-3,5,3,0,14,15,-1,Pittsburgh Steelers,11
2014-10-26,Philadelphia Eagles,Arizona Cardinals,20,24,2014,8,domingo,Regular Season,5-2,5,2,0,5,3,2,6-1,6,1,0,2,5,-3,Arizona Cardinals,2
2014-10-26,Seattle Seahawks,Carolina Panthers,13,9,2014,8,domingo,Regular Season,4-3,4,3,0,10,11,-1,3-4,3,4,0,20,17,3,Seattle Seahawks,6
2014-10-26,Baltimore Ravens,Cincinnati Bengals,24,27,2014,8,domingo,Regular Season,5-3,5,3,0,13,9,4,4-2,4,2,0,12,13,-1,Cincinnati Bengals,4
2014-10-26,Miami Dolphins,Jacksonville Jaguars,27,13,2014,8,domingo,Regular Season,4-3,4,3,0,18,18,0,1-7,1,7,0,31,31,0,Miami Dolphins,13
2014-10-26,Los Angeles Rams,Kansas City Chiefs,7,34,2014,8,domingo,Regular Season,2-5,2,5,0,27,24,3,4-3,4,3,0,15,14,1,Kansas City Chiefs,10
2014-10-26,Chicago Bears,New England Patriots,23,51,2014,8,domingo,Regular Season,3-5,3,5,0,23,19,4,6-2,6,2,0,3,8,-5,New England Patriots,11
2014-10-26,Buffalo Bills,New York Jets,43,23,2014,8,domingo,Regular Season,5-3,5,3,0,16,16,0,1-7,1,7,0,30,29,1,Buffalo Bills,13
2014-10-26,Minnesota Vikings,Tampa Bay Buccaneers,19,13,2014,8,domingo,Regular Season,3-5,3,5,0,25,27,-2,1-6,1,6,0,29,30,-1,Minnesota Vikings,3
2014-10-26,Houston Texans,Tennessee Titans,30,16,2014,8,domingo,Regular Season,4-4,4,4,0,21,23,-2,2-6,2,6,0,28,28,0,Houston Texans,5
2014-10-26,Detroit Lions,Atlanta Falcons,22,21,2014,8,domingo,Regular Season,6-2,6,2,0,6,10,-4,2-6,2,6,0,26,25,1,Detroit Lions,15
2014-10-23,Los Angeles Chargers,Denver Broncos,21,35,2014,8,quinta,Regular Season,5-3,5,3,0,8,7,1,6-1,6,1,0,1,1,0,Denver Broncos,6
2014-10-20,Houston Texans,Pittsburgh Steelers,23,30,2014,7,segunda,Regular Season,3-4,3,4,0,23,19,4,4-3,4,3,0,15,22,-7,Pittsburgh Steelers,3
2014-10-19,San Francisco 49ers,Denver Broncos,17,42,2014,7,domingo,Regular Season,4-3,4,3,0,12,7,5,5-1,5,1,0,1,1,0,Denver Broncos,6
2014-10-19,New York Giants,Dallas Cowboys,21,31,2014,7,domingo,Regular Season,3-4,3,4,0,21,20,1,6-1,6,1,0,2,3,-1,Dallas Cowboys,17
2014-10-19,Arizona Cardinals,Oakland Raiders,24,13,2014,7,domingo,Regular Season,5-1,5,1,0,5,6,-1,0-6,0,6,0,32,31,1,Arizona Cardinals,25
2014-10-19,Kansas City Chiefs,Los Angeles Chargers,23,20,2014,7,domingo,Regular Season,3-3,3,3,0,14,18,-4,5-2,5,2,0,7,2,5,Kansas City Chiefs,16
2014-10-19,Atlanta Falcons,Baltimore Ravens,7,29,2014,7,domingo,Regular Season,2-5,2,5,0,25,24,1,5-2,5,2,0,9,12,-3,Baltimore Ravens,12
2014-10-19,Minnesota Vikings,Buffalo Bills,16,17,2014,7,domingo,Regular Season,2-5,2,5,0,27,27,0,4-3,4,3,0,16,21,-5,Buffalo Bills,6
2014-10-19,Miami Dolphins,Chicago Bears,27,14,2014,7,domingo,Regular Season,3-3,3,3,0,18,23,-5,3-4,3,4,0,19,16,3,Miami Dolphins,7
2014-10-19,New Orleans Saints,Detroit Lions,23,24,2014,7,domingo,Regular Season,2-4,2,4,0,22,17,5,5-2,5,2,0,10,13,-3,Detroit Lions,4
2014-10-19,Carolina Panthers,Green Bay Packers,17,38,2014,7,domingo,Regular Season,3-3,3,3,0,17,14,3,5-2,5,2,0,6,9,-3,Green Bay Packers,5
2014-10-19,Cincinnati Bengals,Indianapolis Colts,0,27,2014,7,domingo,Regular Season,3-2,3,2,0,13,11,2,5-2,5,2,0,4,8,-4,Indianapolis Colts,3
2014-10-19,Cleveland Browns,Jacksonville Jaguars,6,24,2014,7,domingo,Regular Season,3-3,3,3,0,20,15,5,1-6,1,6,0,31,32,-1,Jacksonville Jaguars,17
2014-10-19,Seattle Seahawks,Los Angeles Rams,26,28,2014,7,domingo,Regular Season,3-3,3,3,0,11,5,6,2-4,2,4,0,24,26,-2,Los Angeles Rams,21
2014-10-19,Tennessee Titans,Washington Redskins,17,19,2014,7,domingo,Regular Season,2-5,2,5,0,28,25,3,2-5,2,5,0,26,28,-2,Washington Redskins,3
2014-10-16,New York Jets,New England Patriots,25,27,2014,7,quinta,Regular Season,1-6,1,6,0,29,29,0,5-2,5,2,0,8,10,-2,New England Patriots,19
2014-10-13,San Francisco 49ers,Los Angeles Rams,31,17,2014,6,segunda,Regular Season,4-2,4,2,0,7,7,0,1-4,1,4,0,26,28,-2,San Francisco 49ers,21
2014-10-12,New York Giants,Philadelphia Eagles,0,27,2014,6,domingo,Regular Season,3-3,3,3,0,20,13,7,5-1,5,1,0,4,4,0,Philadelphia Eagles,9
2014-10-12,Washington Redskins,Arizona Cardinals,20,30,2014,6,domingo,Regular Season,1-5,1,5,0,28,26,2,4-1,4,1,0,6,10,-4,Arizona Cardinals,16
2014-10-12,Dallas Cowboys,Seattle Seahawks,30,23,2014,6,domingo,Regular Season,5-1,5,1,0,3,6,-3,3-2,3,2,0,5,1,4,Dallas Cowboys,5
2014-10-12,Los Angeles Chargers,Oakland Raiders,31,28,2014,6,domingo,Regular Season,5-1,5,1,0,2,3,-1,0-5,0,5,0,31,32,-1,Los Angeles Chargers,29
2014-10-12,Chicago Bears,Atlanta Falcons,27,13,2014,6,domingo,Regular Season,3-3,3,3,0,16,22,-6,2-4,2,4,0,24,21,3,Chicago Bears,1
2014-10-12,New England Patriots,Buffalo Bills,37,22,2014,6,domingo,Regular Season,4-2,4,2,0,10,11,-1,3-3,3,3,0,21,18,3,New England Patriots,7
2014-10-12,Carolina Panthers,Cincinnati Bengals,37,37,2014,6,domingo,Regular Season,3-2,3,2,0,14,15,-1,3-1,3,1,0,11,5,6,Draw,10
2014-10-12,Pittsburgh Steelers,Cleveland Browns,10,31,2014,6,domingo,Regular Season,3-3,3,3,0,22,16,6,3-2,3,2,0,15,23,-8,Cleveland Browns,7
2014-10-12,Green Bay Packers,Miami Dolphins,27,24,2014,6,domingo,Regular Season,4-2,4,2,0,9,9,0,2-3,2,3,0,23,24,-1,Green Bay Packers,15
2014-10-12,Detroit Lions,Minnesota Vikings,17,3,2014,6,domingo,Regular Season,4-2,4,2,0,13,14,-1,2-4,2,4,0,27,25,2,Detroit Lions,11
2014-10-12,Denver Broncos,New York Jets,31,17,2014,6,domingo,Regular Season,4-1,4,1,0,1,2,-1,1-5,1,5,0,29,30,-1,Denver Broncos,28
2014-10-12,Baltimore Ravens,Tampa Bay Buccaneers,48,17,2014,6,domingo,Regular Season,4-2,4,2,0,12,12,0,1-5,1,5,0,30,27,3,Baltimore Ravens,15
2014-10-12,Jacksonville Jaguars,Tennessee Titans,14,16,2014,6,domingo,Regular Season,0-6,0,6,0,32,31,1,2-4,2,4,0,25,29,-4,Tennessee Titans,2
2014-10-09,Indianapolis Colts,Houston Texans,33,28,2014,6,quinta,Regular Season,4-2,4,2,0,8,8,0,3-3,3,3,0,19,17,2,Indianapolis Colts,9
2014-10-06,Seattle Seahawks,Washington Redskins,27,17,2014,5,segunda,Regular Season,3-1,3,1,0,1,1,0,1-4,1,4,0,26,27,-1,Seattle Seahawks,26
2014-10-05,Cincinnati Bengals,New England Patriots,17,43,2014,5,domingo,Regular Season,3-1,3,1,0,5,2,3,3-2,3,2,0,11,16,-5,New England Patriots,14
2014-10-05,New York Jets,Los Angeles Chargers,0,31,2014,5,domingo,Regular Season,1-4,1,4,0,30,26,4,4-1,4,1,0,3,5,-2,Los Angeles Chargers,21
2014-10-05,Kansas City Chiefs,San Francisco 49ers,17,22,2014,5,domingo,Regular Season,2-3,2,3,0,19,14,5,3-2,3,2,0,7,9,-2,San Francisco 49ers,5
2014-10-05,Arizona Cardinals,Denver Broncos,20,41,2014,5,domingo,Regular Season,3-1,3,1,0,10,4,6,3-1,3,1,0,2,3,-1,Denver Broncos,1
2014-10-05,Chicago Bears,Carolina Panthers,24,31,2014,5,domingo,Regular Season,2-3,2,3,0,22,15,7,3-2,3,2,0,15,20,-5,Carolina Panthers,5
2014-10-05,Houston Texans,Dallas Cowboys,17,20,2014,5,domingo,Regular Season,3-2,3,2,0,17,13,4,4-1,4,1,0,6,10,-4,Dallas Cowboys,3
2014-10-05,Buffalo Bills,Detroit Lions,17,14,2014,5,domingo,Regular Season,3-2,3,2,0,18,23,-5,3-2,3,2,0,14,8,6,Buffalo Bills,15
2014-10-05,Baltimore Ravens,Indianapolis Colts,13,20,2014,5,domingo,Regular Season,3-2,3,2,0,12,7,5,3-2,3,2,0,8,11,-3,Indianapolis Colts,4
2014-10-05,Pittsburgh Steelers,Jacksonville Jaguars,17,9,2014,5,domingo,Regular Season,3-2,3,2,0,16,18,-2,0-5,0,5,0,31,31,0,Pittsburgh Steelers,13
2014-10-05,Tampa Bay Buccaneers,New Orleans Saints,31,37,2014,5,domingo,Regular Season,1-4,1,4,0,27,29,-2,2-3,2,3,0,20,21,-1,New Orleans Saints,8
2014-10-05,Atlanta Falcons,New York Giants,20,30,2014,5,domingo,Regular Season,2-3,2,3,0,21,17,4,3-2,3,2,0,13,19,-6,New York Giants,2
2014-10-05,Los Angeles Rams,Philadelphia Eagles,28,34,2014,5,domingo,Regular Season,1-3,1,3,0,28,30,-2,4-1,4,1,0,4,6,-2,Philadelphia Eagles,24
2014-10-05,Cleveland Browns,Tennessee Titans,29,28,2014,5,domingo,Regular Season,2-2,2,2,0,23,25,-2,1-4,1,4,0,29,28,1,Cleveland Browns,3
2014-10-02,Minnesota Vikings,Green Bay Packers,10,42,2014,5,quinta,Regular Season,2-3,2,3,0,25,24,1,3-2,3,2,0,9,12,-3,Green Bay Packers,12
2014-09-29,New England Patriots,Kansas City Chiefs,14,41,2014,4,segunda,Regular Season,2-2,2,2,0,16,7,9,2-2,2,2,0,14,22,-8,Kansas City Chiefs,15
2014-09-28,New Orleans Saints,Dallas Cowboys,17,38,2014,4,domingo,Regular Season,1-3,1,3,0,21,15,6,3-1,3,1,0,10,18,-8,Dallas Cowboys,3
2014-09-28,Atlanta Falcons,Minnesota Vikings,28,41,2014,4,domingo,Regular Season,2-2,2,2,0,17,9,8,2-2,2,2,0,24,29,-5,Minnesota Vikings,20
2014-09-28,Philadelphia Eagles,San Francisco 49ers,21,26,2014,4,domingo,Regular Season,3-1,3,1,0,6,4,2,2-2,2,2,0,9,16,-7,San Francisco 49ers,12
2014-09-28,Jacksonville Jaguars,Los Angeles Chargers,14,33,2014,4,domingo,Regular Season,0-4,0,4,0,31,32,-1,3-1,3,1,0,5,6,-1,Los Angeles Chargers,26
2014-09-28,Carolina Panthers,Baltimore Ravens,10,38,2014,4,domingo,Regular Season,2-2,2,2,0,20,10,10,3-1,3,1,0,7,13,-6,Baltimore Ravens,3
2014-09-28,Green Bay Packers,Chicago Bears,38,17,2014,4,domingo,Regular Season,2-2,2,2,0,12,17,-5,2-2,2,2,0,15,8,7,Green Bay Packers,9
2014-09-28,Buffalo Bills,Houston Texans,17,23,2014,4,domingo,Regular Season,2-2,2,2,0,23,19,4,3-1,3,1,0,13,20,-7,Houston Texans,1
2014-09-28,Tennessee Titans,Indianapolis Colts,17,41,2014,4,domingo,Regular Season,1-3,1,3,0,28,27,1,2-2,2,2,0,11,14,-3,Indianapolis Colts,13
2014-09-28,Detroit Lions,New York Jets,24,17,2014,4,domingo,Regular Season,3-1,3,1,0,8,12,-4,1-3,1,3,0,26,21,5,Detroit Lions,9
2014-09-28,Miami Dolphins,Oakland Raiders,38,14,2014,4,domingo,Regular Season,2-2,2,2,0,22,25,-3,0-4,0,4,0,32,30,2,Miami Dolphins,5
2014-09-28,Tampa Bay Buccaneers,Pittsburgh Steelers,27,24,2014,4,domingo,Regular Season,1-3,1,3,0,29,31,-2,2-2,2,2,0,18,11,7,Tampa Bay Buccaneers,20
2014-09-25,New York Giants,Washington Redskins,45,14,2014,4,quinta,Regular Season,2-2,2,2,0,19,26,-7,1-3,1,3,0,27,23,4,New York Giants,3
2014-09-22,Chicago Bears,New York Jets,27,19,2014,3,segunda,Regular Season,2-1,2,1,0,8,11,-3,1-2,1,2,0,21,21,0,Chicago Bears,10
2014-09-21,Pittsburgh Steelers,Carolina Panthers,37,19,2014,3,domingo,Regular Season,2-1,2,1,0,11,19,-8,2-1,2,1,0,10,6,4,Pittsburgh Steelers,13
2014-09-21,Kansas City Chiefs,Miami Dolphins,34,15,2014,3,domingo,Regular Season,1-2,1,2,0,22,27,-5,1-2,1,2,0,25,20,5,Kansas City Chiefs,7
2014-09-21,Denver Broncos,Seattle Seahawks,20,26,2014,3,domingo,Regular Season,2-1,2,1,0,3,1,2,2-1,2,1,0,1,2,-1,Seattle Seahawks,1
2014-09-21,San Francisco 49ers,Arizona Cardinals,14,23,2014,3,domingo,Regular Season,1-2,1,2,0,16,7,9,3-0,3,0,0,5,9,-4,Arizona Cardinals,2
2014-09-21,Los Angeles Chargers,Buffalo Bills,22,10,2014,3,domingo,Regular Season,2-1,2,1,0,6,10,-4,2-1,2,1,0,19,12,7,Los Angeles Chargers,2
2014-09-21,Tennessee Titans,Cincinnati Bengals,7,33,2014,3,domingo,Regular Season,1-2,1,2,0,27,24,3,3-0,3,0,0,2,3,-1,Cincinnati Bengals,21
2014-09-21,Baltimore Ravens,Cleveland Browns,23,21,2014,3,domingo,Regular Season,2-1,2,1,0,13,13,0,1-2,1,2,0,24,23,1,Baltimore Ravens,10
2014-09-21,Green Bay Packers,Detroit Lions,7,19,2014,3,domingo,Regular Season,1-2,1,2,0,17,8,9,2-1,2,1,0,12,18,-6,Detroit Lions,10
2014-09-21,Indianapolis Colts,Jacksonville Jaguars,44,14,2014,3,domingo,Regular Season,1-2,1,2,0,14,15,-1,0-3,0,3,0,32,31,1,Indianapolis Colts,16
2014-09-21,Oakland Raiders,New England Patriots,9,16,2014,3,domingo,Regular Season,0-3,0,3,0,30,32,-2,2-1,2,1,0,7,5,2,New England Patriots,27
2014-09-21,Minnesota Vikings,New Orleans Saints,9,20,2014,3,domingo,Regular Season,1-2,1,2,0,29,26,3,1-2,1,2,0,15,16,-1,New Orleans Saints,10
2014-09-21,Houston Texans,New York Giants,17,30,2014,3,domingo,Regular Season,2-1,2,1,0,20,14,6,1-2,1,2,0,26,30,-4,New York Giants,16
2014-09-21,Washington Redskins,Philadelphia Eagles,34,37,2014,3,domingo,Regular Season,1-2,1,2,0,23,25,-2,3-0,3,0,0,4,4,0,Philadelphia Eagles,21
2014-09-21,Dallas Cowboys,Los Angeles Rams,34,31,2014,3,domingo,Regular Season,2-1,2,1,0,18,22,-4,1-2,1,2,0,28,28,0,Dallas Cowboys,6
2014-09-18,Tampa Bay Buccaneers,Atlanta Falcons,14,56,2014,3,quinta,Regular Season,0-3,0,3,0,31,29,2,2-1,2,1,0,9,17,-8,Atlanta Falcons,12
2014-09-15,Philadelphia Eagles,Indianapolis Colts,30,27,2014,2,segunda,Regular Season,2-0,2,0,0,4,4,0,0-2,0,2,0,15,10,5,Philadelphia Eagles,6
2014-09-14,Chicago Bears,San Francisco 49ers,28,20,2014,2,domingo,Regular Season,1-1,1,1,0,11,18,-7,1-1,1,1,0,7,3,4,Chicago Bears,15
2014-09-14,Kansas City Chiefs,Denver Broncos,17,24,2014,2,domingo,Regular Season,0-2,0,2,0,27,25,2,2-0,2,0,0,1,2,-1,Denver Broncos,23
2014-09-14,New York Jets,Green Bay Packers,24,31,2014,2,domingo,Regular Season,1-1,1,1,0,21,21,0,1-1,1,1,0,8,8,0,Green Bay Packers,13
2014-09-14,Houston Texans,Oakland Raiders,30,14,2014,2,domingo,Regular Season,2-0,2,0,0,14,22,-8,0-2,0,2,0,32,31,1,Houston Texans,9
2014-09-14,Seattle Seahawks,Los Angeles Chargers,21,30,2014,2,domingo,Regular Season,1-1,1,1,0,2,1,1,1-1,1,1,0,10,16,-6,Los Angeles Chargers,15
2014-09-14,Los Angeles Rams,Tampa Bay Buccaneers,19,17,2014,2,domingo,Regular Season,1-1,1,1,0,28,32,-4,0-2,0,2,0,29,24,5,Los Angeles Rams,8
2014-09-14,Miami Dolphins,Buffalo Bills,10,29,2014,2,domingo,Regular Season,1-1,1,1,0,20,15,5,2-0,2,0,0,12,23,-11,Buffalo Bills,8
2014-09-14,Detroit Lions,Carolina Panthers,7,24,2014,2,domingo,Regular Season,1-1,1,1,0,18,13,5,2-0,2,0,0,6,11,-5,Carolina Panthers,2
2014-09-14,Atlanta Falcons,Cincinnati Bengals,10,24,2014,2,domingo,Regular Season,1-1,1,1,0,17,9,8,2-0,2,0,0,3,5,-2,Cincinnati Bengals,4
2014-09-14,New Orleans Saints,Cleveland Browns,24,26,2014,2,domingo,Regular Season,0-2,0,2,0,16,6,10,1-1,1,1,0,23,29,-6,Cleveland Browns,23
2014-09-14,New England Patriots,Minnesota Vikings,30,7,2014,2,domingo,Regular Season,1-1,1,1,0,5,7,-2,1-1,1,1,0,26,17,9,New England Patriots,10
2014-09-14,Arizona Cardinals,New York Giants,25,14,2014,2,domingo,Regular Season,2-0,2,0,0,9,14,-5,0-2,0,2,0,30,26,4,Arizona Cardinals,12
2014-09-14,Dallas Cowboys,Tennessee Titans,26,10,2014,2,domingo,Regular Season,1-1,1,1,0,22,27,-5,1-1,1,1,0,24,19,5,Dallas Cowboys,8
2014-09-14,Jacksonville Jaguars,Washington Redskins,10,41,2014,2,domingo,Regular Season,0-2,0,2,0,31,30,1,1-1,1,1,0,25,28,-3,Washington Redskins,2
2014-09-11,Pittsburgh Steelers,Baltimore Ravens,6,26,2014,2,quinta,Regular Season,1-1,1,1,0,19,12,7,1-1,1,1,0,13,20,-7,Baltimore Ravens,8
2014-09-08,Los Angeles Chargers,Arizona Cardinals,17,18,2014,1,segunda,Regular Season,0-1,0,1,0,16,11,5,1-0,1,0,0,14,14,0,Arizona Cardinals,3
2014-09-08,New York Giants,Detroit Lions,14,35,2014,1,segunda,Regular Season,0-1,0,1,0,26,20,6,1-0,1,0,0,13,18,-5,Detroit Lions,2
2014-09-07,Indianapolis Colts,Denver Broncos,24,31,2014,1,domingo,Regular Season,0-1,0,1,0,10,8,2,1-0,1,0,0,2,2,0,Denver Broncos,6
2014-09-07,San Francisco 49ers,Dallas Cowboys,28,17,2014,1,domingo,Regular Season,1-0,1,0,0,3,4,-1,0-1,0,1,0,27,23,4,San Francisco 49ers,19
2014-09-07,Carolina Panthers,Tampa Bay Buccaneers,20,14,2014,1,domingo,Regular Season,1-0,1,0,0,11,15,-4,0-1,0,1,0,24,19,5,Carolina Panthers,4
2014-09-07,New Orleans Saints,Atlanta Falcons,34,37,2014,1,domingo,Regular Season,0-1,0,1,0,6,5,1,1-0,1,0,0,9,17,-8,Atlanta Falcons,12
2014-09-07,Cincinnati Bengals,Baltimore Ravens,23,16,2014,1,domingo,Regular Season,1-0,1,0,0,5,9,-4,0-1,0,1,0,20,12,8,Cincinnati Bengals,3
2014-09-07,Buffalo Bills,Chicago Bears,23,20,2014,1,domingo,Regular Season,1-0,1,0,0,23,29,-6,0-1,0,1,0,18,10,8,Buffalo Bills,19
2014-09-07,Washington Redskins,Houston Texans,6,17,2014,1,domingo,Regular Season,0-1,0,1,0,28,25,3,1-0,1,0,0,22,27,-5,Houston Texans,2
2014-09-07,Tennessee Titans,Kansas City Chiefs,26,10,2014,1,domingo,Regular Season,1-0,1,0,0,19,28,-9,0-1,0,1,0,25,16,9,Tennessee Titans,12
2014-09-07,New England Patriots,Miami Dolphins,20,33,2014,1,domingo,Regular Season,0-1,0,1,0,7,3,4,1-0,1,0,0,15,22,-7,Miami Dolphins,19
2014-09-07,Oakland Raiders,New York Jets,14,19,2014,1,domingo,Regular Season,0-1,0,1,0,31,32,-1,1-0,1,0,0,21,21,0,New York Jets,11
2014-09-07,Jacksonville Jaguars,Philadelphia Eagles,17,34,2014,1,domingo,Regular Season,0-1,0,1,0,30,31,-1,1-0,1,0,0,4,7,-3,Philadelphia Eagles,24
2014-09-07,Cleveland Browns,Pittsburgh Steelers,27,30,2014,1,domingo,Regular Season,0-1,0,1,0,29,30,-1,1-0,1,0,0,12,13,-1,Pittsburgh Steelers,17
2014-09-07,Minnesota Vikings,Los Angeles Rams,34,6,2014,1,domingo,Regular Season,1-0,1,0,0,17,26,-9,0-1,0,1,0,32,24,8,Minnesota Vikings,2
2014-09-04,Green Bay Packers,Seattle Seahawks,16,36,2014,1,quinta,Regular Season,0-1,0,1,0,8,6,2,1-0,1,0,0,1,1,0,Seattle Seahawks,5
2013-12-29,Carolina Panthers,Atlanta Falcons,21,20,2013,17,domingo,Regular Season,12-4,12,4,0,3,3,0,4-12,4,12,0,26,27,-1,Carolina Panthers,24
2013-12-29,Green Bay Packers,Chicago Bears,33,28,2013,17,domingo,Regular Season,8-7,8,7,0,13,17,-4,8-8,8,8,0,15,13,2,Green Bay Packers,4
2013-12-29,Houston Texans,Tennessee Titans,10,16,2013,17,domingo,Regular Season,2-14,2,14,0,32,32,0,7-9,7,9,0,22,21,1,Tennessee Titans,11
2013-12-29,Cleveland Browns,Pittsburgh Steelers,7,20,2013,17,domingo,Regular Season,4-12,4,12,0,28,28,0,8-8,8,8,0,14,18,-4,Pittsburgh Steelers,10
2013-12-29,Washington Redskins,New York Giants,6,20,2013,17,domingo,Regular Season,3-13,3,13,0,31,31,0,7-9,7,9,0,23,24,-1,New York Giants,7
2013-12-29,Baltimore Ravens,Cincinnati Bengals,17,34,2013,17,domingo,Regular Season,8-8,8,8,0,16,14,2,11-5,11,5,0,7,7,0,Cincinnati Bengals,7
2013-12-29,Jacksonville Jaguars,Indianapolis Colts,10,30,2013,17,domingo,Regular Season,4-12,4,12,0,29,29,0,11-5,11,5,0,8,8,0,Indianapolis Colts,21
2013-12-29,Philadelphia Eagles,Dallas Cowboys,24,22,2013,17,domingo,Regular Season,10-6,10,6,0,11,11,0,8-8,8,8,0,17,15,2,Philadelphia Eagles,4
2013-12-29,New York Jets,Miami Dolphins,20,7,2013,17,domingo,Regular Season,8-8,8,8,0,19,22,-3,8-8,8,8,0,18,16,2,New York Jets,6
2013-12-29,Detroit Lions,Minnesota Vikings,13,14,2013,17,domingo,Regular Season,7-9,7,9,0,21,20,1,5-10,5,10,0,24,25,-1,Minnesota Vikings,5
2013-12-29,Buffalo Bills,New England Patriots,20,34,2013,17,domingo,Regular Season,6-10,6,10,0,25,23,2,12-4,12,4,0,5,5,0,New England Patriots,18
2013-12-29,Tampa Bay Buccaneers,New Orleans Saints,17,42,2013,17,domingo,Regular Season,4-12,4,12,0,27,26,1,11-5,11,5,0,6,6,0,New Orleans Saints,20
2013-12-29,Denver Broncos,Oakland Raiders,34,14,2013,17,domingo,Regular Season,13-3,13,3,0,2,2,0,4-12,4,12,0,30,30,0,Denver Broncos,28
2013-12-29,San Francisco 49ers,Arizona Cardinals,23,20,2013,17,domingo,Regular Season,12-4,12,4,0,4,4,0,10-6,10,6,0,9,9,0,San Francisco 49ers,5
2013-12-29,Kansas City Chiefs,Los Angeles Chargers,24,27,2013,17,domingo,Regular Season,11-5,11,5,0,10,10,0,9-7,9,7,0,12,12,0,Los Angeles Chargers,2
2013-12-29,Los Angeles Rams,Seattle Seahawks,9,27,2013,17,domingo,Regular Season,7-9,7,9,0,20,19,1,13-3,13,3,0,1,1,0,Seattle Seahawks,18
2013-12-23,Atlanta Falcons,San Francisco 49ers,24,34,2013,16,segunda,Regular Season,4-11,4,11,0,27,28,-1,11-4,11,4,0,4,3,1,San Francisco 49ers,25
2013-12-22,Miami Dolphins,Buffalo Bills,0,19,2013,16,domingo,Regular Season,8-7,8,7,0,16,14,2,6-9,6,9,0,23,25,-2,Buffalo Bills,11
2013-12-22,New Orleans Saints,Carolina Panthers,13,17,2013,16,domingo,Regular Season,10-5,10,5,0,6,5,1,11-4,11,4,0,3,4,-1,Carolina Panthers,1
2013-12-22,Dallas Cowboys,Washington Redskins,24,23,2013,16,domingo,Regular Season,8-7,8,7,0,15,18,-3,3-12,3,12,0,31,31,0,Dallas Cowboys,13
2013-12-22,Tampa Bay Buccaneers,Los Angeles Rams,13,23,2013,16,domingo,Regular Season,4-11,4,11,0,26,24,2,7-8,7,8,0,19,20,-1,Los Angeles Rams,4
2013-12-22,Chicago Bears,Philadelphia Eagles,11,54,2013,16,domingo,Regular Season,8-7,8,7,0,13,13,0,9-6,9,6,0,11,11,0,Philadelphia Eagles,2
2013-12-22,Cleveland Browns,New York Jets,13,24,2013,16,domingo,Regular Season,4-11,4,11,0,28,27,1,7-8,7,8,0,22,22,0,New York Jets,5
2013-12-22,Indianapolis Colts,Kansas City Chiefs,23,7,2013,16,domingo,Regular Season,10-5,10,5,0,8,10,-2,11-4,11,4,0,10,6,4,Indianapolis Colts,4
2013-12-22,Minnesota Vikings,Cincinnati Bengals,14,42,2013,16,domingo,Regular Season,4-10,4,10,0,25,23,2,10-5,10,5,0,7,9,-2,Cincinnati Bengals,14
2013-12-22,Denver Broncos,Houston Texans,37,13,2013,16,domingo,Regular Season,12-3,12,3,0,2,2,0,2-13,2,13,0,32,32,0,Denver Broncos,30
2013-12-22,Tennessee Titans,Jacksonville Jaguars,20,16,2013,16,domingo,Regular Season,6-9,6,9,0,21,21,0,4-11,4,11,0,29,29,0,Tennessee Titans,8
2013-12-22,Arizona Cardinals,Seattle Seahawks,17,10,2013,16,domingo,Regular Season,10-5,10,5,0,9,8,1,12-3,12,3,0,1,1,0,Arizona Cardinals,7
2013-12-22,New York Giants,Detroit Lions,23,20,2013,16,domingo,Regular Season,6-9,6,9,0,24,26,-2,7-8,7,8,0,20,17,3,New York Giants,9
2013-12-22,Oakland Raiders,Los Angeles Chargers,13,26,2013,16,domingo,Regular Season,4-11,4,11,0,30,30,0,8-7,8,7,0,12,15,-3,Los Angeles Chargers,15
2013-12-22,Pittsburgh Steelers,Green Bay Packers,38,31,2013,16,domingo,Regular Season,7-8,7,8,0,18,19,-1,7-7,7,7,0,17,16,1,Pittsburgh Steelers,3
2013-12-22,New England Patriots,Baltimore Ravens,41,7,2013,16,domingo,Regular Season,11-4,11,4,0,5,7,-2,8-7,8,7,0,14,12,2,New England Patriots,5
2013-12-16,Baltimore Ravens,Detroit Lions,18,16,2013,15,segunda,Regular Season,8-6,8,6,0,12,14,-2,7-7,7,7,0,17,12,5,Baltimore Ravens,2
2013-12-15,Washington Redskins,Atlanta Falcons,26,27,2013,15,domingo,Regular Season,3-11,3,11,0,31,31,0,4-10,4,10,0,28,30,-2,Atlanta Falcons,1
2013-12-15,San Francisco 49ers,Tampa Bay Buccaneers,33,14,2013,15,domingo,Regular Season,10-4,10,4,0,3,5,-2,4-10,4,10,0,24,24,0,San Francisco 49ers,19
2013-12-15,Arizona Cardinals,Tennessee Titans,37,34,2013,15,domingo,Regular Season,9-5,9,5,0,8,10,-2,5-9,5,9,0,21,22,-1,Arizona Cardinals,12
2013-12-15,New Orleans Saints,Los Angeles Rams,16,27,2013,15,domingo,Regular Season,10-4,10,4,0,5,3,2,6-8,6,8,0,20,20,0,Los Angeles Rams,17
2013-12-15,Seattle Seahawks,New York Giants,23,0,2013,15,domingo,Regular Season,12-2,12,2,0,1,1,0,5-9,5,9,0,26,23,3,Seattle Seahawks,22
2013-12-15,Chicago Bears,Cleveland Browns,38,31,2013,15,domingo,Regular Season,8-6,8,6,0,13,13,0,4-10,4,10,0,27,25,2,Chicago Bears,12
2013-12-15,Houston Texans,Indianapolis Colts,3,25,2013,15,domingo,Regular Season,2-12,2,12,0,32,32,0,9-5,9,5,0,10,11,-1,Indianapolis Colts,21
2013-12-15,Buffalo Bills,Jacksonville Jaguars,27,20,2013,15,domingo,Regular Season,5-9,5,9,0,25,26,-1,4-10,4,10,0,29,29,0,Buffalo Bills,3
2013-12-15,New England Patriots,Miami Dolphins,20,24,2013,15,domingo,Regular Season,10-4,10,4,0,7,4,3,8-6,8,6,0,14,16,-2,Miami Dolphins,12
2013-12-15,Philadelphia Eagles,Minnesota Vikings,30,48,2013,15,domingo,Regular Season,8-6,8,6,0,11,9,2,4-9,4,9,0,23,27,-4,Minnesota Vikings,18
2013-12-15,New York Jets,Carolina Panthers,20,30,2013,15,domingo,Regular Season,6-8,6,8,0,22,21,1,10-4,10,4,0,4,6,-2,Carolina Panthers,15
2013-12-15,Kansas City Chiefs,Oakland Raiders,56,31,2013,15,domingo,Regular Season,11-3,11,3,0,6,7,-1,4-10,4,10,0,30,28,2,Kansas City Chiefs,21
2013-12-15,Green Bay Packers,Dallas Cowboys,37,36,2013,15,domingo,Regular Season,7-6,7,6,0,16,18,-2,7-7,7,7,0,18,15,3,Green Bay Packers,3
2013-12-15,Cincinnati Bengals,Pittsburgh Steelers,20,30,2013,15,domingo,Regular Season,9-5,9,5,0,9,8,1,6-8,6,8,0,19,19,0,Pittsburgh Steelers,11
2013-12-12,Los Angeles Chargers,Denver Broncos,27,20,2013,15,quinta,Regular Season,7-7,7,7,0,15,17,-2,11-3,11,3,0,2,2,0,Los Angeles Chargers,15
2013-12-09,Dallas Cowboys,Chicago Bears,28,45,2013,14,segunda,Regular Season,7-6,7,6,0,15,11,4,7-6,7,6,0,13,15,-2,Chicago Bears,4
2013-12-08,Carolina Panthers,New Orleans Saints,13,31,2013,14,domingo,Regular Season,9-4,9,4,0,6,3,3,10-3,10,3,0,3,5,-2,New Orleans Saints,2
2013-12-08,Los Angeles Rams,Arizona Cardinals,10,30,2013,14,domingo,Regular Season,5-8,5,8,0,20,20,0,8-5,8,5,0,10,13,-3,Arizona Cardinals,7
2013-12-08,New York Giants,Los Angeles Chargers,14,37,2013,14,domingo,Regular Season,5-8,5,8,0,23,22,1,6-7,6,7,0,17,16,1,Los Angeles Chargers,6
2013-12-08,Seattle Seahawks,San Francisco 49ers,17,19,2013,14,domingo,Regular Season,11-2,11,2,0,1,1,0,9-4,9,4,0,5,6,-1,San Francisco 49ers,5
2013-12-08,Tennessee Titans,Denver Broncos,28,51,2013,14,domingo,Regular Season,5-8,5,8,0,22,21,1,11-2,11,2,0,2,2,0,Denver Broncos,19
2013-12-08,Minnesota Vikings,Baltimore Ravens,26,29,2013,14,domingo,Regular Season,3-9,3,9,0,27,28,-1,7-6,7,6,0,14,14,0,Baltimore Ravens,14
2013-12-08,Indianapolis Colts,Cincinnati Bengals,28,42,2013,14,domingo,Regular Season,8-5,8,5,0,11,9,2,9-4,9,4,0,8,8,0,Cincinnati Bengals,1
2013-12-08,Atlanta Falcons,Green Bay Packers,21,22,2013,14,domingo,Regular Season,3-10,3,10,0,30,29,1,6-6,6,6,0,18,19,-1,Green Bay Packers,10
2013-12-08,Cleveland Browns,New England Patriots,26,27,2013,14,domingo,Regular Season,4-9,4,9,0,25,27,-2,10-3,10,3,0,4,4,0,New England Patriots,23
2013-12-08,Oakland Raiders,New York Jets,27,37,2013,14,domingo,Regular Season,4-9,4,9,0,28,25,3,6-7,6,7,0,21,23,-2,New York Jets,2
2013-12-08,Detroit Lions,Philadelphia Eagles,20,34,2013,14,domingo,Regular Season,7-6,7,6,0,12,12,0,8-5,8,5,0,9,10,-1,Philadelphia Eagles,2
2013-12-08,Miami Dolphins,Pittsburgh Steelers,34,28,2013,14,domingo,Regular Season,7-6,7,6,0,16,17,-1,5-8,5,8,0,19,18,1,Miami Dolphins,1
2013-12-08,Buffalo Bills,Tampa Bay Buccaneers,6,27,2013,14,domingo,Regular Season,4-9,4,9,0,26,24,2,4-9,4,9,0,24,26,-2,Tampa Bay Buccaneers,2
2013-12-08,Kansas City Chiefs,Washington Redskins,45,10,2013,14,domingo,Regular Season,10-3,10,3,0,7,7,0,3-10,3,10,0,31,30,1,Kansas City Chiefs,23
2013-12-05,Houston Texans,Jacksonville Jaguars,20,27,2013,14,quinta,Regular Season,2-11,2,11,0,32,32,0,4-9,4,9,0,29,31,-2,Jacksonville Jaguars,1
2013-12-02,New Orleans Saints,Seattle Seahawks,7,34,2013,13,segunda,Regular Season,9-3,9,3,0,5,2,3,11-1,11,1,0,1,1,0,Seattle Seahawks,1
2013-12-01,Tennessee Titans,Indianapolis Colts,14,22,2013,13,domingo,Regular Season,5-7,5,7,0,21,20,1,8-4,8,4,0,9,10,-1,Indianapolis Colts,10
2013-12-01,Denver Broncos,Kansas City Chiefs,35,28,2013,13,domingo,Regular Season,10-2,10,2,0,2,3,-1,9-3,9,3,0,7,6,1,Denver Broncos,3
2013-12-01,Jacksonville Jaguars,Cleveland Browns,32,28,2013,13,domingo,Regular Season,3-9,3,9,0,31,31,0,4-8,4,8,0,27,25,2,Jacksonville Jaguars,6
2013-12-01,Tampa Bay Buccaneers,Carolina Panthers,6,27,2013,13,domingo,Regular Season,3-9,3,9,0,26,27,-1,9-3,9,3,0,3,5,-2,Carolina Panthers,22
2013-12-01,Chicago Bears,Minnesota Vikings,20,23,2013,13,domingo,Regular Season,6-6,6,6,0,15,14,1,3-8,3,8,0,28,28,0,Minnesota Vikings,14
2013-12-01,Arizona Cardinals,Philadelphia Eagles,21,24,2013,13,domingo,Regular Season,7-5,7,5,0,13,9,4,7-5,7,5,0,10,11,-1,Philadelphia Eagles,2
2013-12-01,Miami Dolphins,New York Jets,23,3,2013,13,domingo,Regular Season,6-6,6,6,0,17,21,-4,5-7,5,7,0,23,22,1,Miami Dolphins,1
2013-12-01,Atlanta Falcons,Buffalo Bills,34,31,2013,13,domingo,Regular Season,3-9,3,9,0,29,30,-1,4-8,4,8,0,24,24,0,Atlanta Falcons,6
2013-12-01,Los Angeles Rams,San Francisco 49ers,13,23,2013,13,domingo,Regular Season,5-7,5,7,0,20,19,1,8-4,8,4,0,6,7,-1,San Francisco 49ers,12
2013-12-01,New England Patriots,Houston Texans,34,31,2013,13,domingo,Regular Season,9-3,9,3,0,4,4,0,2-10,2,10,0,32,32,0,New England Patriots,28
2013-12-01,Cincinnati Bengals,Los Angeles Chargers,17,10,2013,13,domingo,Regular Season,8-4,8,4,0,8,8,0,5-7,5,7,0,16,15,1,Cincinnati Bengals,7
2013-12-01,New York Giants,Washington Redskins,24,17,2013,13,domingo,Regular Season,5-7,5,7,0,22,23,-1,3-9,3,9,0,30,29,1,New York Giants,6
2013-11-28,Pittsburgh Steelers,Baltimore Ravens,20,22,2013,13,quinta,Regular Season,5-7,5,7,0,18,16,2,6-6,6,6,0,14,18,-4,Baltimore Ravens,2
2013-11-28,Oakland Raiders,Dallas Cowboys,24,31,2013,13,quinta,Regular Season,4-8,4,8,0,25,26,-1,7-5,7,5,0,11,12,-1,Dallas Cowboys,14
2013-11-28,Green Bay Packers,Detroit Lions,10,40,2013,13,quinta,Regular Season,5-6,5,6,0,19,17,2,7-5,7,5,0,12,13,-1,Detroit Lions,4
2013-11-25,San Francisco 49ers,Washington Redskins,27,6,2013,12,segunda,Regular Season,7-4,7,4,0,7,9,-2,3-8,3,8,0,29,27,2,San Francisco 49ers,18
2013-11-24,Denver Broncos,New England Patriots,31,34,2013,12,domingo,Regular Season,9-2,9,2,0,3,1,2,8-3,8,3,0,4,6,-2,New England Patriots,5
2013-11-24,Dallas Cowboys,New York Giants,24,21,2013,12,domingo,Regular Season,6-5,6,5,0,12,14,-2,4-7,4,7,0,23,22,1,Dallas Cowboys,8
2013-11-24,Indianapolis Colts,Arizona Cardinals,11,40,2013,12,domingo,Regular Season,7-4,7,4,0,10,7,3,7-4,7,4,0,9,13,-4,Arizona Cardinals,6
2013-11-24,Tennessee Titans,Oakland Raiders,23,19,2013,12,domingo,Regular Season,5-6,5,6,0,20,24,-4,4-7,4,7,0,26,26,0,Tennessee Titans,2
2013-11-24,New York Jets,Baltimore Ravens,3,19,2013,12,domingo,Regular Season,5-6,5,6,0,22,16,6,5-6,5,6,0,18,20,-2,Baltimore Ravens,4
2013-11-24,Pittsburgh Steelers,Cleveland Browns,27,11,2013,12,domingo,Regular Season,5-6,5,6,0,16,19,-3,4-7,4,7,0,25,23,2,Pittsburgh Steelers,4
2013-11-24,Tampa Bay Buccaneers,Detroit Lions,24,21,2013,12,domingo,Regular Season,3-8,3,8,0,27,28,-1,6-5,6,5,0,13,11,2,Tampa Bay Buccaneers,17
2013-11-24,Minnesota Vikings,Green Bay Packers,26,26,2013,12,domingo,Regular Season,2-8,2,8,0,28,31,-3,5-5,5,5,0,17,15,2,Draw,16
2013-11-24,Jacksonville Jaguars,Houston Texans,13,6,2013,12,domingo,Regular Season,2-9,2,9,0,31,32,-1,2-9,2,9,0,32,29,3,Jacksonville Jaguars,3
2013-11-24,Los Angeles Chargers,Kansas City Chiefs,41,38,2013,12,domingo,Regular Season,5-6,5,6,0,15,18,-3,9-2,9,2,0,6,3,3,Los Angeles Chargers,15
2013-11-24,Carolina Panthers,Miami Dolphins,20,16,2013,12,domingo,Regular Season,8-3,8,3,0,5,5,0,5-6,5,6,0,21,17,4,Carolina Panthers,12
2013-11-24,Chicago Bears,Los Angeles Rams,21,42,2013,12,domingo,Regular Season,6-5,6,5,0,14,10,4,5-6,5,6,0,19,21,-2,Los Angeles Rams,11
2013-11-21,New Orleans Saints,Atlanta Falcons,17,13,2013,12,quinta,Regular Season,9-2,9,2,0,2,4,-2,2-9,2,9,0,30,30,0,New Orleans Saints,26
2013-11-18,New England Patriots,Carolina Panthers,20,24,2013,11,segunda,Regular Season,7-3,7,3,0,6,5,1,7-3,7,3,0,5,6,-1,Carolina Panthers,1
2013-11-17,Atlanta Falcons,Tampa Bay Buccaneers,28,41,2013,11,domingo,Regular Season,2-8,2,8,0,30,29,1,2-8,2,8,0,28,31,-3,Tampa Bay Buccaneers,2
2013-11-17,New York Jets,Buffalo Bills,14,37,2013,11,domingo,Regular Season,5-5,5,5,0,16,12,4,4-7,4,7,0,25,26,-1,Buffalo Bills,14
2013-11-17,Detroit Lions,Pittsburgh Steelers,27,37,2013,11,domingo,Regular Season,6-4,6,4,0,11,9,2,4-6,4,6,0,19,24,-5,Pittsburgh Steelers,15
2013-11-17,Washington Redskins,Philadelphia Eagles,16,24,2013,11,domingo,Regular Season,3-7,3,7,0,27,23,4,6-5,6,5,0,12,14,-2,Philadelphia Eagles,9
2013-11-17,Los Angeles Chargers,Miami Dolphins,16,20,2013,11,domingo,Regular Season,4-6,4,6,0,18,17,1,5-5,5,5,0,17,22,-5,Miami Dolphins,5
2013-11-17,Baltimore Ravens,Chicago Bears,20,23,2013,11,domingo,Regular Season,4-6,4,6,0,20,18,2,6-4,6,4,0,10,11,-1,Chicago Bears,7
2013-11-17,Cleveland Browns,Cincinnati Bengals,20,41,2013,11,domingo,Regular Season,4-6,4,6,0,23,19,4,7-4,7,4,0,8,10,-2,Cincinnati Bengals,9
2013-11-17,Oakland Raiders,Houston Texans,28,23,2013,11,domingo,Regular Season,4-6,4,6,0,26,27,-1,2-8,2,8,0,29,28,1,Oakland Raiders,1
2013-11-17,Arizona Cardinals,Jacksonville Jaguars,27,14,2013,11,domingo,Regular Season,6-4,6,4,0,13,16,-3,1-9,1,9,0,32,32,0,Arizona Cardinals,16
2013-11-17,Kansas City Chiefs,Denver Broncos,17,27,2013,11,domingo,Regular Season,9-1,9,1,0,3,1,2,9-1,9,1,0,1,2,-1,Denver Broncos,1
2013-11-17,Minnesota Vikings,Seattle Seahawks,20,41,2013,11,domingo,Regular Season,2-8,2,8,0,31,30,1,10-1,10,1,0,2,3,-1,Seattle Seahawks,27
2013-11-17,San Francisco 49ers,New Orleans Saints,20,23,2013,11,domingo,Regular Season,6-4,6,4,0,9,8,1,8-2,8,2,0,4,4,0,New Orleans Saints,4
2013-11-17,Green Bay Packers,New York Giants,13,27,2013,11,domingo,Regular Season,5-5,5,5,0,15,13,2,4-6,4,6,0,22,25,-3,New York Giants,12
2013-11-14,Indianapolis Colts,Tennessee Titans,30,27,2013,11,quinta,Regular Season,7-3,7,3,0,7,7,0,4-6,4,6,0,24,21,3,Indianapolis Colts,14
2013-11-11,Miami Dolphins,Tampa Bay Buccaneers,19,22,2013,10,segunda,Regular Season,4-5,4,5,0,22,19,3,1-8,1,8,0,31,31,0,Tampa Bay Buccaneers,12
2013-11-10,Jacksonville Jaguars,Tennessee Titans,29,27,2013,10,domingo,Regular Season,1-8,1,8,0,32,32,0,4-5,4,5,0,21,16,5,Jacksonville Jaguars,16
2013-11-10,Philadelphia Eagles,Green Bay Packers,27,13,2013,10,domingo,Regular Season,5-5,5,5,0,14,20,-6,5-4,5,4,0,13,11,2,Philadelphia Eagles,9
2013-11-10,Buffalo Bills,Pittsburgh Steelers,10,23,2013,10,domingo,Regular Season,3-7,3,7,0,26,23,3,3-6,3,6,0,24,27,-3,Pittsburgh Steelers,4
2013-11-10,Oakland Raiders,New York Giants,20,24,2013,10,domingo,Regular Season,3-6,3,6,0,27,24,3,3-6,3,6,0,25,29,-4,New York Giants,5
2013-11-10,Los Angeles Rams,Indianapolis Colts,38,8,2013,10,domingo,Regular Season,4-6,4,6,0,20,25,-5,6-3,6,3,0,7,2,5,Los Angeles Rams,23
2013-11-10,Seattle Seahawks,Atlanta Falcons,33,10,2013,10,domingo,Regular Season,9-1,9,1,0,3,4,-1,2-7,2,7,0,29,26,3,Seattle Seahawks,22
2013-11-10,Cincinnati Bengals,Baltimore Ravens,17,20,2013,10,domingo,Regular Season,6-4,6,4,0,10,8,2,4-5,4,5,0,18,21,-3,Baltimore Ravens,13
2013-11-10,Detroit Lions,Chicago Bears,21,19,2013,10,domingo,Regular Season,6-3,6,3,0,9,10,-1,5-4,5,4,0,11,9,2,Detroit Lions,1
2013-11-10,Carolina Panthers,San Francisco 49ers,10,9,2013,10,domingo,Regular Season,6-3,6,3,0,6,12,-6,6-3,6,3,0,8,5,3,Carolina Panthers,7
2013-11-10,Houston Texans,Arizona Cardinals,24,27,2013,10,domingo,Regular Season,2-7,2,7,0,28,28,0,5-4,5,4,0,16,17,-1,Arizona Cardinals,11
2013-11-10,Denver Broncos,Los Angeles Chargers,28,20,2013,10,domingo,Regular Season,8-1,8,1,0,2,3,-1,4-5,4,5,0,17,15,2,Denver Broncos,12
2013-11-10,Dallas Cowboys,New Orleans Saints,17,49,2013,10,domingo,Regular Season,5-5,5,5,0,15,13,2,7-2,7,2,0,4,6,-2,New Orleans Saints,7
2013-11-07,Washington Redskins,Minnesota Vikings,27,34,2013,10,quinta,Regular Season,3-6,3,6,0,23,22,1,2-7,2,7,0,30,30,0,Minnesota Vikings,8
2013-11-04,Chicago Bears,Green Bay Packers,27,20,2013,9,segunda,Regular Season,5-3,5,3,0,9,14,-5,5-3,5,3,0,11,8,3,Chicago Bears,6
2013-11-03,Atlanta Falcons,Carolina Panthers,10,34,2013,9,domingo,Regular Season,2-6,2,6,0,26,23,3,5-3,5,3,0,12,12,0,Carolina Panthers,11
2013-11-03,Minnesota Vikings,Dallas Cowboys,23,27,2013,9,domingo,Regular Season,1-7,1,7,0,30,30,0,5-4,5,4,0,13,13,0,Dallas Cowboys,17
2013-11-03,New Orleans Saints,New York Jets,20,26,2013,9,domingo,Regular Season,6-2,6,2,0,6,5,1,5-4,5,4,0,14,16,-2,New York Jets,11
2013-11-03,Tennessee Titans,Los Angeles Rams,28,21,2013,9,domingo,Regular Season,4-4,4,4,0,16,18,-2,3-6,3,6,0,25,25,0,Tennessee Titans,7
2013-11-03,Kansas City Chiefs,Buffalo Bills,23,13,2013,9,domingo,Regular Season,9-0,9,0,0,1,1,0,3-6,3,6,0,23,20,3,Kansas City Chiefs,19
2013-11-03,Los Angeles Chargers,Washington Redskins,24,30,2013,9,domingo,Regular Season,4-4,4,4,0,15,11,4,3-5,3,5,0,22,24,-2,Washington Redskins,13
2013-11-03,Philadelphia Eagles,Oakland Raiders,49,20,2013,9,domingo,Regular Season,4-5,4,5,0,20,26,-6,3-5,3,5,0,24,22,2,Philadelphia Eagles,4
2013-11-03,Tampa Bay Buccaneers,Seattle Seahawks,24,27,2013,9,domingo,Regular Season,0-8,0,8,0,31,31,0,8-1,8,1,0,4,4,0,Seattle Seahawks,27
2013-11-03,Baltimore Ravens,Cleveland Browns,18,24,2013,9,domingo,Regular Season,3-5,3,5,0,21,15,6,4-5,4,5,0,18,21,-3,Cleveland Browns,6
2013-11-03,Pittsburgh Steelers,New England Patriots,31,55,2013,9,domingo,Regular Season,2-6,2,6,0,27,27,0,7-2,7,2,0,7,9,-2,New England Patriots,18
2013-11-03,Indianapolis Colts,Houston Texans,27,24,2013,9,domingo,Regular Season,6-2,6,2,0,2,3,-1,2-6,2,6,0,28,28,0,Indianapolis Colts,25
2013-10-31,Cincinnati Bengals,Miami Dolphins,20,22,2013,9,quinta,Regular Season,6-3,6,3,0,8,7,1,4-4,4,4,0,19,19,0,Miami Dolphins,12
2013-10-28,Seattle Seahawks,Los Angeles Rams,14,9,2013,8,segunda,Regular Season,7-1,7,1,0,4,4,0,3-5,3,5,0,25,27,-2,Seattle Seahawks,23
2013-10-27,San Francisco 49ers,Jacksonville Jaguars,42,10,2013,8,domingo,Regular Season,6-2,6,2,0,6,6,0,0-8,0,8,0,32,32,0,San Francisco 49ers,26
2013-10-27,Dallas Cowboys,Detroit Lions,30,31,2013,8,domingo,Regular Season,4-4,4,4,0,13,10,3,5-3,5,3,0,10,11,-1,Detroit Lions,1
2013-10-27,New York Giants,Philadelphia Eagles,15,7,2013,8,domingo,Regular Season,2-6,2,6,0,29,29,0,3-5,3,5,0,26,19,7,New York Giants,10
2013-10-27,Cleveland Browns,Kansas City Chiefs,17,23,2013,8,domingo,Regular Season,3-5,3,5,0,21,22,-1,8-0,8,0,0,1,1,0,Kansas City Chiefs,21
2013-10-27,Buffalo Bills,New Orleans Saints,17,35,2013,8,domingo,Regular Season,3-5,3,5,0,20,21,-1,6-1,6,1,0,5,5,0,New Orleans Saints,16
2013-10-27,Miami Dolphins,New England Patriots,17,27,2013,8,domingo,Regular Season,3-4,3,4,0,19,16,3,6-2,6,2,0,9,8,1,New England Patriots,8
2013-10-27,New York Jets,Cincinnati Bengals,9,49,2013,8,domingo,Regular Season,4-4,4,4,0,16,15,1,6-2,6,2,0,7,7,0,Cincinnati Bengals,8
2013-10-27,Pittsburgh Steelers,Oakland Raiders,18,21,2013,8,domingo,Regular Season,2-5,2,5,0,27,25,2,3-4,3,4,0,22,28,-6,Oakland Raiders,3
2013-10-27,Washington Redskins,Denver Broncos,21,45,2013,8,domingo,Regular Season,2-5,2,5,0,24,23,1,7-1,7,1,0,2,3,-1,Denver Broncos,20
2013-10-27,Atlanta Falcons,Arizona Cardinals,13,27,2013,8,domingo,Regular Season,2-5,2,5,0,23,20,3,4-4,4,4,0,17,24,-7,Arizona Cardinals,4
2013-10-27,Green Bay Packers,Minnesota Vikings,44,31,2013,8,domingo,Regular Season,5-2,5,2,0,8,9,-1,1-6,1,6,0,30,30,0,Green Bay Packers,21
2013-10-24,Carolina Panthers,Tampa Bay Buccaneers,31,13,2013,8,quinta,Regular Season,4-3,4,3,0,12,18,-6,0-7,0,7,0,31,31,0,Carolina Panthers,13
2013-10-21,Minnesota Vikings,New York Giants,7,23,2013,7,segunda,Regular Season,1-5,1,5,0,30,29,1,1-6,1,6,0,29,31,-2,New York Giants,2
2013-10-20,New England Patriots,New York Jets,27,30,2013,7,domingo,Regular Season,5-2,5,2,0,8,5,3,4-3,4,3,0,15,20,-5,New York Jets,15
2013-10-20,Los Angeles Chargers,Jacksonville Jaguars,24,6,2013,7,domingo,Regular Season,4-3,4,3,0,12,15,-3,0-7,0,7,0,32,32,0,Los Angeles Chargers,17
2013-10-20,Houston Texans,Kansas City Chiefs,16,17,2013,7,domingo,Regular Season,2-5,2,5,0,26,22,4,7-0,7,0,0,1,2,-1,Kansas City Chiefs,20
2013-10-20,Cincinnati Bengals,Detroit Lions,27,24,2013,7,domingo,Regular Season,5-2,5,2,0,7,8,-1,4-3,4,3,0,11,11,0,Cincinnati Bengals,3
2013-10-20,Buffalo Bills,Miami Dolphins,23,21,2013,7,domingo,Regular Season,3-4,3,4,0,21,25,-4,3-3,3,3,0,16,14,2,Buffalo Bills,11
2013-10-20,Chicago Bears,Washington Redskins,41,45,2013,7,domingo,Regular Season,4-3,4,3,0,13,10,3,2-4,2,4,0,23,28,-5,Washington Redskins,18
2013-10-20,Dallas Cowboys,Philadelphia Eagles,17,3,2013,7,domingo,Regular Season,4-3,4,3,0,10,13,-3,3-4,3,4,0,19,17,2,Dallas Cowboys,4
2013-10-20,Los Angeles Rams,Carolina Panthers,15,30,2013,7,domingo,Regular Season,3-4,3,4,0,27,19,8,3-3,3,3,0,18,24,-6,Carolina Panthers,5
2013-10-20,Tampa Bay Buccaneers,Atlanta Falcons,23,31,2013,7,domingo,Regular Season,0-6,0,6,0,31,30,1,2-4,2,4,0,20,23,-3,Atlanta Falcons,7
2013-10-20,San Francisco 49ers,Tennessee Titans,31,17,2013,7,domingo,Regular Season,5-2,5,2,0,6,7,-1,3-4,3,4,0,17,16,1,San Francisco 49ers,9
2013-10-20,Cleveland Browns,Green Bay Packers,13,31,2013,7,domingo,Regular Season,3-4,3,4,0,22,18,4,4-2,4,2,0,9,9,0,Green Bay Packers,9
2013-10-20,Baltimore Ravens,Pittsburgh Steelers,16,19,2013,7,domingo,Regular Season,3-4,3,4,0,14,12,2,2-4,2,4,0,25,27,-2,Pittsburgh Steelers,15
2013-10-20,Denver Broncos,Indianapolis Colts,33,39,2013,7,domingo,Regular Season,6-1,6,1,0,3,1,2,5-2,5,2,0,2,6,-4,Indianapolis Colts,5
2013-10-17,Seattle Seahawks,Arizona Cardinals,34,22,2013,7,quinta,Regular Season,6-1,6,1,0,4,4,0,3-4,3,4,0,24,21,3,Seattle Seahawks,17
2013-10-14,Indianapolis Colts,Los Angeles Chargers,9,19,2013,6,segunda,Regular Season,4-2,4,2,0,6,4,2,3-3,3,3,0,15,20,-5,Los Angeles Chargers,16
2013-10-13,Oakland Raiders,Kansas City Chiefs,7,24,2013,6,domingo,Regular Season,2-4,2,4,0,26,24,2,6-0,6,0,0,2,3,-1,Kansas City Chiefs,21
2013-10-13,Philadelphia Eagles,Tampa Bay Buccaneers,31,20,2013,6,domingo,Regular Season,3-3,3,3,0,17,21,-4,0-5,0,5,0,30,30,0,Philadelphia Eagles,9
2013-10-13,Green Bay Packers,Baltimore Ravens,19,17,2013,6,domingo,Regular Season,3-2,3,2,0,9,11,-2,3-3,3,3,0,12,9,3,Green Bay Packers,2
2013-10-13,Detroit Lions,Cleveland Browns,31,17,2013,6,domingo,Regular Season,4-2,4,2,0,11,12,-1,3-3,3,3,0,18,16,2,Detroit Lions,4
2013-10-13,Carolina Panthers,Minnesota Vikings,35,10,2013,6,domingo,Regular Season,2-3,2,3,0,24,26,-2,1-4,1,4,0,29,28,1,Carolina Panthers,2
2013-10-13,Los Angeles Rams,Houston Texans,38,13,2013,6,domingo,Regular Season,3-3,3,3,0,19,25,-6,2-4,2,4,0,22,17,5,Los Angeles Rams,8
2013-10-13,Pittsburgh Steelers,New York Jets,19,6,2013,6,domingo,Regular Season,1-4,1,4,0,27,29,-2,3-3,3,3,0,20,18,2,Pittsburgh Steelers,11
2013-10-13,Cincinnati Bengals,Buffalo Bills,27,24,2013,6,domingo,Regular Season,4-2,4,2,0,8,8,0,2-4,2,4,0,25,23,2,Cincinnati Bengals,15
2013-10-13,Tennessee Titans,Seattle Seahawks,13,20,2013,6,domingo,Regular Season,3-3,3,3,0,16,14,2,5-1,5,1,0,4,5,-1,Seattle Seahawks,9
2013-10-13,Jacksonville Jaguars,Denver Broncos,19,35,2013,6,domingo,Regular Season,0-6,0,6,0,32,32,0,6-0,6,0,0,1,1,0,Denver Broncos,31
2013-10-13,Arizona Cardinals,San Francisco 49ers,20,32,2013,6,domingo,Regular Season,3-3,3,3,0,21,19,2,4-2,4,2,0,7,7,0,San Francisco 49ers,12
2013-10-13,New Orleans Saints,New England Patriots,27,30,2013,6,domingo,Regular Season,5-1,5,1,0,3,2,1,5-1,5,1,0,5,6,-1,New England Patriots,4
2013-10-13,Washington Redskins,Dallas Cowboys,16,31,2013,6,domingo,Regular Season,1-4,1,4,0,28,27,1,3-3,3,3,0,13,15,-2,Dallas Cowboys,12
2013-10-10,New York Giants,Chicago Bears,21,27,2013,6,quinta,Regular Season,0-6,0,6,0,31,31,0,4-2,4,2,0,10,10,0,Chicago Bears,21
2013-10-07,New York Jets,Atlanta Falcons,30,28,2013,5,segunda,Regular Season,3-2,3,2,0,18,22,-4,1-4,1,4,0,22,16,6,New York Jets,6
2013-10-06,Kansas City Chiefs,Tennessee Titans,26,17,2013,5,domingo,Regular Season,5-0,5,0,0,3,5,-2,3-2,3,2,0,14,13,1,Kansas City Chiefs,8
2013-10-06,Baltimore Ravens,Miami Dolphins,26,23,2013,5,domingo,Regular Season,3-2,3,2,0,9,14,-5,3-2,3,2,0,13,7,6,Baltimore Ravens,7
2013-10-06,Jacksonville Jaguars,Los Angeles Rams,20,34,2013,5,domingo,Regular Season,0-5,0,5,0,32,32,0,2-3,2,3,0,25,26,-1,Los Angeles Rams,6
2013-10-06,New England Patriots,Cincinnati Bengals,6,13,2013,5,domingo,Regular Season,4-1,4,1,0,6,4,2,3-2,3,2,0,8,11,-3,Cincinnati Bengals,7
2013-10-06,Seattle Seahawks,Indianapolis Colts,28,34,2013,5,domingo,Regular Season,4-1,4,1,0,5,2,3,4-1,4,1,0,4,6,-2,Indianapolis Colts,4
2013-10-06,Detroit Lions,Green Bay Packers,9,22,2013,5,domingo,Regular Season,3-2,3,2,0,12,10,2,2-2,2,2,0,11,12,-1,Green Bay Packers,2
2013-10-06,New Orleans Saints,Chicago Bears,26,18,2013,5,domingo,Regular Season,5-0,5,0,0,2,3,-1,3-2,3,2,0,10,9,1,New Orleans Saints,6
2013-10-06,Philadelphia Eagles,New York Giants,36,21,2013,5,domingo,Regular Season,2-3,2,3,0,21,27,-6,0-5,0,5,0,31,30,1,Philadelphia Eagles,3
2013-10-06,Carolina Panthers,Arizona Cardinals,6,22,2013,5,domingo,Regular Season,1-3,1,3,0,26,21,5,3-2,3,2,0,19,19,0,Arizona Cardinals,2
2013-10-06,Los Angeles Chargers,Oakland Raiders,17,27,2013,5,domingo,Regular Season,2-3,2,3,0,20,17,3,2-3,2,3,0,24,28,-4,Oakland Raiders,11
2013-10-06,Denver Broncos,Dallas Cowboys,51,48,2013,5,domingo,Regular Season,5-0,5,0,0,1,1,0,2-3,2,3,0,15,18,-3,Denver Broncos,17
2013-10-06,Houston Texans,San Francisco 49ers,3,34,2013,5,domingo,Regular Season,2-3,2,3,0,17,15,2,3-2,3,2,0,7,8,-1,San Francisco 49ers,7
2013-10-03,Buffalo Bills,Cleveland Browns,24,37,2013,5,quinta,Regular Season,2-3,2,3,0,23,23,0,3-2,3,2,0,16,20,-4,Cleveland Browns,3
2013-09-30,Miami Dolphins,New Orleans Saints,17,38,2013,4,segunda,Regular Season,3-1,3,1,0,7,7,0,4-0,4,0,0,3,3,0,New Orleans Saints,4
2013-09-29,Pittsburgh Steelers,Minnesota Vikings,27,34,2013,4,domingo,Regular Season,0-4,0,4,0,29,28,1,1-3,1,3,0,24,26,-2,Minnesota Vikings,2
2013-09-29,Baltimore Ravens,Buffalo Bills,20,23,2013,4,domingo,Regular Season,2-2,2,2,0,14,11,3,2-2,2,2,0,23,24,-1,Buffalo Bills,13
2013-09-29,Cincinnati Bengals,Cleveland Browns,6,17,2013,4,domingo,Regular Season,2-2,2,2,0,11,6,5,2-2,2,2,0,20,25,-5,Cleveland Browns,19
2013-09-29,Indianapolis Colts,Jacksonville Jaguars,37,3,2013,4,domingo,Regular Season,3-1,3,1,0,6,9,-3,0-4,0,4,0,32,32,0,Indianapolis Colts,23
2013-09-29,Seattle Seahawks,Houston Texans,23,20,2013,4,domingo,Regular Season,4-0,4,0,0,2,1,1,2-2,2,2,0,15,13,2,Seattle Seahawks,12
2013-09-29,Arizona Cardinals,Tampa Bay Buccaneers,13,10,2013,4,domingo,Regular Season,2-2,2,2,0,19,22,-3,0-4,0,4,0,31,31,0,Arizona Cardinals,9
2013-09-29,Chicago Bears,Detroit Lions,32,40,2013,4,domingo,Regular Season,3-1,3,1,0,9,4,5,3-1,3,1,0,10,16,-6,Detroit Lions,12
2013-09-29,New York Giants,Kansas City Chiefs,7,31,2013,4,domingo,Regular Season,0-4,0,4,0,30,29,1,4-0,4,0,0,5,8,-3,Kansas City Chiefs,21
2013-09-29,New York Jets,Tennessee Titans,13,38,2013,4,domingo,Regular Season,2-2,2,2,0,22,18,4,3-1,3,1,0,13,17,-4,Tennessee Titans,1
2013-09-29,Dallas Cowboys,Los Angeles Chargers,21,30,2013,4,domingo,Regular Season,2-2,2,2,0,18,15,3,2-2,2,2,0,17,19,-2,Los Angeles Chargers,4
2013-09-29,Washington Redskins,Oakland Raiders,24,14,2013,4,domingo,Regular Season,1-3,1,3,0,25,27,-2,1-3,1,3,0,28,30,-2,Washington Redskins,3
2013-09-29,Philadelphia Eagles,Denver Broncos,20,52,2013,4,domingo,Regular Season,1-3,1,3,0,27,23,4,4-0,4,0,0,1,2,-1,Denver Broncos,21
2013-09-29,New England Patriots,Atlanta Falcons,30,23,2013,4,domingo,Regular Season,4-0,4,0,0,4,5,-1,1-3,1,3,0,16,14,2,New England Patriots,9
2013-09-26,San Francisco 49ers,Los Angeles Rams,35,11,2013,4,quinta,Regular Season,2-2,2,2,0,8,10,-2,1-3,1,3,0,26,20,6,San Francisco 49ers,10
2013-09-23,Oakland Raiders,Denver Broncos,21,37,2013,3,segunda,Regular Season,1-2,1,2,0,30,29,1,3-0,3,0,0,2,2,0,Denver Broncos,27
2013-09-22,Los Angeles Chargers,Tennessee Titans,17,20,2013,3,domingo,Regular Season,1-2,1,2,0,19,16,3,2-1,2,1,0,17,22,-5,Tennessee Titans,6
2013-09-22,Cleveland Browns,Minnesota Vikings,31,27,2013,3,domingo,Regular Season,1-2,1,2,0,25,31,-6,0-3,0,3,0,26,23,3,Cleveland Browns,8
2013-09-22,Tampa Bay Buccaneers,New England Patriots,3,23,2013,3,domingo,Regular Season,0-3,0,3,0,31,30,1,3-0,3,0,0,5,7,-2,New England Patriots,23
2013-09-22,Houston Texans,Baltimore Ravens,9,30,2013,3,domingo,Regular Season,2-1,2,1,0,13,4,9,2-1,2,1,0,11,11,0,Baltimore Ravens,7
2013-09-22,Los Angeles Rams,Dallas Cowboys,7,31,2013,3,domingo,Regular Season,1-2,1,2,0,20,17,3,2-1,2,1,0,15,15,0,Dallas Cowboys,2
2013-09-22,Arizona Cardinals,New Orleans Saints,7,31,2013,3,domingo,Regular Season,1-2,1,2,0,22,21,1,3-0,3,0,0,3,8,-5,New Orleans Saints,13
2013-09-22,Detroit Lions,Washington Redskins,27,20,2013,3,domingo,Regular Season,2-1,2,1,0,16,18,-2,0-3,0,3,0,27,24,3,Detroit Lions,6
2013-09-22,Green Bay Packers,Cincinnati Bengals,30,34,2013,3,domingo,Regular Season,1-2,1,2,0,12,5,7,2-1,2,1,0,6,10,-4,Cincinnati Bengals,5
2013-09-22,New York Giants,Carolina Panthers,0,38,2013,3,domingo,Regular Season,0-3,0,3,0,29,20,9,1-2,1,2,0,21,27,-6,Carolina Panthers,7
2013-09-22,Atlanta Falcons,Miami Dolphins,23,27,2013,3,domingo,Regular Season,1-2,1,2,0,14,6,8,3-0,3,0,0,7,12,-5,Miami Dolphins,6
2013-09-22,Indianapolis Colts,San Francisco 49ers,27,7,2013,3,domingo,Regular Season,2-1,2,1,0,9,14,-5,1-2,1,2,0,10,3,7,Indianapolis Colts,11
2013-09-22,Jacksonville Jaguars,Seattle Seahawks,17,45,2013,3,domingo,Regular Season,0-3,0,3,0,32,32,0,3-0,3,0,0,1,1,0,Seattle Seahawks,31
2013-09-22,Buffalo Bills,New York Jets,20,27,2013,3,domingo,Regular Season,1-2,1,2,0,24,26,-2,2-1,2,1,0,18,28,-10,New York Jets,2
2013-09-22,Chicago Bears,Pittsburgh Steelers,40,23,2013,3,domingo,Regular Season,3-0,3,0,0,4,9,-5,0-3,0,3,0,28,25,3,Chicago Bears,16
2013-09-19,Kansas City Chiefs,Philadelphia Eagles,26,16,2013,3,quinta,Regular Season,3-0,3,0,0,8,13,-5,1-2,1,2,0,23,19,4,Kansas City Chiefs,6
2013-09-16,Pittsburgh Steelers,Cincinnati Bengals,10,20,2013,2,segunda,Regular Season,0-2,0,2,0,25,23,2,1-1,1,1,0,10,10,0,Cincinnati Bengals,13
2013-09-15,Detroit Lions,Arizona Cardinals,21,25,2013,2,domingo,Regular Season,1-1,1,1,0,18,18,0,1-1,1,1,0,21,25,-4,Arizona Cardinals,7
2013-09-15,Los Angeles Rams,Atlanta Falcons,24,31,2013,2,domingo,Regular Season,1-1,1,1,0,17,15,2,1-1,1,1,0,6,4,2,Atlanta Falcons,11
2013-09-15,Cleveland Browns,Baltimore Ravens,6,14,2013,2,domingo,Regular Season,0-2,0,2,0,31,30,1,1-1,1,1,0,11,11,0,Baltimore Ravens,19
2013-09-15,Carolina Panthers,Buffalo Bills,23,24,2013,2,domingo,Regular Season,0-2,0,2,0,27,24,3,1-1,1,1,0,26,29,-3,Buffalo Bills,5
2013-09-15,Minnesota Vikings,Chicago Bears,30,31,2013,2,domingo,Regular Season,0-2,0,2,0,23,21,2,2-0,2,0,0,9,9,0,Chicago Bears,12
2013-09-15,Washington Redskins,Green Bay Packers,20,38,2013,2,domingo,Regular Season,0-2,0,2,0,24,19,5,1-1,1,1,0,5,7,-2,Green Bay Packers,12
2013-09-15,Tennessee Titans,Houston Texans,24,30,2013,2,domingo,Regular Season,1-1,1,1,0,22,22,0,2-0,2,0,0,4,6,-2,Houston Texans,16
2013-09-15,Miami Dolphins,Indianapolis Colts,24,20,2013,2,domingo,Regular Season,2-0,2,0,0,12,17,-5,1-1,1,1,0,14,12,2,Miami Dolphins,5
2013-09-15,Dallas Cowboys,Kansas City Chiefs,16,17,2013,2,domingo,Regular Season,1-1,1,1,0,15,13,2,2-0,2,0,0,13,20,-7,Kansas City Chiefs,7
2013-09-15,Denver Broncos,New York Giants,41,23,2013,2,domingo,Regular Season,2-0,2,0,0,2,3,-1,0-2,0,2,0,20,16,4,Denver Broncos,13
2013-09-15,Jacksonville Jaguars,Oakland Raiders,9,19,2013,2,domingo,Regular Season,0-2,0,2,0,32,32,0,1-1,1,1,0,29,31,-2,Oakland Raiders,1
2013-09-15,Los Angeles Chargers,Philadelphia Eagles,33,30,2013,2,domingo,Regular Season,1-1,1,1,0,16,26,-10,1-1,1,1,0,19,14,5,Los Angeles Chargers,12
2013-09-15,San Francisco 49ers,Seattle Seahawks,3,29,2013,2,domingo,Regular Season,1-1,1,1,0,3,1,2,2-0,2,0,0,1,2,-1,Seattle Seahawks,1
2013-09-15,New Orleans Saints,Tampa Bay Buccaneers,16,14,2013,2,domingo,Regular Season,2-0,2,0,0,8,8,0,0-2,0,2,0,30,28,2,New Orleans Saints,20
2013-09-12,New York Jets,New England Patriots,10,13,2013,2,quinta,Regular Season,1-1,1,1,0,28,27,1,2-0,2,0,0,7,5,2,New England Patriots,22
2013-09-09,Houston Texans,Los Angeles Chargers,31,28,2013,1,segunda,Regular Season,1-0,1,0,0,6,7,-1,0-1,0,1,0,26,24,2,Houston Texans,17
2013-09-09,Philadelphia Eagles,Washington Redskins,33,27,2013,1,segunda,Regular Season,1-0,1,0,0,14,25,-11,0-1,0,1,0,19,10,9,Philadelphia Eagles,15
2013-09-08,New England Patriots,Buffalo Bills,23,21,2013,1,domingo,Regular Season,1-0,1,0,0,5,6,-1,0-1,0,1,0,29,30,-1,New England Patriots,24
2013-09-08,Seattle Seahawks,Carolina Panthers,12,7,2013,1,domingo,Regular Season,1-0,1,0,0,2,1,1,0-1,0,1,0,24,23,1,Seattle Seahawks,22
2013-09-08,Cincinnati Bengals,Chicago Bears,21,24,2013,1,domingo,Regular Season,0-1,0,1,0,10,9,1,1-0,1,0,0,9,14,-5,Chicago Bears,5
2013-09-08,Miami Dolphins,Cleveland Browns,23,10,2013,1,domingo,Regular Season,1-0,1,0,0,17,20,-3,0-1,0,1,0,30,28,2,Miami Dolphins,8
2013-09-08,New York Giants,Dallas Cowboys,31,36,2013,1,domingo,Regular Season,0-1,0,1,0,16,12,4,1-0,1,0,0,13,18,-5,Dallas Cowboys,6
2013-09-08,Minnesota Vikings,Detroit Lions,24,34,2013,1,domingo,Regular Season,0-1,0,1,0,21,17,4,1-0,1,0,0,18,21,-3,Detroit Lions,4
2013-09-08,Oakland Raiders,Indianapolis Colts,17,21,2013,1,domingo,Regular Season,0-1,0,1,0,31,31,0,1-0,1,0,0,12,11,1,Indianapolis Colts,20
2013-09-08,Kansas City Chiefs,Jacksonville Jaguars,28,2,2013,1,domingo,Regular Season,1-0,1,0,0,20,19,1,0-1,0,1,0,32,29,3,Kansas City Chiefs,10
2013-09-08,Atlanta Falcons,New Orleans Saints,17,23,2013,1,domingo,Regular Season,0-1,0,1,0,4,2,2,1-0,1,0,0,8,13,-5,New Orleans Saints,11
2013-09-08,Tampa Bay Buccaneers,New York Jets,17,18,2013,1,domingo,Regular Season,0-1,0,1,0,28,22,6,1-0,1,0,0,27,32,-5,New York Jets,10
2013-09-08,Tennessee Titans,Pittsburgh Steelers,16,9,2013,1,domingo,Regular Season,1-0,1,0,0,22,27,-5,0-1,0,1,0,23,16,7,Tennessee Titans,11
2013-09-08,Green Bay Packers,San Francisco 49ers,28,34,2013,1,domingo,Regular Season,0-1,0,1,0,7,5,2,1-0,1,0,0,1,3,-2,San Francisco 49ers,2
2013-09-08,Arizona Cardinals,Los Angeles Rams,24,27,2013,1,domingo,Regular Season,0-1,0,1,0,25,26,-1,1-0,1,0,0,15,15,0,Los Angeles Rams,11
2013-09-05,Baltimore Ravens,Denver Broncos,27,49,2013,1,quinta,Regular Season,0-1,0,1,0,11,8,3,1-0,1,0,0,3,4,-1,Denver Broncos,4
2012-12-30,Dallas Cowboys,Washington Redskins,18,28,2012,17,domingo,Regular Season,8-8,8,8,0,15,14,1,10-6,10,6,0,8,9,-1,Washington Redskins,5
2012-12-30,Jacksonville Jaguars,Tennessee Titans,20,38,2012,17,domingo,Regular Season,2-14,2,14,0,31,31,0,6-10,6,10,0,26,27,-1,Tennessee Titans,4
2012-12-30,Los Angeles Rams,Seattle Seahawks,13,20,2012,17,domingo,Regular Season,7-8,7,8,0,16,16,0,11-5,11,5,0,5,6,-1,Seattle Seahawks,10
2012-12-30,Arizona Cardinals,San Francisco 49ers,13,27,2012,17,domingo,Regular Season,5-11,5,11,0,27,26,1,11-4,11,4,0,3,3,0,San Francisco 49ers,23
2012-12-30,Oakland Raiders,Los Angeles Chargers,21,24,2012,17,domingo,Regular Season,4-12,4,12,0,30,30,0,7-9,7,9,0,22,21,1,Los Angeles Chargers,9
2012-12-30,Cleveland Browns,Pittsburgh Steelers,10,24,2012,17,domingo,Regular Season,5-11,5,11,0,24,24,0,8-8,8,8,0,17,18,-1,Pittsburgh Steelers,6
2012-12-30,Philadelphia Eagles,New York Giants,7,42,2012,17,domingo,Regular Season,4-12,4,12,0,29,29,0,9-7,9,7,0,14,15,-1,New York Giants,14
2012-12-30,Carolina Panthers,New Orleans Saints,44,38,2012,17,domingo,Regular Season,7-9,7,9,0,18,20,-2,7-9,7,9,0,19,17,2,Carolina Panthers,3
2012-12-30,Miami Dolphins,New England Patriots,0,28,2012,17,domingo,Regular Season,7-9,7,9,0,20,19,1,12-4,12,4,0,4,5,-1,New England Patriots,14
2012-12-30,Green Bay Packers,Minnesota Vikings,34,37,2012,17,domingo,Regular Season,11-5,11,5,0,6,4,2,10-6,10,6,0,12,12,0,Minnesota Vikings,8
2012-12-30,Houston Texans,Indianapolis Colts,16,28,2012,17,domingo,Regular Season,12-4,12,4,0,9,7,2,11-5,11,5,0,7,8,-1,Indianapolis Colts,1
2012-12-30,Chicago Bears,Detroit Lions,26,24,2012,17,domingo,Regular Season,10-6,10,6,0,13,13,0,4-12,4,12,0,28,28,0,Chicago Bears,15
2012-12-30,Kansas City Chiefs,Denver Broncos,3,38,2012,17,domingo,Regular Season,2-14,2,14,0,32,32,0,13-3,13,3,0,1,1,0,Denver Broncos,31
2012-12-30,Baltimore Ravens,Cincinnati Bengals,17,23,2012,17,domingo,Regular Season,10-6,10,6,0,10,10,0,10-6,10,6,0,11,11,0,Cincinnati Bengals,1
2012-12-30,New York Jets,Buffalo Bills,9,28,2012,17,domingo,Regular Season,6-10,6,10,0,25,23,2,6-10,6,10,0,23,25,-2,Buffalo Bills,2
2012-12-30,Tampa Bay Buccaneers,Atlanta Falcons,22,17,2012,17,domingo,Regular Season,7-9,7,9,0,21,22,-1,13-3,13,3,0,2,2,0,Tampa Bay Buccaneers,20
2012-12-23,Los Angeles Rams,Tampa Bay Buccaneers,28,13,2012,16,domingo,Regular Season,7-7,7,7,0,16,17,-1,6-9,6,9,0,22,20,2,Los Angeles Rams,3
2012-12-23,San Francisco 49ers,Seattle Seahawks,13,42,2012,16,domingo,Regular Season,10-4,10,4,0,3,1,2,10-5,10,5,0,6,7,-1,Seattle Seahawks,6
2012-12-23,Cincinnati Bengals,Pittsburgh Steelers,13,10,2012,16,domingo,Regular Season,9-6,9,6,0,11,13,-2,7-8,7,8,0,18,16,2,Cincinnati Bengals,3
2012-12-23,Washington Redskins,Philadelphia Eagles,27,20,2012,16,domingo,Regular Season,9-6,9,6,0,9,8,1,4-11,4,11,0,29,29,0,Washington Redskins,21
2012-12-23,Los Angeles Chargers,New York Jets,27,17,2012,16,domingo,Regular Season,6-9,6,9,0,21,24,-3,6-9,6,9,0,23,21,2,Los Angeles Chargers,3
2012-12-23,Buffalo Bills,Miami Dolphins,10,24,2012,16,domingo,Regular Season,5-10,5,10,0,25,25,0,7-8,7,8,0,19,19,0,Miami Dolphins,6
2012-12-23,Indianapolis Colts,Kansas City Chiefs,20,13,2012,16,domingo,Regular Season,10-5,10,5,0,8,9,-1,2-13,2,13,0,32,32,0,Indianapolis Colts,23
2012-12-23,New England Patriots,Jacksonville Jaguars,23,16,2012,16,domingo,Regular Season,11-4,11,4,0,5,4,1,2-13,2,13,0,31,31,0,New England Patriots,27
2012-12-23,Minnesota Vikings,Houston Texans,23,6,2012,16,domingo,Regular Season,9-6,9,6,0,12,15,-3,12-3,12,3,0,7,3,4,Minnesota Vikings,12
2012-12-23,Tennessee Titans,Green Bay Packers,7,55,2012,16,domingo,Regular Season,5-10,5,10,0,27,26,1,11-4,11,4,0,4,6,-2,Green Bay Packers,20
2012-12-23,Cleveland Browns,Denver Broncos,12,34,2012,16,domingo,Regular Season,5-10,5,10,0,24,22,2,12-3,12,3,0,1,2,-1,Denver Broncos,20
2012-12-23,New Orleans Saints,Dallas Cowboys,34,31,2012,16,domingo,Regular Season,7-8,7,8,0,17,18,-1,8-7,8,7,0,14,10,4,New Orleans Saints,8
2012-12-23,Oakland Raiders,Carolina Panthers,6,17,2012,16,domingo,Regular Season,4-11,4,11,0,30,30,0,6-9,6,9,0,20,23,-3,Carolina Panthers,7
2012-12-23,New York Giants,Baltimore Ravens,14,33,2012,16,domingo,Regular Season,8-7,8,7,0,15,12,3,10-5,10,5,0,10,11,-1,Baltimore Ravens,1
2012-12-23,Chicago Bears,Arizona Cardinals,28,13,2012,16,domingo,Regular Season,9-6,9,6,0,13,14,-1,5-10,5,10,0,26,27,-1,Chicago Bears,13
2012-12-22,Atlanta Falcons,Detroit Lions,31,18,2012,16,sábado,Regular Season,13-2,13,2,0,2,5,-3,4-11,4,11,0,28,28,0,Atlanta Falcons,23
2012-12-17,New York Jets,Tennessee Titans,10,14,2012,15,segunda,Regular Season,6-8,6,8,0,21,19,2,5-9,5,9,0,26,28,-2,Tennessee Titans,9
2012-12-16,Minnesota Vikings,Los Angeles Rams,36,22,2012,15,domingo,Regular Season,8-6,8,6,0,15,16,-1,6-7,6,7,0,17,17,0,Minnesota Vikings,1
2012-12-16,Carolina Panthers,Los Angeles Chargers,31,7,2012,15,domingo,Regular Season,5-9,5,9,0,23,26,-3,5-9,5,9,0,24,23,1,Carolina Panthers,3
2012-12-16,Kansas City Chiefs,Oakland Raiders,0,15,2012,15,domingo,Regular Season,2-12,2,12,0,32,32,0,4-10,4,10,0,30,30,0,Oakland Raiders,2
2012-12-16,Tampa Bay Buccaneers,New Orleans Saints,0,41,2012,15,domingo,Regular Season,6-8,6,8,0,20,18,2,6-8,6,8,0,18,22,-4,New Orleans Saints,4
2012-12-16,San Francisco 49ers,New England Patriots,41,34,2012,15,domingo,Regular Season,10-3,10,3,0,1,4,-3,10-4,10,4,0,4,1,3,San Francisco 49ers,3
2012-12-16,Jacksonville Jaguars,Miami Dolphins,3,24,2012,15,domingo,Regular Season,2-12,2,12,0,31,31,0,6-8,6,8,0,19,21,-2,Miami Dolphins,10
2012-12-16,Indianapolis Colts,Houston Texans,17,29,2012,15,domingo,Regular Season,9-5,9,5,0,9,9,0,12-2,12,2,0,3,3,0,Houston Texans,6
2012-12-16,Pittsburgh Steelers,Dallas Cowboys,24,27,2012,15,domingo,Regular Season,7-7,7,7,0,16,15,1,8-6,8,6,0,10,13,-3,Dallas Cowboys,2
2012-12-16,Washington Redskins,Cleveland Browns,38,21,2012,15,domingo,Regular Season,8-6,8,6,0,8,12,-4,5-9,5,9,0,22,20,2,Washington Redskins,8
2012-12-16,Green Bay Packers,Chicago Bears,21,13,2012,15,domingo,Regular Season,10-4,10,4,0,6,6,0,8-6,8,6,0,14,11,3,Green Bay Packers,5
2012-12-16,Seattle Seahawks,Buffalo Bills,50,17,2012,15,domingo,Regular Season,9-5,9,5,0,7,10,-3,5-9,5,9,0,25,24,1,Seattle Seahawks,14
2012-12-16,Denver Broncos,Baltimore Ravens,34,17,2012,15,domingo,Regular Season,11-3,11,3,0,2,2,0,9-5,9,5,0,11,8,3,Denver Broncos,6
2012-12-16,New York Giants,Atlanta Falcons,0,34,2012,15,domingo,Regular Season,8-6,8,6,0,12,7,5,12-2,12,2,0,5,5,0,Atlanta Falcons,2
2012-12-16,Detroit Lions,Arizona Cardinals,10,38,2012,15,domingo,Regular Season,4-10,4,10,0,28,25,3,5-9,5,9,0,27,29,-2,Arizona Cardinals,4
2012-12-13,Cincinnati Bengals,Philadelphia Eagles,34,13,2012,15,quinta,Regular Season,8-6,8,6,0,13,14,-1,4-10,4,10,0,29,27,2,Cincinnati Bengals,13
2012-12-10,Houston Texans,New England Patriots,14,42,2012,14,segunda,Regular Season,11-2,11,2,0,3,1,2,10-3,10,3,0,1,3,-2,New England Patriots,2
2012-12-09,Baltimore Ravens,Washington Redskins,28,31,2012,14,domingo,Regular Season,9-4,9,4,0,8,6,2,7-6,7,6,0,12,14,-2,Washington Redskins,8
2012-12-09,Philadelphia Eagles,Tampa Bay Buccaneers,23,21,2012,14,domingo,Regular Season,4-9,4,9,0,27,30,-3,6-7,6,7,0,18,15,3,Philadelphia Eagles,15
2012-12-09,Arizona Cardinals,Seattle Seahawks,0,58,2012,14,domingo,Regular Season,4-9,4,9,0,29,27,2,8-5,8,5,0,10,12,-2,Seattle Seahawks,15
2012-12-09,Miami Dolphins,San Francisco 49ers,13,27,2012,14,domingo,Regular Season,5-8,5,8,0,21,20,1,9-3,9,3,0,4,4,0,San Francisco 49ers,16
2012-12-09,Los Angeles Chargers,Pittsburgh Steelers,34,24,2012,14,domingo,Regular Season,5-8,5,8,0,23,25,-2,7-6,7,6,0,15,13,2,Los Angeles Chargers,12
2012-12-09,New Orleans Saints,New York Giants,27,52,2012,14,domingo,Regular Season,5-8,5,8,0,22,18,4,8-5,8,5,0,7,10,-3,New York Giants,8
2012-12-09,Chicago Bears,Minnesota Vikings,14,21,2012,14,domingo,Regular Season,8-5,8,5,0,11,8,3,7-6,7,6,0,16,17,-1,Minnesota Vikings,9
2012-12-09,New York Jets,Jacksonville Jaguars,17,10,2012,14,domingo,Regular Season,6-7,6,7,0,19,22,-3,2-11,2,11,0,31,32,-1,New York Jets,10
2012-12-09,Tennessee Titans,Indianapolis Colts,23,27,2012,14,domingo,Regular Season,4-9,4,9,0,28,26,2,9-4,9,4,0,9,9,0,Indianapolis Colts,17
2012-12-09,Detroit Lions,Green Bay Packers,20,27,2012,14,domingo,Regular Season,4-9,4,9,0,25,21,4,9-4,9,4,0,6,7,-1,Green Bay Packers,14
2012-12-09,Kansas City Chiefs,Cleveland Browns,7,30,2012,14,domingo,Regular Season,2-11,2,11,0,32,31,1,5-8,5,8,0,20,24,-4,Cleveland Browns,7
2012-12-09,Dallas Cowboys,Cincinnati Bengals,20,19,2012,14,domingo,Regular Season,7-6,7,6,0,13,16,-3,7-6,7,6,0,14,11,3,Dallas Cowboys,5
2012-12-09,Atlanta Falcons,Carolina Panthers,20,30,2012,14,domingo,Regular Season,11-2,11,2,0,5,2,3,4-9,4,9,0,26,28,-2,Carolina Panthers,26
2012-12-09,Los Angeles Rams,Buffalo Bills,15,12,2012,14,domingo,Regular Season,6-6,6,6,0,17,19,-2,5-8,5,8,0,24,23,1,Los Angeles Rams,4
2012-12-06,Denver Broncos,Oakland Raiders,26,13,2012,14,quinta,Regular Season,10-3,10,3,0,2,5,-3,3-10,3,10,0,30,29,1,Denver Broncos,24
2012-12-03,New York Giants,Washington Redskins,16,17,2012,13,segunda,Regular Season,7-5,7,5,0,10,8,2,6-6,6,6,0,14,17,-3,Washington Redskins,9
2012-12-02,Houston Texans,Tennessee Titans,24,10,2012,13,domingo,Regular Season,11-1,11,1,0,1,1,0,4-8,4,8,0,26,26,0,Houston Texans,25
2012-12-02,San Francisco 49ers,Los Angeles Rams,13,16,2012,13,domingo,Regular Season,8-3,8,3,0,4,3,1,5-6,5,6,0,19,21,-2,Los Angeles Rams,18
2012-12-02,Cincinnati Bengals,Los Angeles Chargers,20,13,2012,13,domingo,Regular Season,7-5,7,5,0,11,11,0,4-8,4,8,0,25,22,3,Cincinnati Bengals,11
2012-12-02,Cleveland Browns,Oakland Raiders,20,17,2012,13,domingo,Regular Season,4-8,4,8,0,24,27,-3,3-9,3,9,0,29,29,0,Cleveland Browns,2
2012-12-02,Arizona Cardinals,New York Jets,6,7,2012,13,domingo,Regular Season,4-8,4,8,0,27,25,2,5-7,5,7,0,22,23,-1,New York Jets,2
2012-12-02,New England Patriots,Miami Dolphins,23,16,2012,13,domingo,Regular Season,9-3,9,3,0,3,5,-2,5-7,5,7,0,20,18,2,New England Patriots,13
2012-12-02,Carolina Panthers,Kansas City Chiefs,21,27,2012,13,domingo,Regular Season,3-9,3,9,0,28,28,0,2-10,2,10,0,31,32,-1,Kansas City Chiefs,4
2012-12-02,Minnesota Vikings,Green Bay Packers,14,23,2012,13,domingo,Regular Season,6-6,6,6,0,17,16,1,8-4,8,4,0,7,9,-2,Green Bay Packers,7
2012-12-02,Indianapolis Colts,Detroit Lions,35,33,2012,13,domingo,Regular Season,8-4,8,4,0,9,10,-1,4-8,4,8,0,21,20,1,Indianapolis Colts,10
2012-12-02,Tampa Bay Buccaneers,Denver Broncos,23,31,2012,13,domingo,Regular Season,6-6,6,6,0,15,12,3,9-3,9,3,0,5,7,-2,Denver Broncos,5
2012-12-02,Philadelphia Eagles,Dallas Cowboys,33,38,2012,13,domingo,Regular Season,3-9,3,9,0,30,30,0,6-6,6,6,0,16,19,-3,Dallas Cowboys,11
2012-12-02,Seattle Seahawks,Chicago Bears,23,17,2012,13,domingo,Regular Season,7-5,7,5,0,12,13,-1,8-4,8,4,0,8,6,2,Seattle Seahawks,7
2012-12-02,Jacksonville Jaguars,Buffalo Bills,18,34,2012,13,domingo,Regular Season,2-10,2,10,0,32,31,1,5-7,5,7,0,23,24,-1,Buffalo Bills,7
2012-12-02,Pittsburgh Steelers,Baltimore Ravens,23,20,2012,13,domingo,Regular Season,7-5,7,5,0,13,14,-1,9-3,9,3,0,6,4,2,Pittsburgh Steelers,10
2012-11-29,New Orleans Saints,Atlanta Falcons,13,23,2012,13,quinta,Regular Season,5-7,5,7,0,18,15,3,11-1,11,1,0,2,2,0,Atlanta Falcons,13
2012-11-26,Carolina Panthers,Philadelphia Eagles,30,22,2012,12,segunda,Regular Season,3-8,3,8,0,28,29,-1,3-8,3,8,0,30,27,3,Carolina Panthers,2
2012-11-25,Atlanta Falcons,Tampa Bay Buccaneers,24,23,2012,12,domingo,Regular Season,10-1,10,1,0,2,2,0,6-5,6,5,0,12,10,2,Atlanta Falcons,8
2012-11-25,Baltimore Ravens,Los Angeles Chargers,16,13,2012,12,domingo,Regular Season,9-2,9,2,0,4,5,-1,4-7,4,7,0,22,21,1,Baltimore Ravens,16
2012-11-25,Green Bay Packers,New York Giants,10,38,2012,12,domingo,Regular Season,7-4,7,4,0,9,4,5,7-4,7,4,0,8,9,-1,New York Giants,5
2012-11-25,San Francisco 49ers,New Orleans Saints,31,21,2012,12,domingo,Regular Season,8-2,8,2,0,3,3,0,5-6,5,6,0,15,13,2,San Francisco 49ers,10
2012-11-25,Seattle Seahawks,Miami Dolphins,21,24,2012,12,domingo,Regular Season,6-5,6,5,0,13,12,1,5-6,5,6,0,18,20,-2,Miami Dolphins,8
2012-11-25,Denver Broncos,Kansas City Chiefs,17,9,2012,12,domingo,Regular Season,8-3,8,3,0,7,7,0,1-10,1,10,0,32,32,0,Denver Broncos,25
2012-11-25,Tennessee Titans,Jacksonville Jaguars,19,24,2012,12,domingo,Regular Season,4-7,4,7,0,26,23,3,2-9,2,9,0,31,31,0,Jacksonville Jaguars,8
2012-11-25,Buffalo Bills,Indianapolis Colts,13,20,2012,12,domingo,Regular Season,4-7,4,7,0,24,24,0,7-4,7,4,0,10,15,-5,Indianapolis Colts,9
2012-11-25,Pittsburgh Steelers,Cleveland Browns,14,20,2012,12,domingo,Regular Season,6-5,6,5,0,14,11,3,3-8,3,8,0,27,30,-3,Cleveland Browns,19
2012-11-25,Oakland Raiders,Cincinnati Bengals,10,34,2012,12,domingo,Regular Season,3-8,3,8,0,29,28,1,6-5,6,5,0,11,17,-6,Cincinnati Bengals,11
2012-11-25,Minnesota Vikings,Chicago Bears,10,28,2012,12,domingo,Regular Season,6-5,6,5,0,16,14,2,8-3,8,3,0,6,6,0,Chicago Bears,8
2012-11-25,Los Angeles Rams,Arizona Cardinals,31,17,2012,12,domingo,Regular Season,4-6,4,6,0,21,26,-5,4-7,4,7,0,25,25,0,Los Angeles Rams,1
2012-11-22,New England Patriots,New York Jets,49,19,2012,12,quinta,Regular Season,8-3,8,3,0,5,8,-3,4-7,4,7,0,23,22,1,New England Patriots,14
2012-11-22,Houston Texans,Detroit Lions,34,31,2012,12,quinta,Regular Season,10-1,10,1,0,1,1,0,4-7,4,7,0,20,19,1,Houston Texans,18
2012-11-22,Washington Redskins,Dallas Cowboys,38,31,2012,12,quinta,Regular Season,5-6,5,6,0,17,18,-1,5-6,5,6,0,19,16,3,Washington Redskins,2
2012-11-19,Chicago Bears,San Francisco 49ers,7,32,2012,11,segunda,Regular Season,7-3,7,3,0,6,3,3,7-2,7,2,0,3,4,-1,San Francisco 49ers,1
2012-11-18,Philadelphia Eagles,Washington Redskins,6,31,2012,11,domingo,Regular Season,3-7,3,7,0,27,24,3,4-6,4,6,0,18,21,-3,Washington Redskins,3
2012-11-18,New York Jets,Los Angeles Rams,27,13,2012,11,domingo,Regular Season,4-6,4,6,0,22,26,-4,3-6,3,6,0,26,23,3,New York Jets,3
2012-11-18,Baltimore Ravens,Pittsburgh Steelers,13,10,2012,11,domingo,Regular Season,8-2,8,2,0,5,5,0,6-4,6,4,0,11,9,2,Baltimore Ravens,4
2012-11-18,New Orleans Saints,Oakland Raiders,38,17,2012,11,domingo,Regular Season,5-5,5,5,0,13,16,-3,3-7,3,7,0,28,28,0,New Orleans Saints,12
2012-11-18,Indianapolis Colts,New England Patriots,24,59,2012,11,domingo,Regular Season,6-4,6,4,0,15,11,4,7-3,7,3,0,8,8,0,New England Patriots,3
2012-11-18,Cincinnati Bengals,Kansas City Chiefs,28,6,2012,11,domingo,Regular Season,5-5,5,5,0,17,19,-2,1-9,1,9,0,32,32,0,Cincinnati Bengals,13
2012-11-18,Jacksonville Jaguars,Houston Texans,37,43,2012,11,domingo,Regular Season,1-9,1,9,0,31,31,0,9-1,9,1,0,1,1,0,Houston Texans,30
2012-11-18,Green Bay Packers,Detroit Lions,24,20,2012,11,domingo,Regular Season,7-3,7,3,0,4,6,-2,4-6,4,6,0,19,17,2,Green Bay Packers,11
2012-11-18,Los Angeles Chargers,Denver Broncos,23,30,2012,11,domingo,Regular Season,4-6,4,6,0,21,20,1,7-3,7,3,0,7,7,0,Denver Broncos,13
2012-11-18,Cleveland Browns,Dallas Cowboys,20,23,2012,11,domingo,Regular Season,2-8,2,8,0,30,30,0,5-5,5,5,0,16,15,1,Dallas Cowboys,15
2012-11-18,Tampa Bay Buccaneers,Carolina Panthers,27,21,2012,11,domingo,Regular Season,6-4,6,4,0,10,13,-3,2-8,2,8,0,29,29,0,Tampa Bay Buccaneers,16
2012-11-18,Arizona Cardinals,Atlanta Falcons,19,23,2012,11,domingo,Regular Season,4-6,4,6,0,25,22,3,9-1,9,1,0,2,2,0,Atlanta Falcons,20
2012-11-15,Miami Dolphins,Buffalo Bills,14,19,2012,11,quinta,Regular Season,4-6,4,6,0,20,18,2,4-6,4,6,0,24,27,-3,Buffalo Bills,9
2012-11-12,Kansas City Chiefs,Pittsburgh Steelers,13,16,2012,10,segunda,Regular Season,1-8,1,8,0,32,32,0,6-3,6,3,0,9,10,-1,Pittsburgh Steelers,22
2012-11-11,Los Angeles Chargers,Tampa Bay Buccaneers,24,34,2012,10,domingo,Regular Season,4-5,4,5,0,20,17,3,5-4,5,4,0,13,13,0,Tampa Bay Buccaneers,4
2012-11-11,New York Jets,Seattle Seahawks,7,28,2012,10,domingo,Regular Season,3-6,3,6,0,26,25,1,6-4,6,4,0,12,12,0,Seattle Seahawks,13
2012-11-11,Los Angeles Rams,San Francisco 49ers,24,24,2012,10,domingo,Regular Season,3-5,3,5,0,23,24,-1,6-2,6,2,0,4,4,0,Draw,20
2012-11-11,Dallas Cowboys,Philadelphia Eagles,38,23,2012,10,domingo,Regular Season,4-5,4,5,0,15,18,-3,3-6,3,6,0,24,21,3,Dallas Cowboys,3
2012-11-11,Atlanta Falcons,New Orleans Saints,27,31,2012,10,domingo,Regular Season,8-1,8,1,0,2,1,1,4-5,4,5,0,16,22,-6,New Orleans Saints,21
2012-11-11,Buffalo Bills,New England Patriots,31,37,2012,10,domingo,Regular Season,3-6,3,6,0,27,28,-1,6-3,6,3,0,8,9,-1,New England Patriots,19
2012-11-11,Detroit Lions,Minnesota Vikings,24,34,2012,10,domingo,Regular Season,4-5,4,5,0,17,14,3,6-4,6,4,0,14,16,-2,Minnesota Vikings,2
2012-11-11,Tennessee Titans,Miami Dolphins,37,3,2012,10,domingo,Regular Season,4-6,4,6,0,25,27,-2,4-5,4,5,0,18,15,3,Tennessee Titans,12
2012-11-11,New York Giants,Cincinnati Bengals,13,31,2012,10,domingo,Regular Season,6-4,6,4,0,10,5,5,4-5,4,5,0,19,23,-4,Cincinnati Bengals,18
2012-11-11,Houston Texans,Chicago Bears,13,6,2012,10,domingo,Regular Season,8-1,8,1,0,1,2,-1,7-2,7,2,0,3,3,0,Houston Texans,1
2012-11-11,Denver Broncos,Carolina Panthers,36,14,2012,10,domingo,Regular Season,6-3,6,3,0,7,8,-1,2-7,2,7,0,29,29,0,Denver Broncos,21
2012-11-11,Oakland Raiders,Baltimore Ravens,20,55,2012,10,domingo,Regular Season,3-6,3,6,0,28,26,2,7-2,7,2,0,5,7,-2,Baltimore Ravens,19
2012-11-08,Indianapolis Colts,Jacksonville Jaguars,27,10,2012,10,quinta,Regular Season,6-3,6,3,0,11,11,0,1-8,1,8,0,31,31,0,Indianapolis Colts,20
2012-11-05,Philadelphia Eagles,New Orleans Saints,13,28,2012,9,segunda,Regular Season,3-5,3,5,0,21,18,3,3-5,3,5,0,22,26,-4,New Orleans Saints,8
2012-11-04,Carolina Panthers,Washington Redskins,21,13,2012,9,domingo,Regular Season,2-6,2,6,0,29,30,-1,3-6,3,6,0,19,19,0,Carolina Panthers,11
2012-11-04,Chicago Bears,Tennessee Titans,51,20,2012,9,domingo,Regular Season,7-1,7,1,0,3,5,-2,3-6,3,6,0,27,27,0,Chicago Bears,22
2012-11-04,Minnesota Vikings,Seattle Seahawks,20,30,2012,9,domingo,Regular Season,5-4,5,4,0,16,11,5,5-4,5,4,0,12,13,-1,Seattle Seahawks,2
2012-11-04,Tampa Bay Buccaneers,Oakland Raiders,42,32,2012,9,domingo,Regular Season,4-4,4,4,0,13,21,-8,3-5,3,5,0,26,24,2,Tampa Bay Buccaneers,3
2012-11-04,Pittsburgh Steelers,New York Giants,24,20,2012,9,domingo,Regular Season,5-3,5,3,0,10,10,0,6-3,6,3,0,5,2,3,Pittsburgh Steelers,8
2012-11-04,Detroit Lions,Jacksonville Jaguars,31,14,2012,9,domingo,Regular Season,4-4,4,4,0,14,17,-3,1-7,1,7,0,31,31,0,Detroit Lions,14
2012-11-04,Miami Dolphins,Indianapolis Colts,20,23,2012,9,domingo,Regular Season,4-4,4,4,0,15,12,3,5-3,5,3,0,11,15,-4,Indianapolis Colts,3
2012-11-04,Buffalo Bills,Houston Texans,9,21,2012,9,domingo,Regular Season,3-5,3,5,0,28,28,0,7-1,7,1,0,2,3,-1,Houston Texans,25
2012-11-04,Arizona Cardinals,Green Bay Packers,17,31,2012,9,domingo,Regular Season,4-5,4,5,0,20,16,4,6-3,6,3,0,6,6,0,Green Bay Packers,10
2012-11-04,Baltimore Ravens,Cleveland Browns,25,15,2012,9,domingo,Regular Season,6-2,6,2,0,7,7,0,2-7,2,7,0,30,29,1,Baltimore Ravens,22
2012-11-04,Denver Broncos,Cincinnati Bengals,31,23,2012,9,domingo,Regular Season,5-3,5,3,0,8,9,-1,3-5,3,5,0,23,22,1,Denver Broncos,13
2012-11-04,Dallas Cowboys,Atlanta Falcons,13,19,2012,9,domingo,Regular Season,3-5,3,5,0,18,14,4,8-0,8,0,0,1,1,0,Atlanta Falcons,13
2012-11-01,Kansas City Chiefs,Los Angeles Chargers,13,31,2012,9,quinta,Regular Season,1-7,1,7,0,32,32,0,4-4,4,4,0,17,20,-3,Los Angeles Chargers,12
2012-10-29,San Francisco 49ers,Arizona Cardinals,24,3,2012,8,segunda,Regular Season,6-2,6,2,0,4,4,0,4-4,4,4,0,16,14,2,San Francisco 49ers,10
2012-10-28,Indianapolis Colts,Tennessee Titans,19,13,2012,8,domingo,Regular Season,4-3,4,3,0,15,23,-8,3-5,3,5,0,27,25,2,Indianapolis Colts,2
2012-10-28,New England Patriots,Los Angeles Rams,45,7,2012,8,domingo,Regular Season,5-3,5,3,0,8,8,0,3-5,3,5,0,23,21,2,New England Patriots,13
2012-10-28,Washington Redskins,Pittsburgh Steelers,12,27,2012,8,domingo,Regular Season,3-5,3,5,0,19,18,1,4-3,4,3,0,10,10,0,Pittsburgh Steelers,8
2012-10-28,Atlanta Falcons,Philadelphia Eagles,30,17,2012,8,domingo,Regular Season,7-0,7,0,0,1,1,0,3-4,3,4,0,18,13,5,Atlanta Falcons,12
2012-10-28,Miami Dolphins,New York Jets,30,9,2012,8,domingo,Regular Season,4-3,4,3,0,12,16,-4,3-5,3,5,0,25,24,1,Miami Dolphins,8
2012-10-28,Oakland Raiders,Kansas City Chiefs,26,16,2012,8,domingo,Regular Season,3-4,3,4,0,24,28,-4,1-6,1,6,0,32,32,0,Oakland Raiders,4
2012-10-28,Jacksonville Jaguars,Green Bay Packers,15,24,2012,8,domingo,Regular Season,1-6,1,6,0,31,31,0,5-3,5,3,0,6,7,-1,Green Bay Packers,24
2012-10-28,Seattle Seahawks,Detroit Lions,24,28,2012,8,domingo,Regular Season,4-4,4,4,0,13,11,2,3-4,3,4,0,17,19,-2,Detroit Lions,8
2012-10-28,New Orleans Saints,Denver Broncos,14,34,2012,8,domingo,Regular Season,2-5,2,5,0,26,20,6,4-3,4,3,0,9,12,-3,Denver Broncos,8
2012-10-28,New York Giants,Dallas Cowboys,29,24,2012,8,domingo,Regular Season,6-2,6,2,0,2,2,0,3-4,3,4,0,14,15,-1,New York Giants,13
2012-10-28,Los Angeles Chargers,Cleveland Browns,6,7,2012,8,domingo,Regular Season,3-4,3,4,0,20,17,3,2-6,2,6,0,29,30,-1,Cleveland Browns,13
2012-10-28,Carolina Panthers,Chicago Bears,22,23,2012,8,domingo,Regular Season,1-6,1,6,0,30,29,1,6-1,6,1,0,5,5,0,Chicago Bears,24
2012-10-25,Tampa Bay Buccaneers,Minnesota Vikings,36,17,2012,8,quinta,Regular Season,3-4,3,4,0,21,26,-5,5-3,5,3,0,11,9,2,Tampa Bay Buccaneers,17
2012-10-22,Detroit Lions,Chicago Bears,7,13,2012,7,segunda,Regular Season,2-4,2,4,0,19,19,0,5-1,5,1,0,5,6,-1,Chicago Bears,13
2012-10-21,New Orleans Saints,Tampa Bay Buccaneers,35,28,2012,7,domingo,Regular Season,2-4,2,4,0,20,24,-4,2-4,2,4,0,26,22,4,New Orleans Saints,2
2012-10-21,Green Bay Packers,Los Angeles Rams,30,20,2012,7,domingo,Regular Season,4-3,4,3,0,7,8,-1,3-4,3,4,0,21,20,1,Green Bay Packers,12
2012-10-21,Jacksonville Jaguars,Oakland Raiders,23,26,2012,7,domingo,Regular Season,1-5,1,5,0,31,31,0,2-4,2,4,0,28,29,-1,Oakland Raiders,2
2012-10-21,Washington Redskins,New York Giants,23,27,2012,7,domingo,Regular Season,3-4,3,4,0,18,15,3,5-2,5,2,0,2,3,-1,New York Giants,12
2012-10-21,New York Jets,New England Patriots,26,29,2012,7,domingo,Regular Season,3-4,3,4,0,24,23,1,4-3,4,3,0,8,7,1,New England Patriots,16
2012-10-21,Arizona Cardinals,Minnesota Vikings,14,21,2012,7,domingo,Regular Season,4-3,4,3,0,14,11,3,5-2,5,2,0,9,10,-1,Minnesota Vikings,1
2012-10-21,Cleveland Browns,Indianapolis Colts,13,17,2012,7,domingo,Regular Season,1-6,1,6,0,30,30,0,3-3,3,3,0,23,26,-3,Indianapolis Colts,4
2012-10-21,Baltimore Ravens,Houston Texans,13,43,2012,7,domingo,Regular Season,5-2,5,2,0,6,4,2,6-1,6,1,0,3,2,1,Houston Texans,2
2012-10-21,Pittsburgh Steelers,Cincinnati Bengals,24,17,2012,7,domingo,Regular Season,3-3,3,3,0,10,14,-4,3-4,3,4,0,22,21,1,Pittsburgh Steelers,7
2012-10-21,Dallas Cowboys,Carolina Panthers,19,14,2012,7,domingo,Regular Season,3-3,3,3,0,15,18,-3,1-5,1,5,0,29,28,1,Dallas Cowboys,10
2012-10-21,Tennessee Titans,Buffalo Bills,35,34,2012,7,domingo,Regular Season,3-4,3,4,0,25,27,-2,3-4,3,4,0,27,25,2,Tennessee Titans,2
2012-10-18,Seattle Seahawks,San Francisco 49ers,6,13,2012,7,quinta,Regular Season,4-3,4,3,0,11,9,2,5-2,5,2,0,4,5,-1,San Francisco 49ers,4
2012-10-15,Denver Broncos,Los Angeles Chargers,35,24,2012,6,segunda,Regular Season,3-3,3,3,0,12,17,-5,3-3,3,3,0,16,14,2,Denver Broncos,3
2012-10-14,Minnesota Vikings,Washington Redskins,26,38,2012,6,domingo,Regular Season,4-2,4,2,0,10,8,2,3-3,3,3,0,15,21,-6,Washington Redskins,13
2012-10-14,Kansas City Chiefs,Tampa Bay Buccaneers,10,38,2012,6,domingo,Regular Season,1-5,1,5,0,32,30,2,2-3,2,3,0,22,23,-1,Tampa Bay Buccaneers,7
2012-10-14,New England Patriots,Seattle Seahawks,23,24,2012,6,domingo,Regular Season,3-3,3,3,0,7,5,2,4-2,4,2,0,9,16,-7,Seattle Seahawks,11
2012-10-14,New York Giants,San Francisco 49ers,26,3,2012,6,domingo,Regular Season,4-2,4,2,0,3,7,-4,4-2,4,2,0,5,3,2,New York Giants,4
2012-10-14,Detroit Lions,Philadelphia Eagles,26,23,2012,6,domingo,Regular Season,2-3,2,3,0,19,20,-1,3-3,3,3,0,13,11,2,Detroit Lions,9
2012-10-14,Indianapolis Colts,New York Jets,9,35,2012,6,domingo,Regular Season,2-3,2,3,0,26,22,4,3-3,3,3,0,23,25,-2,New York Jets,3
2012-10-14,Los Angeles Rams,Miami Dolphins,14,17,2012,6,domingo,Regular Season,3-3,3,3,0,20,18,2,3-3,3,3,0,17,19,-2,Miami Dolphins,1
2012-10-14,Green Bay Packers,Houston Texans,42,24,2012,6,domingo,Regular Season,3-3,3,3,0,8,12,-4,5-1,5,1,0,2,1,1,Green Bay Packers,11
2012-10-14,Cincinnati Bengals,Cleveland Browns,24,34,2012,6,domingo,Regular Season,3-3,3,3,0,21,15,6,1-5,1,5,0,30,32,-2,Cleveland Browns,17
2012-10-14,Dallas Cowboys,Baltimore Ravens,29,31,2012,6,domingo,Regular Season,2-3,2,3,0,18,13,5,5-1,5,1,0,4,4,0,Baltimore Ravens,9
2012-10-14,Oakland Raiders,Atlanta Falcons,20,23,2012,6,domingo,Regular Season,1-4,1,4,0,29,29,0,6-0,6,0,0,1,2,-1,Atlanta Falcons,27
2012-10-14,Buffalo Bills,Arizona Cardinals,19,16,2012,6,domingo,Regular Season,3-3,3,3,0,25,27,-2,4-2,4,2,0,11,9,2,Buffalo Bills,18
2012-10-11,Pittsburgh Steelers,Tennessee Titans,23,26,2012,6,quinta,Regular Season,2-3,2,3,0,14,10,4,2-4,2,4,0,27,28,-1,Tennessee Titans,18
2012-10-08,Houston Texans,New York Jets,23,17,2012,5,segunda,Regular Season,5-0,5,0,0,1,1,0,2-3,2,3,0,25,23,2,Houston Texans,22
2012-10-07,Atlanta Falcons,Washington Redskins,24,17,2012,5,domingo,Regular Season,5-0,5,0,0,2,2,0,2-3,2,3,0,21,18,3,Atlanta Falcons,16
2012-10-07,Buffalo Bills,San Francisco 49ers,3,45,2012,5,domingo,Regular Season,2-3,2,3,0,27,21,6,4-1,4,1,0,3,4,-1,San Francisco 49ers,17
2012-10-07,Philadelphia Eagles,Pittsburgh Steelers,14,16,2012,5,domingo,Regular Season,3-2,3,2,0,11,7,4,2-2,2,2,0,10,16,-6,Pittsburgh Steelers,9
2012-10-07,Cleveland Browns,New York Giants,27,41,2012,5,domingo,Regular Season,0-5,0,5,0,32,32,0,3-2,3,2,0,7,10,-3,New York Giants,22
2012-10-07,Los Angeles Chargers,New Orleans Saints,24,31,2012,5,domingo,Regular Season,3-2,3,2,0,14,11,3,1-4,1,4,0,24,28,-4,New Orleans Saints,17
2012-10-07,Denver Broncos,New England Patriots,21,31,2012,5,domingo,Regular Season,2-3,2,3,0,17,13,4,3-2,3,2,0,5,6,-1,New England Patriots,7
2012-10-07,Tennessee Titans,Minnesota Vikings,7,30,2012,5,domingo,Regular Season,1-4,1,4,0,28,25,3,4-1,4,1,0,8,14,-6,Minnesota Vikings,11
2012-10-07,Baltimore Ravens,Kansas City Chiefs,9,6,2012,5,domingo,Regular Season,4-1,4,1,0,4,3,1,1-4,1,4,0,30,27,3,Baltimore Ravens,24
2012-10-07,Chicago Bears,Jacksonville Jaguars,41,3,2012,5,domingo,Regular Season,4-1,4,1,0,6,9,-3,1-4,1,4,0,31,30,1,Chicago Bears,21
2012-10-07,Green Bay Packers,Indianapolis Colts,27,30,2012,5,domingo,Regular Season,2-3,2,3,0,12,8,4,2-2,2,2,0,22,31,-9,Indianapolis Colts,23
2012-10-07,Miami Dolphins,Cincinnati Bengals,17,13,2012,5,domingo,Regular Season,2-3,2,3,0,19,26,-7,3-2,3,2,0,15,12,3,Miami Dolphins,14
2012-10-07,Seattle Seahawks,Carolina Panthers,16,12,2012,5,domingo,Regular Season,3-2,3,2,0,16,17,-1,1-4,1,4,0,26,24,2,Seattle Seahawks,7
2012-10-04,Arizona Cardinals,Los Angeles Rams,3,17,2012,5,quinta,Regular Season,4-1,4,1,0,9,5,4,3-2,3,2,0,18,19,-1,Los Angeles Rams,14
2012-10-01,Chicago Bears,Dallas Cowboys,34,18,2012,4,segunda,Regular Season,3-1,3,1,0,9,11,-2,2-2,2,2,0,15,12,3,Chicago Bears,1
2012-09-30,Washington Redskins,Tampa Bay Buccaneers,24,22,2012,4,domingo,Regular Season,2-2,2,2,0,18,22,-4,1-3,1,3,0,22,20,2,Washington Redskins,2
2012-09-30,Seattle Seahawks,Los Angeles Rams,13,19,2012,4,domingo,Regular Season,2-2,2,2,0,17,10,7,2-2,2,2,0,19,25,-6,Los Angeles Rams,15
2012-09-30,New York Giants,Philadelphia Eagles,17,19,2012,4,domingo,Regular Season,2-2,2,2,0,10,6,4,3-1,3,1,0,7,9,-2,Philadelphia Eagles,3
2012-09-30,San Francisco 49ers,New York Jets,34,0,2012,4,domingo,Regular Season,3-1,3,1,0,4,4,0,2-2,2,2,0,23,17,6,San Francisco 49ers,13
2012-09-30,Los Angeles Chargers,Kansas City Chiefs,37,20,2012,4,domingo,Regular Season,3-1,3,1,0,11,13,-2,1-3,1,3,0,27,26,1,Los Angeles Chargers,13
2012-09-30,Cincinnati Bengals,Jacksonville Jaguars,27,10,2012,4,domingo,Regular Season,3-1,3,1,0,12,15,-3,1-3,1,3,0,30,30,0,Cincinnati Bengals,15
2012-09-30,Tennessee Titans,Houston Texans,14,38,2012,4,domingo,Regular Season,1-3,1,3,0,25,24,1,4-0,4,0,0,1,1,0,Houston Texans,23
2012-09-30,New Orleans Saints,Green Bay Packers,27,28,2012,4,domingo,Regular Season,0-4,0,4,0,28,28,0,2-2,2,2,0,8,7,1,Green Bay Packers,21
2012-09-30,Minnesota Vikings,Detroit Lions,20,13,2012,4,domingo,Regular Season,3-1,3,1,0,14,21,-7,1-3,1,3,0,20,18,2,Minnesota Vikings,3
2012-09-30,Oakland Raiders,Denver Broncos,6,37,2012,4,domingo,Regular Season,1-3,1,3,0,29,27,2,2-2,2,2,0,13,14,-1,Denver Broncos,13
2012-09-30,New England Patriots,Buffalo Bills,52,28,2012,4,domingo,Regular Season,2-2,2,2,0,6,8,-2,2-2,2,2,0,21,19,2,New England Patriots,11
2012-09-30,Carolina Panthers,Atlanta Falcons,28,30,2012,4,domingo,Regular Season,1-3,1,3,0,24,23,1,4-0,4,0,0,2,2,0,Atlanta Falcons,21
2012-09-30,Miami Dolphins,Arizona Cardinals,21,24,2012,4,domingo,Regular Season,1-3,1,3,0,26,29,-3,4-0,4,0,0,5,5,0,Arizona Cardinals,24
2012-09-27,Cleveland Browns,Baltimore Ravens,16,23,2012,4,quinta,Regular Season,0-4,0,4,0,32,32,0,3-1,3,1,0,3,3,0,Baltimore Ravens,29
2012-09-24,Green Bay Packers,Seattle Seahawks,12,14,2012,3,segunda,Regular Season,1-2,1,2,0,7,4,3,2-1,2,1,0,10,17,-7,Seattle Seahawks,13
2012-09-23,Cincinnati Bengals,Washington Redskins,38,31,2012,3,domingo,Regular Season,2-1,2,1,0,15,16,-1,1-2,1,2,0,22,20,2,Cincinnati Bengals,4
2012-09-23,Detroit Lions,Tennessee Titans,41,44,2012,3,domingo,Regular Season,1-2,1,2,0,18,13,5,1-2,1,2,0,24,26,-2,Tennessee Titans,13
2012-09-23,Atlanta Falcons,Los Angeles Chargers,27,3,2012,3,domingo,Regular Season,3-0,3,0,0,2,3,-1,2-1,2,1,0,13,11,2,Atlanta Falcons,8
2012-09-23,Pittsburgh Steelers,Oakland Raiders,31,34,2012,3,domingo,Regular Season,1-2,1,2,0,16,9,7,1-2,1,2,0,27,30,-3,Oakland Raiders,21
2012-09-23,Kansas City Chiefs,New Orleans Saints,27,24,2012,3,domingo,Regular Season,1-2,1,2,0,26,28,-2,0-3,0,3,0,28,24,4,Kansas City Chiefs,4
2012-09-23,San Francisco 49ers,Minnesota Vikings,13,24,2012,3,domingo,Regular Season,2-1,2,1,0,4,1,3,2-1,2,1,0,21,29,-8,Minnesota Vikings,28
2012-09-23,New York Jets,Miami Dolphins,23,20,2012,3,domingo,Regular Season,2-1,2,1,0,17,18,-1,1-2,1,2,0,29,25,4,New York Jets,7
2012-09-23,Jacksonville Jaguars,Indianapolis Colts,22,17,2012,3,domingo,Regular Season,1-2,1,2,0,30,31,-1,1-2,1,2,0,31,27,4,Jacksonville Jaguars,4
2012-09-23,Houston Texans,Denver Broncos,31,25,2012,3,domingo,Regular Season,3-0,3,0,0,1,2,-1,1-2,1,2,0,14,10,4,Houston Texans,8
2012-09-23,Tampa Bay Buccaneers,Dallas Cowboys,10,16,2012,3,domingo,Regular Season,1-2,1,2,0,20,21,-1,2-1,2,1,0,12,15,-3,Dallas Cowboys,6
2012-09-23,Buffalo Bills,Cleveland Browns,24,14,2012,3,domingo,Regular Season,2-1,2,1,0,19,22,-3,0-3,0,3,0,32,32,0,Buffalo Bills,10
2012-09-23,Los Angeles Rams,Chicago Bears,6,23,2012,3,domingo,Regular Season,1-2,1,2,0,25,23,2,2-1,2,1,0,11,12,-1,Chicago Bears,11
2012-09-23,New England Patriots,Baltimore Ravens,30,31,2012,3,domingo,Regular Season,1-2,1,2,0,8,5,3,2-1,2,1,0,3,6,-3,Baltimore Ravens,1
2012-09-23,Philadelphia Eagles,Arizona Cardinals,6,27,2012,3,domingo,Regular Season,2-1,2,1,0,9,7,2,3-0,3,0,0,5,14,-9,Arizona Cardinals,7
2012-09-20,New York Giants,Carolina Panthers,36,7,2012,3,quinta,Regular Season,2-1,2,1,0,6,8,-2,1-2,1,2,0,23,19,4,New York Giants,11
2012-09-17,Denver Broncos,Atlanta Falcons,21,27,2012,2,segunda,Regular Season,1-1,1,1,0,10,9,1,2-0,2,0,0,3,6,-3,Atlanta Falcons,3
2012-09-16,Washington Redskins,Los Angeles Rams,28,31,2012,2,domingo,Regular Season,1-1,1,1,0,20,15,5,1-1,1,1,0,23,27,-4,Los Angeles Rams,12
2012-09-16,Dallas Cowboys,Seattle Seahawks,7,27,2012,2,domingo,Regular Season,1-1,1,1,0,15,10,5,1-1,1,1,0,17,26,-9,Seattle Seahawks,16
2012-09-16,Detroit Lions,San Francisco 49ers,19,27,2012,2,domingo,Regular Season,1-1,1,1,0,13,13,0,2-0,2,0,0,1,2,-1,San Francisco 49ers,11
2012-09-16,Tennessee Titans,Los Angeles Chargers,10,38,2012,2,domingo,Regular Season,0-2,0,2,0,26,22,4,2-0,2,0,0,11,14,-3,Los Angeles Chargers,8
2012-09-16,New York Jets,Pittsburgh Steelers,10,27,2012,2,domingo,Regular Season,1-1,1,1,0,18,17,1,1-1,1,1,0,9,11,-2,Pittsburgh Steelers,6
2012-09-16,Baltimore Ravens,Philadelphia Eagles,23,24,2012,2,domingo,Regular Season,1-1,1,1,0,6,3,3,2-0,2,0,0,7,12,-5,Philadelphia Eagles,9
2012-09-16,Tampa Bay Buccaneers,New York Giants,34,41,2012,2,domingo,Regular Season,1-1,1,1,0,21,21,0,1-1,1,1,0,8,7,1,New York Giants,14
2012-09-16,Arizona Cardinals,New England Patriots,20,18,2012,2,domingo,Regular Season,2-0,2,0,0,14,20,-6,1-1,1,1,0,5,1,4,Arizona Cardinals,19
2012-09-16,Oakland Raiders,Miami Dolphins,13,35,2012,2,domingo,Regular Season,0-2,0,2,0,30,25,5,1-1,1,1,0,25,30,-5,Miami Dolphins,5
2012-09-16,Houston Texans,Jacksonville Jaguars,27,7,2012,2,domingo,Regular Season,2-0,2,0,0,2,4,-2,0-2,0,2,0,31,29,2,Houston Texans,25
2012-09-16,Minnesota Vikings,Indianapolis Colts,20,23,2012,2,domingo,Regular Season,1-1,1,1,0,29,28,1,1-1,1,1,0,27,32,-5,Indianapolis Colts,4
2012-09-16,Cleveland Browns,Cincinnati Bengals,27,34,2012,2,domingo,Regular Season,0-2,0,2,0,32,31,1,1-1,1,1,0,16,18,-2,Cincinnati Bengals,13
2012-09-16,New Orleans Saints,Carolina Panthers,27,35,2012,2,domingo,Regular Season,0-2,0,2,0,24,16,8,1-1,1,1,0,19,23,-4,Carolina Panthers,7
2012-09-16,Kansas City Chiefs,Buffalo Bills,17,35,2012,2,domingo,Regular Season,0-2,0,2,0,28,19,9,1-1,1,1,0,22,24,-2,Buffalo Bills,5
2012-09-13,Chicago Bears,Green Bay Packers,10,23,2012,2,quinta,Regular Season,1-1,1,1,0,12,8,4,1-1,1,1,0,4,5,-1,Green Bay Packers,3
2012-09-10,Los Angeles Chargers,Oakland Raiders,22,14,2012,1,segunda,Regular Season,1-0,1,0,0,14,15,-1,0-1,0,1,0,25,26,-1,Los Angeles Chargers,11
2012-09-10,Cincinnati Bengals,Baltimore Ravens,13,44,2012,1,segunda,Regular Season,0-1,0,1,0,18,16,2,1-0,1,0,0,3,6,-3,Baltimore Ravens,10
2012-09-09,New England Patriots,Tennessee Titans,34,13,2012,1,domingo,Regular Season,1-0,1,0,0,1,2,-1,0-1,0,1,0,22,18,4,New England Patriots,16
2012-09-09,Carolina Panthers,Tampa Bay Buccaneers,10,16,2012,1,domingo,Regular Season,0-1,0,1,0,23,22,1,1-0,1,0,0,21,25,-4,Tampa Bay Buccaneers,3
2012-09-09,Buffalo Bills,New York Jets,28,48,2012,1,domingo,Regular Season,0-1,0,1,0,24,19,5,1-0,1,0,0,17,21,-4,New York Jets,2
2012-09-09,Washington Redskins,New Orleans Saints,40,32,2012,1,domingo,Regular Season,1-0,1,0,0,15,24,-9,0-1,0,1,0,16,11,5,Washington Redskins,13
2012-09-09,Jacksonville Jaguars,Minnesota Vikings,23,26,2012,1,domingo,Regular Season,0-1,0,1,0,29,29,0,1-0,1,0,0,28,30,-2,Minnesota Vikings,1
2012-09-09,Atlanta Falcons,Kansas City Chiefs,40,24,2012,1,domingo,Regular Season,1-0,1,0,0,6,10,-4,0-1,0,1,0,19,17,2,Atlanta Falcons,7
2012-09-09,Miami Dolphins,Houston Texans,10,30,2012,1,domingo,Regular Season,0-1,0,1,0,30,27,3,1-0,1,0,0,4,5,-1,Houston Texans,22
2012-09-09,San Francisco 49ers,Green Bay Packers,30,22,2012,1,domingo,Regular Season,1-0,1,0,0,2,4,-2,0-1,0,1,0,5,1,4,San Francisco 49ers,3
2012-09-09,Los Angeles Rams,Detroit Lions,23,27,2012,1,domingo,Regular Season,0-1,0,1,0,27,28,-1,1-0,1,0,0,13,12,1,Detroit Lions,16
2012-09-09,Pittsburgh Steelers,Denver Broncos,19,31,2012,1,domingo,Regular Season,0-1,0,1,0,11,8,3,1-0,1,0,0,9,13,-4,Denver Broncos,5
2012-09-09,Philadelphia Eagles,Cleveland Browns,17,16,2012,1,domingo,Regular Season,1-0,1,0,0,12,7,5,0-1,0,1,0,31,31,0,Philadelphia Eagles,24
2012-09-09,Indianapolis Colts,Chicago Bears,21,41,2012,1,domingo,Regular Season,0-1,0,1,0,32,32,0,1-0,1,0,0,8,9,-1,Chicago Bears,23
2012-09-09,Seattle Seahawks,Arizona Cardinals,16,20,2012,1,domingo,Regular Season,0-1,0,1,0,26,20,6,1-0,1,0,0,20,23,-3,Arizona Cardinals,3
2012-09-05,Dallas Cowboys,New York Giants,24,17,2012,1,quarta,Regular Season,1-0,1,0,0,10,14,-4,0-1,0,1,0,7,3,4,Dallas Cowboys,11
2012-01-01,San Francisco 49ers,Los Angeles Rams,34,27,2011,17,domingo,Regular Season,13-3,13,3,0,3,3,0,2-14,2,14,0,31,32,-1,San Francisco 49ers,29
2012-01-01,Washington Redskins,Philadelphia Eagles,10,34,2011,17,domingo,Regular Season,5-11,5,11,0,26,26,0,8-8,8,8,0,15,17,-2,Philadelphia Eagles,9
2012-01-01,Los Angeles Chargers,Oakland Raiders,38,26,2011,17,domingo,Regular Season,8-8,8,8,0,16,19,-3,8-8,8,8,0,17,14,3,Los Angeles Chargers,5
2012-01-01,Dallas Cowboys,New York Giants,14,31,2011,17,domingo,Regular Season,8-8,8,8,0,13,11,2,9-7,9,7,0,9,12,-3,New York Giants,1
2012-01-01,Carolina Panthers,New Orleans Saints,17,45,2011,17,domingo,Regular Season,6-10,6,10,0,23,21,2,13-3,13,3,0,2,2,0,New Orleans Saints,19
2012-01-01,Buffalo Bills,New England Patriots,21,49,2011,17,domingo,Regular Season,6-10,6,10,0,25,25,0,13-3,13,3,0,4,4,0,New England Patriots,21
2012-01-01,Chicago Bears,Minnesota Vikings,17,13,2011,17,domingo,Regular Season,8-8,8,8,0,20,22,-2,3-13,3,13,0,30,30,0,Chicago Bears,8
2012-01-01,New York Jets,Miami Dolphins,17,19,2011,17,domingo,Regular Season,8-8,8,8,0,19,16,3,6-10,6,10,0,24,24,0,Miami Dolphins,8
2012-01-01,Indianapolis Colts,Jacksonville Jaguars,13,19,2011,17,domingo,Regular Season,2-14,2,14,0,32,31,1,5-11,5,11,0,27,27,0,Jacksonville Jaguars,4
2012-01-01,Tennessee Titans,Houston Texans,23,22,2011,17,domingo,Regular Season,9-7,9,7,0,12,15,-3,10-6,10,6,0,10,9,1,Tennessee Titans,6
2012-01-01,Detroit Lions,Green Bay Packers,41,45,2011,17,domingo,Regular Season,10-6,10,6,0,8,7,1,15-1,15,1,0,1,1,0,Green Bay Packers,6
2012-01-01,Kansas City Chiefs,Denver Broncos,7,3,2011,17,domingo,Regular Season,7-9,7,9,0,22,23,-1,8-8,8,8,0,14,13,1,Kansas City Chiefs,10
2012-01-01,Pittsburgh Steelers,Cleveland Browns,13,9,2011,17,domingo,Regular Season,12-4,12,4,0,6,6,0,4-12,4,12,0,28,28,0,Pittsburgh Steelers,22
2012-01-01,Baltimore Ravens,Cincinnati Bengals,24,16,2011,17,domingo,Regular Season,12-4,12,4,0,5,5,0,9-7,9,7,0,11,10,1,Baltimore Ravens,5
2012-01-01,Tampa Bay Buccaneers,Atlanta Falcons,24,45,2011,17,domingo,Regular Season,4-12,4,12,0,29,29,0,10-6,10,6,0,7,8,-1,Atlanta Falcons,21
2012-01-01,Seattle Seahawks,Arizona Cardinals,20,23,2011,17,domingo,Regular Season,7-9,7,9,0,21,18,3,8-8,8,8,0,18,20,-2,Arizona Cardinals,2
2011-12-26,Atlanta Falcons,New Orleans Saints,16,45,2011,16,segunda,Regular Season,9-6,9,6,0,8,8,0,12-3,12,3,0,2,2,0,New Orleans Saints,6
2011-12-25,Chicago Bears,Green Bay Packers,21,35,2011,16,domingo,Regular Season,7-8,7,8,0,22,21,1,14-1,14,1,0,1,1,0,Green Bay Packers,20
2011-12-24,Minnesota Vikings,Washington Redskins,33,26,2011,16,sábado,Regular Season,3-12,3,12,0,30,30,0,5-10,5,10,0,26,25,1,Minnesota Vikings,5
2011-12-24,Jacksonville Jaguars,Tennessee Titans,17,23,2011,16,sábado,Regular Season,4-11,4,11,0,27,27,0,8-7,8,7,0,15,20,-5,Tennessee Titans,7
2011-12-24,San Francisco 49ers,Seattle Seahawks,19,17,2011,16,sábado,Regular Season,12-3,12,3,0,3,3,0,7-8,7,8,0,18,15,3,San Francisco 49ers,12
2011-12-24,Los Angeles Rams,Pittsburgh Steelers,0,27,2011,16,sábado,Regular Season,2-13,2,13,0,32,31,1,11-4,11,4,0,6,6,0,Pittsburgh Steelers,25
2011-12-24,New York Giants,New York Jets,29,14,2011,16,sábado,Regular Season,8-7,8,7,0,12,16,-4,8-7,8,7,0,16,12,4,New York Giants,4
2011-12-24,Miami Dolphins,New England Patriots,24,27,2011,16,sábado,Regular Season,5-10,5,10,0,24,23,1,12-3,12,3,0,4,4,0,New England Patriots,19
2011-12-24,Oakland Raiders,Kansas City Chiefs,16,13,2011,16,sábado,Regular Season,8-7,8,7,0,14,19,-5,6-9,6,9,0,23,22,1,Oakland Raiders,3
2011-12-24,Los Angeles Chargers,Detroit Lions,10,38,2011,16,sábado,Regular Season,7-8,7,8,0,19,14,5,10-5,10,5,0,7,9,-2,Detroit Lions,5
2011-12-24,Philadelphia Eagles,Dallas Cowboys,20,7,2011,16,sábado,Regular Season,7-8,7,8,0,17,18,-1,8-7,8,7,0,11,10,1,Philadelphia Eagles,8
2011-12-24,Arizona Cardinals,Cincinnati Bengals,16,23,2011,16,sábado,Regular Season,7-8,7,8,0,20,17,3,9-6,9,6,0,10,13,-3,Cincinnati Bengals,4
2011-12-24,Tampa Bay Buccaneers,Carolina Panthers,16,48,2011,16,sábado,Regular Season,4-11,4,11,0,29,29,0,6-9,6,9,0,21,24,-3,Carolina Panthers,5
2011-12-24,Denver Broncos,Buffalo Bills,14,40,2011,16,sábado,Regular Season,8-7,8,7,0,13,11,2,6-9,6,9,0,25,26,-1,Buffalo Bills,15
2011-12-24,Cleveland Browns,Baltimore Ravens,14,20,2011,16,sábado,Regular Season,4-11,4,11,0,28,28,0,11-4,11,4,0,5,5,0,Baltimore Ravens,23
2011-12-22,Houston Texans,Indianapolis Colts,16,19,2011,16,quinta,Regular Season,10-5,10,5,0,9,7,2,2-13,2,13,0,31,32,-1,Indianapolis Colts,25
2011-12-19,Pittsburgh Steelers,San Francisco 49ers,3,20,2011,15,segunda,Regular Season,10-4,10,4,0,6,4,2,11-3,11,3,0,3,6,-3,San Francisco 49ers,2
2011-12-18,Cincinnati Bengals,Los Angeles Rams,20,13,2011,15,domingo,Regular Season,8-6,8,6,0,13,15,-2,2-12,2,12,0,31,31,0,Cincinnati Bengals,16
2011-12-18,Baltimore Ravens,Los Angeles Chargers,14,34,2011,15,domingo,Regular Season,10-4,10,4,0,5,2,3,7-7,7,7,0,14,18,-4,Los Angeles Chargers,16
2011-12-18,New York Jets,Philadelphia Eagles,19,45,2011,15,domingo,Regular Season,8-6,8,6,0,12,10,2,6-8,6,8,0,18,21,-3,Philadelphia Eagles,11
2011-12-18,Detroit Lions,Oakland Raiders,28,27,2011,15,domingo,Regular Season,9-5,9,5,0,9,11,-2,7-7,7,7,0,19,16,3,Detroit Lions,5
2011-12-18,Washington Redskins,New York Giants,23,10,2011,15,domingo,Regular Season,5-9,5,9,0,25,27,-2,7-7,7,7,0,16,12,4,Washington Redskins,15
2011-12-18,New Orleans Saints,Minnesota Vikings,42,20,2011,15,domingo,Regular Season,11-3,11,3,0,2,3,-1,2-12,2,12,0,30,30,0,New Orleans Saints,27
2011-12-18,Green Bay Packers,Kansas City Chiefs,14,19,2011,15,domingo,Regular Season,13-1,13,1,0,1,1,0,6-8,6,8,0,22,25,-3,Kansas City Chiefs,24
2011-12-18,Tennessee Titans,Indianapolis Colts,13,27,2011,15,domingo,Regular Season,7-7,7,7,0,20,13,7,1-13,1,13,0,32,32,0,Indianapolis Colts,19
2011-12-18,Carolina Panthers,Houston Texans,28,13,2011,15,domingo,Regular Season,5-9,5,9,0,24,24,0,10-4,10,4,0,7,7,0,Carolina Panthers,17
2011-12-18,New England Patriots,Denver Broncos,41,23,2011,15,domingo,Regular Season,11-3,11,3,0,4,5,-1,8-6,8,6,0,11,9,2,New England Patriots,4
2011-12-18,Seattle Seahawks,Chicago Bears,38,14,2011,15,domingo,Regular Season,7-7,7,7,0,15,20,-5,7-7,7,7,0,21,17,4,Seattle Seahawks,3
2011-12-18,Miami Dolphins,Buffalo Bills,30,23,2011,15,domingo,Regular Season,5-9,5,9,0,23,23,0,5-9,5,9,0,26,22,4,Miami Dolphins,1
2011-12-18,Cleveland Browns,Arizona Cardinals,17,20,2011,15,domingo,Regular Season,4-10,4,10,0,28,29,-1,7-7,7,7,0,17,19,-2,Arizona Cardinals,10
2011-12-17,Dallas Cowboys,Tampa Bay Buccaneers,31,15,2011,15,sábado,Regular Season,8-6,8,6,0,10,14,-4,4-10,4,10,0,29,28,1,Dallas Cowboys,14
2011-12-15,Jacksonville Jaguars,Atlanta Falcons,14,41,2011,15,quinta,Regular Season,4-10,4,10,0,27,26,1,9-5,9,5,0,8,8,0,Atlanta Falcons,18
2011-12-12,Los Angeles Rams,Seattle Seahawks,13,30,2011,14,segunda,Regular Season,2-11,2,11,0,31,31,0,6-7,6,7,0,20,19,1,Seattle Seahawks,12
2011-12-11,New England Patriots,Washington Redskins,34,27,2011,14,domingo,Regular Season,10-3,10,3,0,5,6,-1,4-9,4,9,0,27,27,0,New England Patriots,21
2011-12-11,New Orleans Saints,Tennessee Titans,22,17,2011,14,domingo,Regular Season,10-3,10,3,0,3,4,-1,7-6,7,6,0,13,13,0,New Orleans Saints,9
2011-12-11,Buffalo Bills,Los Angeles Chargers,10,37,2011,14,domingo,Regular Season,5-8,5,8,0,22,20,2,6-7,6,7,0,18,21,-3,Los Angeles Chargers,1
2011-12-11,Kansas City Chiefs,New York Jets,10,37,2011,14,domingo,Regular Season,5-8,5,8,0,25,23,2,8-5,8,5,0,10,11,-1,New York Jets,12
2011-12-11,Philadelphia Eagles,Miami Dolphins,26,10,2011,14,domingo,Regular Season,5-8,5,8,0,21,24,-3,4-9,4,9,0,23,22,1,Philadelphia Eagles,2
2011-12-11,Tampa Bay Buccaneers,Jacksonville Jaguars,14,41,2011,14,domingo,Regular Season,4-9,4,9,0,28,26,2,4-9,4,9,0,26,29,-3,Jacksonville Jaguars,3
2011-12-11,Oakland Raiders,Green Bay Packers,16,46,2011,14,domingo,Regular Season,7-6,7,6,0,16,15,1,13-0,13,0,0,1,1,0,Green Bay Packers,14
2011-12-11,Minnesota Vikings,Detroit Lions,28,34,2011,14,domingo,Regular Season,2-11,2,11,0,30,30,0,8-5,8,5,0,11,12,-1,Detroit Lions,18
2011-12-11,Chicago Bears,Denver Broncos,10,13,2011,14,domingo,Regular Season,7-6,7,6,0,17,17,0,8-5,8,5,0,9,10,-1,Denver Broncos,7
2011-12-11,New York Giants,Dallas Cowboys,37,34,2011,14,domingo,Regular Season,7-6,7,6,0,12,16,-4,7-6,7,6,0,14,9,5,New York Giants,7
2011-12-11,Houston Texans,Cincinnati Bengals,20,19,2011,14,domingo,Regular Season,10-3,10,3,0,7,7,0,7-6,7,6,0,15,14,1,Houston Texans,7
2011-12-11,Atlanta Falcons,Carolina Panthers,31,23,2011,14,domingo,Regular Season,8-5,8,5,0,8,8,0,4-9,4,9,0,24,25,-1,Atlanta Falcons,17
2011-12-11,Indianapolis Colts,Baltimore Ravens,10,24,2011,14,domingo,Regular Season,0-13,0,13,0,32,32,0,10-3,10,3,0,2,2,0,Baltimore Ravens,30
2011-12-11,San Francisco 49ers,Arizona Cardinals,19,21,2011,14,domingo,Regular Season,10-3,10,3,0,6,3,3,6-7,6,7,0,19,18,1,Arizona Cardinals,15
2011-12-08,Cleveland Browns,Pittsburgh Steelers,3,14,2011,14,quinta,Regular Season,4-9,4,9,0,29,28,1,10-3,10,3,0,4,5,-1,Pittsburgh Steelers,23
2011-12-05,Los Angeles Chargers,Jacksonville Jaguars,38,14,2011,13,segunda,Regular Season,5-7,5,7,0,21,22,-1,3-9,3,9,0,29,29,0,Los Angeles Chargers,7
2011-12-04,New York Jets,Washington Redskins,34,19,2011,13,domingo,Regular Season,7-5,7,5,0,11,15,-4,4-8,4,8,0,27,23,4,New York Jets,8
2011-12-04,Carolina Panthers,Tampa Bay Buccaneers,38,19,2011,13,domingo,Regular Season,4-8,4,8,0,25,28,-3,4-8,4,8,0,26,20,6,Carolina Panthers,8
2011-12-04,Los Angeles Rams,San Francisco 49ers,0,26,2011,13,domingo,Regular Season,2-10,2,10,0,31,31,0,10-2,10,2,0,3,3,0,San Francisco 49ers,28
2011-12-04,Cincinnati Bengals,Pittsburgh Steelers,7,35,2011,13,domingo,Regular Season,7-5,7,5,0,14,13,1,9-3,9,3,0,5,5,0,Pittsburgh Steelers,8
2011-12-04,Green Bay Packers,New York Giants,38,35,2011,13,domingo,Regular Season,12-0,12,0,0,1,1,0,6-6,6,6,0,16,14,2,Green Bay Packers,13
2011-12-04,Detroit Lions,New Orleans Saints,17,31,2011,13,domingo,Regular Season,7-5,7,5,0,12,11,1,9-3,9,3,0,4,4,0,New Orleans Saints,7
2011-12-04,Indianapolis Colts,New England Patriots,24,31,2011,13,domingo,Regular Season,0-12,0,12,0,32,32,0,9-3,9,3,0,6,6,0,New England Patriots,26
2011-12-04,Denver Broncos,Minnesota Vikings,35,32,2011,13,domingo,Regular Season,7-5,7,5,0,10,16,-6,2-10,2,10,0,30,30,0,Denver Broncos,14
2011-12-04,Oakland Raiders,Miami Dolphins,14,34,2011,13,domingo,Regular Season,7-5,7,5,0,15,10,5,4-8,4,8,0,22,26,-4,Miami Dolphins,16
2011-12-04,Atlanta Falcons,Houston Texans,10,17,2011,13,domingo,Regular Season,7-5,7,5,0,8,9,-1,9-3,9,3,0,7,7,0,Houston Texans,2
2011-12-04,Baltimore Ravens,Cleveland Browns,24,10,2011,13,domingo,Regular Season,9-3,9,3,0,2,2,0,4-8,4,8,0,28,27,1,Baltimore Ravens,25
2011-12-04,Kansas City Chiefs,Chicago Bears,10,3,2011,13,domingo,Regular Season,5-7,5,7,0,23,21,2,7-5,7,5,0,17,12,5,Kansas City Chiefs,9
2011-12-04,Tennessee Titans,Buffalo Bills,23,17,2011,13,domingo,Regular Season,7-5,7,5,0,13,17,-4,5-7,5,7,0,20,19,1,Tennessee Titans,2
2011-12-04,Dallas Cowboys,Arizona Cardinals,13,19,2011,13,domingo,Regular Season,7-5,7,5,0,9,8,1,5-7,5,7,0,18,25,-7,Arizona Cardinals,17
2011-12-01,Philadelphia Eagles,Seattle Seahawks,14,31,2011,13,quinta,Regular Season,4-8,4,8,0,24,18,6,5-7,5,7,0,19,24,-5,Seattle Seahawks,6
2011-11-28,New York Giants,New Orleans Saints,24,49,2011,12,segunda,Regular Season,6-5,6,5,0,14,12,2,8-3,8,3,0,4,3,1,New Orleans Saints,9
2011-11-27,Tampa Bay Buccaneers,Tennessee Titans,17,23,2011,12,domingo,Regular Season,4-7,4,7,0,20,20,0,6-5,6,5,0,17,16,1,Tennessee Titans,4
2011-11-27,Arizona Cardinals,Los Angeles Rams,23,20,2011,12,domingo,Regular Season,4-7,4,7,0,25,27,-2,2-9,2,9,0,31,31,0,Arizona Cardinals,4
2011-11-27,Washington Redskins,Seattle Seahawks,23,17,2011,12,domingo,Regular Season,4-7,4,7,0,23,26,-3,4-7,4,7,0,24,23,1,Washington Redskins,3
2011-11-27,Denver Broncos,Los Angeles Chargers,16,13,2011,12,domingo,Regular Season,6-5,6,5,0,16,17,-1,4-7,4,7,0,22,21,1,Denver Broncos,4
2011-11-27,New England Patriots,Philadelphia Eagles,38,20,2011,12,domingo,Regular Season,8-3,8,3,0,6,6,0,4-7,4,7,0,18,18,0,New England Patriots,12
2011-11-27,Chicago Bears,Oakland Raiders,20,25,2011,12,domingo,Regular Season,7-4,7,4,0,12,7,5,7-4,7,4,0,10,14,-4,Oakland Raiders,7
2011-11-27,Buffalo Bills,New York Jets,24,28,2011,12,domingo,Regular Season,5-6,5,6,0,19,19,0,6-5,6,5,0,15,15,0,New York Jets,4
2011-11-27,Pittsburgh Steelers,Kansas City Chiefs,13,9,2011,12,domingo,Regular Season,8-3,8,3,0,5,4,1,4-7,4,7,0,21,22,-1,Pittsburgh Steelers,18
2011-11-27,Houston Texans,Jacksonville Jaguars,20,13,2011,12,domingo,Regular Season,8-3,8,3,0,7,8,-1,3-8,3,8,0,29,28,1,Houston Texans,20
2011-11-27,Carolina Panthers,Indianapolis Colts,27,19,2011,12,domingo,Regular Season,3-8,3,8,0,28,30,-2,0-11,0,11,0,32,32,0,Carolina Panthers,2
2011-11-27,Cleveland Browns,Cincinnati Bengals,20,23,2011,12,domingo,Regular Season,4-7,4,7,0,27,24,3,7-4,7,4,0,13,13,0,Cincinnati Bengals,11
2011-11-27,Minnesota Vikings,Atlanta Falcons,14,24,2011,12,domingo,Regular Season,2-9,2,9,0,30,29,1,7-4,7,4,0,9,11,-2,Atlanta Falcons,18
2011-11-24,Green Bay Packers,Detroit Lions,27,15,2011,12,quinta,Regular Season,11-0,11,0,0,1,1,0,7-4,7,4,0,11,10,1,Green Bay Packers,9
2011-11-24,Miami Dolphins,Dallas Cowboys,19,20,2011,12,quinta,Regular Season,3-8,3,8,0,26,25,1,7-4,7,4,0,8,9,-1,Dallas Cowboys,16
2011-11-24,San Francisco 49ers,Baltimore Ravens,6,16,2011,12,quinta,Regular Season,9-2,9,2,0,3,2,1,8-3,8,3,0,2,5,-3,Baltimore Ravens,3
2011-11-21,Kansas City Chiefs,New England Patriots,3,34,2011,11,segunda,Regular Season,4-6,4,6,0,22,21,1,7-3,7,3,0,6,8,-2,New England Patriots,13
2011-11-20,Dallas Cowboys,Washington Redskins,27,24,2011,11,domingo,Regular Season,6-4,6,4,0,9,12,-3,3-7,3,7,0,26,26,0,Dallas Cowboys,14
2011-11-20,Seattle Seahawks,Los Angeles Rams,24,7,2011,11,domingo,Regular Season,4-6,4,6,0,23,24,-1,2-8,2,8,0,31,30,1,Seattle Seahawks,6
2011-11-20,Arizona Cardinals,San Francisco 49ers,7,23,2011,11,domingo,Regular Season,3-7,3,7,0,27,23,4,9-1,9,1,0,2,2,0,San Francisco 49ers,21
2011-11-20,Philadelphia Eagles,New York Giants,17,10,2011,11,domingo,Regular Season,4-6,4,6,0,18,22,-4,6-4,6,4,0,12,7,5,Philadelphia Eagles,15
2011-11-20,Oakland Raiders,Minnesota Vikings,27,21,2011,11,domingo,Regular Season,6-4,6,4,0,14,16,-2,2-8,2,8,0,29,27,2,Oakland Raiders,11
2011-11-20,Buffalo Bills,Miami Dolphins,8,35,2011,11,domingo,Regular Season,5-5,5,5,0,19,17,2,3-7,3,7,0,25,29,-4,Miami Dolphins,12
2011-11-20,Tampa Bay Buccaneers,Green Bay Packers,26,35,2011,11,domingo,Regular Season,4-6,4,6,0,20,20,0,10-0,10,0,0,1,1,0,Green Bay Packers,19
2011-11-20,Carolina Panthers,Detroit Lions,35,49,2011,11,domingo,Regular Season,2-8,2,8,0,30,31,-1,7-3,7,3,0,10,10,0,Detroit Lions,21
2011-11-20,Jacksonville Jaguars,Cleveland Browns,10,14,2011,11,domingo,Regular Season,3-7,3,7,0,28,25,3,4-6,4,6,0,24,28,-4,Cleveland Browns,3
2011-11-20,Los Angeles Chargers,Chicago Bears,20,31,2011,11,domingo,Regular Season,4-6,4,6,0,21,18,3,7-3,7,3,0,7,5,2,Chicago Bears,13
2011-11-20,Cincinnati Bengals,Baltimore Ravens,24,31,2011,11,domingo,Regular Season,6-4,6,4,0,13,11,2,7-3,7,3,0,5,6,-1,Baltimore Ravens,5
2011-11-20,Tennessee Titans,Atlanta Falcons,17,23,2011,11,domingo,Regular Season,5-5,5,5,0,16,15,1,6-4,6,4,0,11,13,-2,Atlanta Falcons,2
2011-11-17,New York Jets,Denver Broncos,13,17,2011,11,quinta,Regular Season,5-5,5,5,0,15,14,1,5-5,5,5,0,17,19,-2,Denver Broncos,5
2011-11-14,Minnesota Vikings,Green Bay Packers,7,45,2011,10,segunda,Regular Season,2-7,2,7,0,27,24,3,9-0,9,0,0,1,1,0,Green Bay Packers,23
2011-11-13,Houston Texans,Tampa Bay Buccaneers,37,9,2011,10,domingo,Regular Season,7-3,7,3,0,9,8,1,4-5,4,5,0,20,18,2,Houston Texans,10
2011-11-13,Baltimore Ravens,Seattle Seahawks,17,22,2011,10,domingo,Regular Season,6-3,6,3,0,6,3,3,3-6,3,6,0,24,28,-4,Seattle Seahawks,25
2011-11-13,New York Giants,San Francisco 49ers,20,27,2011,10,domingo,Regular Season,6-3,6,3,0,7,6,1,8-1,8,1,0,2,2,0,San Francisco 49ers,4
2011-11-13,Arizona Cardinals,Philadelphia Eagles,21,17,2011,10,domingo,Regular Season,3-6,3,6,0,23,29,-6,3-6,3,6,0,22,16,6,Arizona Cardinals,13
2011-11-13,New England Patriots,New York Jets,37,16,2011,10,domingo,Regular Season,6-3,6,3,0,8,12,-4,5-4,5,4,0,14,11,3,New England Patriots,1
2011-11-13,Washington Redskins,Miami Dolphins,9,20,2011,10,domingo,Regular Season,3-6,3,6,0,26,22,4,2-7,2,7,0,29,31,-2,Miami Dolphins,9
2011-11-13,Denver Broncos,Kansas City Chiefs,17,10,2011,10,domingo,Regular Season,4-5,4,5,0,19,23,-4,4-5,4,5,0,21,19,2,Denver Broncos,4
2011-11-13,Jacksonville Jaguars,Indianapolis Colts,17,3,2011,10,domingo,Regular Season,3-6,3,6,0,25,27,-2,0-10,0,10,0,32,32,0,Jacksonville Jaguars,5
2011-11-13,Buffalo Bills,Dallas Cowboys,7,44,2011,10,domingo,Regular Season,5-4,5,4,0,17,14,3,5-4,5,4,0,12,15,-3,Dallas Cowboys,1
2011-11-13,Los Angeles Rams,Cleveland Browns,13,12,2011,10,domingo,Regular Season,2-7,2,7,0,30,30,0,3-6,3,6,0,28,25,3,Los Angeles Rams,5
2011-11-13,Pittsburgh Steelers,Cincinnati Bengals,24,17,2011,10,domingo,Regular Season,7-3,7,3,0,4,5,-1,6-3,6,3,0,11,10,1,Pittsburgh Steelers,5
2011-11-13,Detroit Lions,Chicago Bears,13,37,2011,10,domingo,Regular Season,6-3,6,3,0,10,7,3,6-3,6,3,0,5,9,-4,Chicago Bears,2
2011-11-13,Tennessee Titans,Carolina Panthers,30,3,2011,10,domingo,Regular Season,5-4,5,4,0,15,20,-5,2-7,2,7,0,31,26,5,Tennessee Titans,6
2011-11-13,New Orleans Saints,Atlanta Falcons,26,23,2011,10,domingo,Regular Season,7-3,7,3,0,3,4,-1,5-4,5,4,0,13,13,0,New Orleans Saints,9
2011-11-10,Oakland Raiders,Los Angeles Chargers,24,17,2011,10,quinta,Regular Season,5-4,5,4,0,16,21,-5,4-5,4,5,0,18,17,1,Oakland Raiders,4
2011-11-07,Chicago Bears,Philadelphia Eagles,30,24,2011,9,segunda,Regular Season,5-3,5,3,0,9,10,-1,3-5,3,5,0,16,16,0,Chicago Bears,6
2011-11-06,San Francisco 49ers,Washington Redskins,19,11,2011,9,domingo,Regular Season,7-1,7,1,0,2,2,0,3-5,3,5,0,22,22,0,San Francisco 49ers,20
2011-11-06,Cincinnati Bengals,Tennessee Titans,24,17,2011,9,domingo,Regular Season,6-2,6,2,0,10,14,-4,4-4,4,4,0,20,20,0,Cincinnati Bengals,6
2011-11-06,Green Bay Packers,Los Angeles Chargers,45,38,2011,9,domingo,Regular Season,8-0,8,0,0,1,1,0,4-4,4,4,0,17,15,2,Green Bay Packers,14
2011-11-06,Baltimore Ravens,Pittsburgh Steelers,23,20,2011,9,domingo,Regular Season,6-2,6,2,0,3,4,-1,6-3,6,3,0,5,3,2,Baltimore Ravens,1
2011-11-06,Denver Broncos,Oakland Raiders,38,24,2011,9,domingo,Regular Season,3-5,3,5,0,23,28,-5,4-4,4,4,0,21,17,4,Denver Broncos,11
2011-11-06,Tampa Bay Buccaneers,New Orleans Saints,16,27,2011,9,domingo,Regular Season,4-4,4,4,0,18,19,-1,6-3,6,3,0,4,6,-2,New Orleans Saints,13
2011-11-06,New York Giants,New England Patriots,24,20,2011,9,domingo,Regular Season,6-2,6,2,0,6,9,-3,5-3,5,3,0,12,5,7,New York Giants,4
2011-11-06,Miami Dolphins,Kansas City Chiefs,31,3,2011,9,domingo,Regular Season,1-7,1,7,0,31,31,0,4-4,4,4,0,19,18,1,Miami Dolphins,13
2011-11-06,Atlanta Falcons,Indianapolis Colts,31,7,2011,9,domingo,Regular Season,5-3,5,3,0,13,12,1,0-9,0,9,0,32,32,0,Atlanta Falcons,20
2011-11-06,Cleveland Browns,Houston Texans,12,30,2011,9,domingo,Regular Season,3-5,3,5,0,25,24,1,6-3,6,3,0,8,11,-3,Houston Texans,13
2011-11-06,Seattle Seahawks,Dallas Cowboys,13,23,2011,9,domingo,Regular Season,2-6,2,6,0,28,27,1,4-4,4,4,0,15,21,-6,Dallas Cowboys,6
2011-11-06,New York Jets,Buffalo Bills,27,11,2011,9,domingo,Regular Season,5-3,5,3,0,11,13,-2,5-3,5,3,0,14,7,7,New York Jets,6
2011-11-06,Los Angeles Rams,Arizona Cardinals,13,19,2011,9,domingo,Regular Season,1-7,1,7,0,30,29,1,2-6,2,6,0,29,30,-1,Arizona Cardinals,1
2011-10-31,Los Angeles Chargers,Kansas City Chiefs,20,23,2011,8,segunda,Regular Season,4-3,4,3,0,15,9,6,4-3,4,3,0,18,21,-3,Kansas City Chiefs,12
2011-10-30,Indianapolis Colts,Tennessee Titans,10,27,2011,8,domingo,Regular Season,0-8,0,8,0,32,32,0,4-3,4,3,0,20,19,1,Tennessee Titans,13
2011-10-30,New Orleans Saints,Los Angeles Rams,21,31,2011,8,domingo,Regular Season,5-3,5,3,0,6,3,3,1-6,1,6,0,29,30,-1,Los Angeles Rams,27
2011-10-30,Cincinnati Bengals,Seattle Seahawks,34,12,2011,8,domingo,Regular Season,5-2,5,2,0,14,16,-2,2-5,2,5,0,27,26,1,Cincinnati Bengals,10
2011-10-30,Cleveland Browns,San Francisco 49ers,10,20,2011,8,domingo,Regular Season,3-4,3,4,0,24,24,0,6-1,6,1,0,2,4,-2,San Francisco 49ers,20
2011-10-30,New England Patriots,Pittsburgh Steelers,17,25,2011,8,domingo,Regular Season,5-2,5,2,0,5,2,3,6-2,6,2,0,3,5,-2,Pittsburgh Steelers,3
2011-10-30,Dallas Cowboys,Philadelphia Eagles,7,34,2011,8,domingo,Regular Season,3-4,3,4,0,21,18,3,3-4,3,4,0,16,22,-6,Philadelphia Eagles,4
2011-10-30,Miami Dolphins,New York Giants,17,20,2011,8,domingo,Regular Season,0-7,0,7,0,31,31,0,5-2,5,2,0,9,11,-2,New York Giants,20
2011-10-30,Jacksonville Jaguars,Houston Texans,14,24,2011,8,domingo,Regular Season,2-6,2,6,0,26,25,1,5-3,5,3,0,11,12,-1,Houston Texans,13
2011-10-30,Detroit Lions,Denver Broncos,45,10,2011,8,domingo,Regular Season,6-2,6,2,0,8,8,0,2-5,2,5,0,28,27,1,Detroit Lions,19
2011-10-30,Minnesota Vikings,Carolina Panthers,24,21,2011,8,domingo,Regular Season,2-6,2,6,0,23,28,-5,2-6,2,6,0,25,23,2,Minnesota Vikings,5
2011-10-30,Washington Redskins,Buffalo Bills,0,23,2011,8,domingo,Regular Season,3-4,3,4,0,22,20,2,5-2,5,2,0,7,7,0,Buffalo Bills,13
2011-10-30,Arizona Cardinals,Baltimore Ravens,27,30,2011,8,domingo,Regular Season,1-6,1,6,0,30,29,1,5-2,5,2,0,4,6,-2,Baltimore Ravens,23
2011-10-24,Baltimore Ravens,Jacksonville Jaguars,7,12,2011,7,segunda,Regular Season,4-2,4,2,0,6,3,3,2-5,2,5,0,25,29,-4,Jacksonville Jaguars,26
2011-10-23,Houston Texans,Tennessee Titans,41,7,2011,7,domingo,Regular Season,4-3,4,3,0,12,17,-5,3-3,3,3,0,19,13,6,Houston Texans,4
2011-10-23,Chicago Bears,Tampa Bay Buccaneers,24,18,2011,7,domingo,Regular Season,4-3,4,3,0,10,14,-4,4-3,4,3,0,17,12,5,Chicago Bears,2
2011-10-23,Kansas City Chiefs,Oakland Raiders,28,0,2011,7,domingo,Regular Season,3-3,3,3,0,21,24,-3,4-3,4,3,0,15,9,6,Kansas City Chiefs,15
2011-10-23,Los Angeles Chargers,New York Jets,21,27,2011,7,domingo,Regular Season,4-2,4,2,0,9,7,2,4-3,4,3,0,13,16,-3,New York Jets,9
2011-10-23,Indianapolis Colts,New Orleans Saints,7,62,2011,7,domingo,Regular Season,0-7,0,7,0,32,32,0,5-2,5,2,0,3,5,-2,New Orleans Saints,27
2011-10-23,Green Bay Packers,Minnesota Vikings,33,27,2011,7,domingo,Regular Season,7-0,7,0,0,1,1,0,1-6,1,6,0,28,28,0,Green Bay Packers,27
2011-10-23,Denver Broncos,Miami Dolphins,18,15,2011,7,domingo,Regular Season,2-4,2,4,0,27,27,0,0-6,0,6,0,31,30,1,Denver Broncos,3
2011-10-23,Atlanta Falcons,Detroit Lions,23,16,2011,7,domingo,Regular Season,4-3,4,3,0,14,19,-5,5-2,5,2,0,8,6,2,Atlanta Falcons,13
2011-10-23,Los Angeles Rams,Dallas Cowboys,7,34,2011,7,domingo,Regular Season,0-6,0,6,0,30,31,-1,3-3,3,3,0,18,21,-3,Dallas Cowboys,10
2011-10-23,Seattle Seahawks,Cleveland Browns,3,6,2011,7,domingo,Regular Season,2-4,2,4,0,26,22,4,3-3,3,3,0,24,23,1,Cleveland Browns,1
2011-10-23,Washington Redskins,Carolina Panthers,20,33,2011,7,domingo,Regular Season,3-3,3,3,0,20,15,5,2-5,2,5,0,23,25,-2,Carolina Panthers,10
2011-10-23,Pittsburgh Steelers,Arizona Cardinals,32,20,2011,7,domingo,Regular Season,5-2,5,2,0,5,8,-3,1-5,1,5,0,29,26,3,Pittsburgh Steelers,18
2011-10-17,Miami Dolphins,New York Jets,6,24,2011,6,segunda,Regular Season,0-5,0,5,0,30,30,0,3-3,3,3,0,16,17,-1,New York Jets,13
2011-10-16,Philadelphia Eagles,Washington Redskins,20,13,2011,6,domingo,Regular Season,2-4,2,4,0,20,21,-1,3-2,3,2,0,15,10,5,Philadelphia Eagles,11
2011-10-16,New Orleans Saints,Tampa Bay Buccaneers,20,26,2011,6,domingo,Regular Season,4-2,4,2,0,5,3,2,4-2,4,2,0,12,16,-4,Tampa Bay Buccaneers,13
2011-10-16,Jacksonville Jaguars,Pittsburgh Steelers,13,17,2011,6,domingo,Regular Season,1-5,1,5,0,29,29,0,4-2,4,2,0,8,8,0,Pittsburgh Steelers,21
2011-10-16,Cleveland Browns,Oakland Raiders,17,24,2011,6,domingo,Regular Season,2-3,2,3,0,23,23,0,4-2,4,2,0,9,11,-2,Oakland Raiders,12
2011-10-16,Buffalo Bills,New York Giants,24,27,2011,6,domingo,Regular Season,4-2,4,2,0,10,6,4,4-2,4,2,0,11,14,-3,New York Giants,8
2011-10-16,Dallas Cowboys,New England Patriots,16,20,2011,6,domingo,Regular Season,2-3,2,3,0,21,15,6,5-1,5,1,0,2,2,0,New England Patriots,13
2011-10-16,Los Angeles Rams,Green Bay Packers,3,24,2011,6,domingo,Regular Season,0-5,0,5,0,31,31,0,6-0,6,0,0,1,1,0,Green Bay Packers,30
2011-10-16,San Francisco 49ers,Detroit Lions,25,19,2011,6,domingo,Regular Season,5-1,5,1,0,4,9,-5,5-1,5,1,0,6,4,2,San Francisco 49ers,5
2011-10-16,Indianapolis Colts,Cincinnati Bengals,17,27,2011,6,domingo,Regular Season,0-6,0,6,0,32,32,0,4-2,4,2,0,18,20,-2,Cincinnati Bengals,12
2011-10-16,Minnesota Vikings,Chicago Bears,10,39,2011,6,domingo,Regular Season,1-5,1,5,0,28,26,2,3-3,3,3,0,14,18,-4,Chicago Bears,8
2011-10-16,Houston Texans,Baltimore Ravens,14,29,2011,6,domingo,Regular Season,3-3,3,3,0,17,12,5,4-1,4,1,0,3,5,-2,Baltimore Ravens,7
2011-10-16,Carolina Panthers,Atlanta Falcons,17,31,2011,6,domingo,Regular Season,1-5,1,5,0,25,24,1,3-3,3,3,0,19,19,0,Atlanta Falcons,5
2011-10-10,Chicago Bears,Detroit Lions,13,24,2011,5,segunda,Regular Season,2-3,2,3,0,18,18,0,5-0,5,0,0,4,4,0,Detroit Lions,14
2011-10-09,Tampa Bay Buccaneers,San Francisco 49ers,3,48,2011,5,domingo,Regular Season,3-2,3,2,0,16,11,5,4-1,4,1,0,9,16,-7,San Francisco 49ers,5
2011-10-09,Tennessee Titans,Pittsburgh Steelers,17,38,2011,5,domingo,Regular Season,3-2,3,2,0,13,8,5,3-2,3,2,0,8,13,-5,Pittsburgh Steelers,5
2011-10-09,Seattle Seahawks,New York Giants,36,25,2011,5,domingo,Regular Season,2-3,2,3,0,22,25,-3,3-2,3,2,0,14,10,4,Seattle Seahawks,15
2011-10-09,New York Jets,New England Patriots,21,30,2011,5,domingo,Regular Season,2-3,2,3,0,17,14,3,4-1,4,1,0,2,3,-1,New England Patriots,11
2011-10-09,Arizona Cardinals,Minnesota Vikings,10,34,2011,5,domingo,Regular Season,1-4,1,4,0,28,23,5,1-4,1,4,0,26,30,-4,Minnesota Vikings,7
2011-10-09,Cincinnati Bengals,Jacksonville Jaguars,30,20,2011,5,domingo,Regular Season,3-2,3,2,0,20,21,-1,1-4,1,4,0,29,26,3,Cincinnati Bengals,5
2011-10-09,Kansas City Chiefs,Indianapolis Colts,28,24,2011,5,domingo,Regular Season,2-3,2,3,0,25,28,-3,0-5,0,5,0,32,29,3,Kansas City Chiefs,1
2011-10-09,Oakland Raiders,Houston Texans,25,20,2011,5,domingo,Regular Season,3-2,3,2,0,11,15,-4,3-2,3,2,0,12,6,6,Oakland Raiders,9
2011-10-09,Los Angeles Chargers,Denver Broncos,29,24,2011,5,domingo,Regular Season,4-1,4,1,0,7,7,0,1-4,1,4,0,27,27,0,Los Angeles Chargers,20
2011-10-09,New Orleans Saints,Carolina Panthers,30,27,2011,5,domingo,Regular Season,4-1,4,1,0,3,2,1,1-4,1,4,0,24,24,0,New Orleans Saints,22
2011-10-09,Philadelphia Eagles,Buffalo Bills,24,31,2011,5,domingo,Regular Season,1-4,1,4,0,21,20,1,4-1,4,1,0,6,9,-3,Buffalo Bills,11
2011-10-09,Green Bay Packers,Atlanta Falcons,25,14,2011,5,domingo,Regular Season,5-0,5,0,0,1,1,0,2-3,2,3,0,19,19,0,Green Bay Packers,18
2011-10-03,Indianapolis Colts,Tampa Bay Buccaneers,17,24,2011,4,segunda,Regular Season,0-4,0,4,0,29,30,-1,3-1,3,1,0,11,14,-3,Tampa Bay Buccaneers,16
2011-10-02,Washington Redskins,Los Angeles Rams,17,10,2011,4,domingo,Regular Season,3-1,3,1,0,12,16,-4,0-4,0,4,0,32,31,1,Washington Redskins,15
2011-10-02,Atlanta Falcons,Seattle Seahawks,30,28,2011,4,domingo,Regular Season,2-2,2,2,0,19,19,0,1-3,1,3,0,25,24,1,Atlanta Falcons,5
2011-10-02,Miami Dolphins,Los Angeles Chargers,16,26,2011,4,domingo,Regular Season,0-4,0,4,0,31,29,2,3-1,3,1,0,7,9,-2,Los Angeles Chargers,20
2011-10-02,San Francisco 49ers,Philadelphia Eagles,24,23,2011,4,domingo,Regular Season,3-1,3,1,0,16,20,-4,1-3,1,3,0,20,17,3,San Francisco 49ers,3
2011-10-02,New England Patriots,Oakland Raiders,31,19,2011,4,domingo,Regular Season,3-1,3,1,0,3,3,0,2-2,2,2,0,15,13,2,New England Patriots,10
2011-10-02,Minnesota Vikings,Kansas City Chiefs,17,22,2011,4,domingo,Regular Season,0-4,0,4,0,30,28,2,1-3,1,3,0,28,32,-4,Kansas City Chiefs,4
2011-10-02,New Orleans Saints,Jacksonville Jaguars,23,10,2011,4,domingo,Regular Season,3-1,3,1,0,2,2,0,1-3,1,3,0,26,25,1,New Orleans Saints,23
2011-10-02,Pittsburgh Steelers,Houston Texans,10,17,2011,4,domingo,Regular Season,2-2,2,2,0,13,10,3,3-1,3,1,0,6,8,-2,Houston Texans,2
2011-10-02,Denver Broncos,Green Bay Packers,23,49,2011,4,domingo,Regular Season,1-3,1,3,0,27,26,1,4-0,4,0,0,1,1,0,Green Bay Packers,25
2011-10-02,Detroit Lions,Dallas Cowboys,34,30,2011,4,domingo,Regular Season,4-0,4,0,0,4,4,0,2-2,2,2,0,17,11,6,Detroit Lions,7
2011-10-02,Tennessee Titans,Cleveland Browns,31,13,2011,4,domingo,Regular Season,3-1,3,1,0,8,15,-7,2-2,2,2,0,22,21,1,Tennessee Titans,6
2011-10-02,Buffalo Bills,Cincinnati Bengals,20,23,2011,4,domingo,Regular Season,3-1,3,1,0,9,6,3,2-2,2,2,0,21,27,-6,Cincinnati Bengals,21
2011-10-02,Carolina Panthers,Chicago Bears,29,34,2011,4,domingo,Regular Season,1-3,1,3,0,24,22,2,2-2,2,2,0,18,18,0,Chicago Bears,4
2011-10-02,New York Jets,Baltimore Ravens,17,34,2011,4,domingo,Regular Season,2-2,2,2,0,14,7,7,3-1,3,1,0,5,5,0,Baltimore Ravens,2
2011-10-02,New York Giants,Arizona Cardinals,31,27,2011,4,domingo,Regular Season,3-1,3,1,0,10,12,-2,1-3,1,3,0,23,23,0,New York Giants,11
2011-09-26,Washington Redskins,Dallas Cowboys,16,18,2011,3,segunda,Regular Season,2-1,2,1,0,16,15,1,2-1,2,1,0,11,13,-2,Dallas Cowboys,2
2011-09-25,Denver Broncos,Tennessee Titans,14,17,2011,3,domingo,Regular Season,1-2,1,2,0,26,24,2,2-1,2,1,0,15,17,-2,Tennessee Titans,7
2011-09-25,Atlanta Falcons,Tampa Bay Buccaneers,13,16,2011,3,domingo,Regular Season,1-2,1,2,0,19,8,11,2-1,2,1,0,14,14,0,Tampa Bay Buccaneers,6
2011-09-25,Baltimore Ravens,Los Angeles Rams,37,7,2011,3,domingo,Regular Season,2-1,2,1,0,5,7,-2,0-3,0,3,0,31,22,9,Baltimore Ravens,15
2011-09-25,Arizona Cardinals,Seattle Seahawks,10,13,2011,3,domingo,Regular Season,1-2,1,2,0,23,19,4,1-2,1,2,0,24,32,-8,Seattle Seahawks,13
2011-09-25,Kansas City Chiefs,Los Angeles Chargers,17,20,2011,3,domingo,Regular Season,0-3,0,3,0,32,31,1,2-1,2,1,0,9,12,-3,Los Angeles Chargers,19
2011-09-25,New York Giants,Philadelphia Eagles,29,16,2011,3,domingo,Regular Season,2-1,2,1,0,12,18,-6,1-2,1,2,0,17,6,11,New York Giants,12
2011-09-25,New York Jets,Oakland Raiders,24,34,2011,3,domingo,Regular Season,2-1,2,1,0,7,3,4,2-1,2,1,0,13,20,-7,Oakland Raiders,17
2011-09-25,Houston Texans,New Orleans Saints,33,40,2011,3,domingo,Regular Season,2-1,2,1,0,8,5,3,2-1,2,1,0,2,4,-2,New Orleans Saints,1
2011-09-25,Detroit Lions,Minnesota Vikings,26,23,2011,3,domingo,Regular Season,3-0,3,0,0,4,11,-7,0-3,0,3,0,28,26,2,Detroit Lions,15
2011-09-25,Pittsburgh Steelers,Indianapolis Colts,23,20,2011,3,domingo,Regular Season,2-1,2,1,0,10,9,1,0-3,0,3,0,30,30,0,Pittsburgh Steelers,21
2011-09-25,Miami Dolphins,Cleveland Browns,16,17,2011,3,domingo,Regular Season,0-3,0,3,0,29,25,4,2-1,2,1,0,21,29,-8,Cleveland Browns,4
2011-09-25,San Francisco 49ers,Cincinnati Bengals,13,8,2011,3,domingo,Regular Season,2-1,2,1,0,20,23,-3,1-2,1,2,0,27,28,-1,San Francisco 49ers,5
2011-09-25,Green Bay Packers,Chicago Bears,27,17,2011,3,domingo,Regular Season,3-0,3,0,0,1,1,0,1-2,1,2,0,18,10,8,Green Bay Packers,9
2011-09-25,Jacksonville Jaguars,Carolina Panthers,10,16,2011,3,domingo,Regular Season,1-2,1,2,0,25,21,4,1-2,1,2,0,22,27,-5,Carolina Panthers,6
2011-09-25,New England Patriots,Buffalo Bills,31,34,2011,3,domingo,Regular Season,2-1,2,1,0,3,2,1,3-0,3,0,0,6,16,-10,Buffalo Bills,14
2011-09-19,Los Angeles Rams,New York Giants,16,28,2011,2,segunda,Regular Season,0-2,0,2,0,22,20,2,1-1,1,1,0,18,17,1,New York Giants,3
2011-09-18,Arizona Cardinals,Washington Redskins,21,22,2011,2,domingo,Regular Season,1-1,1,1,0,19,16,3,2-0,2,0,0,15,19,-4,Washington Redskins,3
2011-09-18,Baltimore Ravens,Tennessee Titans,13,26,2011,2,domingo,Regular Season,1-1,1,1,0,7,4,3,1-1,1,1,0,17,25,-8,Tennessee Titans,21
2011-09-18,Dallas Cowboys,San Francisco 49ers,27,24,2011,2,domingo,Regular Season,1-1,1,1,0,13,13,0,1-1,1,1,0,23,22,1,Dallas Cowboys,9
2011-09-18,Seattle Seahawks,Pittsburgh Steelers,0,24,2011,2,domingo,Regular Season,0-2,0,2,0,32,31,1,1-1,1,1,0,9,8,1,Pittsburgh Steelers,23
2011-09-18,Jacksonville Jaguars,New York Jets,3,32,2011,2,domingo,Regular Season,1-1,1,1,0,21,15,6,2-0,2,0,0,3,5,-2,New York Jets,10
2011-09-18,Chicago Bears,New Orleans Saints,13,30,2011,2,domingo,Regular Season,1-1,1,1,0,10,7,3,1-1,1,1,0,4,6,-2,New Orleans Saints,1
2011-09-18,Los Angeles Chargers,New England Patriots,21,35,2011,2,domingo,Regular Season,1-1,1,1,0,12,9,3,2-0,2,0,0,2,2,0,New England Patriots,7
2011-09-18,Tampa Bay Buccaneers,Minnesota Vikings,24,20,2011,2,domingo,Regular Season,1-1,1,1,0,14,14,0,0-2,0,2,0,26,24,2,Tampa Bay Buccaneers,10
2011-09-18,Houston Texans,Miami Dolphins,23,13,2011,2,domingo,Regular Season,2-0,2,0,0,5,10,-5,0-2,0,2,0,25,26,-1,Houston Texans,16
2011-09-18,Cleveland Browns,Indianapolis Colts,27,19,2011,2,domingo,Regular Season,1-1,1,1,0,29,32,-3,0-2,0,2,0,30,23,7,Cleveland Browns,9
2011-09-18,Kansas City Chiefs,Detroit Lions,3,48,2011,2,domingo,Regular Season,0-2,0,2,0,31,21,10,2-0,2,0,0,11,12,-1,Detroit Lions,9
2011-09-18,Cincinnati Bengals,Denver Broncos,22,24,2011,2,domingo,Regular Season,1-1,1,1,0,28,30,-2,1-1,1,1,0,24,28,-4,Denver Broncos,2
2011-09-18,Green Bay Packers,Carolina Panthers,30,23,2011,2,domingo,Regular Season,2-0,2,0,0,1,1,0,0-2,0,2,0,27,29,-2,Green Bay Packers,28
2011-09-18,Oakland Raiders,Buffalo Bills,35,38,2011,2,domingo,Regular Season,1-1,1,1,0,20,18,2,2-0,2,0,0,16,27,-11,Buffalo Bills,9
2011-09-18,Philadelphia Eagles,Atlanta Falcons,31,35,2011,2,domingo,Regular Season,1-1,1,1,0,6,3,3,1-1,1,1,0,8,11,-3,Atlanta Falcons,8
2011-09-12,New England Patriots,Miami Dolphins,38,24,2011,1,segunda,Regular Season,1-0,1,0,0,2,2,0,0-1,0,1,0,26,24,2,New England Patriots,22
2011-09-12,Oakland Raiders,Denver Broncos,23,20,2011,1,segunda,Regular Season,1-0,1,0,0,18,22,-4,0-1,0,1,0,28,27,1,Oakland Raiders,5
2011-09-11,New York Giants,Washington Redskins,14,28,2011,1,domingo,Regular Season,0-1,0,1,0,17,15,2,1-0,1,0,0,19,28,-9,Washington Redskins,13
2011-09-11,Detroit Lions,Tampa Bay Buccaneers,27,20,2011,1,domingo,Regular Season,1-0,1,0,0,12,16,-4,0-1,0,1,0,14,12,2,Detroit Lions,4
2011-09-11,Philadelphia Eagles,Los Angeles Rams,31,13,2011,1,domingo,Regular Season,1-0,1,0,0,3,4,-1,0-1,0,1,0,20,17,3,Philadelphia Eagles,13
2011-09-11,Seattle Seahawks,San Francisco 49ers,17,33,2011,1,domingo,Regular Season,0-1,0,1,0,31,25,6,1-0,1,0,0,22,26,-4,San Francisco 49ers,1
2011-09-11,Minnesota Vikings,Los Angeles Chargers,17,24,2011,1,domingo,Regular Season,0-1,0,1,0,24,20,4,1-0,1,0,0,9,10,-1,Los Angeles Chargers,10
2011-09-11,Dallas Cowboys,New York Jets,24,27,2011,1,domingo,Regular Season,0-1,0,1,0,13,14,-1,1-0,1,0,0,5,7,-2,New York Jets,7
2011-09-11,Buffalo Bills,Kansas City Chiefs,41,7,2011,1,domingo,Regular Season,1-0,1,0,0,27,30,-3,0-1,0,1,0,21,18,3,Buffalo Bills,12
2011-09-11,Tennessee Titans,Jacksonville Jaguars,14,16,2011,1,domingo,Regular Season,0-1,0,1,0,25,23,2,1-0,1,0,0,15,19,-4,Jacksonville Jaguars,4
2011-09-11,Indianapolis Colts,Houston Texans,7,34,2011,1,domingo,Regular Season,0-1,0,1,0,23,9,14,1-0,1,0,0,10,11,-1,Houston Texans,2
2011-09-11,Cincinnati Bengals,Cleveland Browns,27,17,2011,1,domingo,Regular Season,1-0,1,0,0,30,32,-2,0-1,0,1,0,32,29,3,Cincinnati Bengals,3
2011-09-11,Atlanta Falcons,Chicago Bears,12,30,2011,1,domingo,Regular Season,0-1,0,1,0,11,6,5,1-0,1,0,0,7,13,-6,Chicago Bears,7
2011-09-11,Pittsburgh Steelers,Baltimore Ravens,7,35,2011,1,domingo,Regular Season,0-1,0,1,0,8,3,5,1-0,1,0,0,4,8,-4,Baltimore Ravens,5
2011-09-11,Carolina Panthers,Arizona Cardinals,21,28,2011,1,domingo,Regular Season,0-1,0,1,0,29,31,-2,1-0,1,0,0,16,21,-5,Arizona Cardinals,10
2011-09-08,New Orleans Saints,Green Bay Packers,34,42,2011,1,quinta,Regular Season,0-1,0,1,0,6,5,1,1-0,1,0,0,1,1,0,Green Bay Packers,4
2011-01-02,New York Giants,Washington Redskins,17,14,2010,17,domingo,Regular Season,10-6,10,6,0,12,12,0,6-10,6,10,0,26,21,5,New York Giants,9
2011-01-02,Los Angeles Rams,Seattle Seahawks,6,16,2010,17,domingo,Regular Season,7-9,7,9,0,17,16,1,7-9,7,9,0,19,26,-7,Seattle Seahawks,10
2011-01-02,Arizona Cardinals,San Francisco 49ers,7,38,2010,17,domingo,Regular Season,5-11,5,11,0,28,29,-1,6-10,6,10,0,25,27,-2,San Francisco 49ers,2
2011-01-02,Dallas Cowboys,Philadelphia Eagles,14,13,2010,17,domingo,Regular Season,6-10,6,10,0,18,22,-4,10-6,10,6,0,7,7,0,Dallas Cowboys,15
2011-01-02,Buffalo Bills,New York Jets,7,38,2010,17,domingo,Regular Season,4-12,4,12,0,30,28,2,11-5,11,5,0,8,8,0,New York Jets,20
2011-01-02,Tampa Bay Buccaneers,New Orleans Saints,23,13,2010,17,domingo,Regular Season,10-6,10,6,0,13,13,0,11-5,11,5,0,5,4,1,Tampa Bay Buccaneers,9
2011-01-02,Miami Dolphins,New England Patriots,7,38,2010,17,domingo,Regular Season,7-9,7,9,0,22,18,4,14-2,14,2,0,1,1,0,New England Patriots,17
2011-01-02,Oakland Raiders,Kansas City Chiefs,31,10,2010,17,domingo,Regular Season,8-8,8,8,0,15,17,-2,10-6,10,6,0,11,11,0,Oakland Raiders,6
2011-01-02,Tennessee Titans,Indianapolis Colts,20,23,2010,17,domingo,Regular Season,6-10,6,10,0,20,20,0,10-6,10,6,0,10,10,0,Indianapolis Colts,10
2011-01-02,Jacksonville Jaguars,Houston Texans,17,34,2010,17,domingo,Regular Season,8-8,8,8,0,16,15,1,6-10,6,10,0,21,23,-2,Houston Texans,8
2011-01-02,Chicago Bears,Green Bay Packers,3,10,2010,17,domingo,Regular Season,11-5,11,5,0,6,6,0,10-6,10,6,0,9,9,0,Green Bay Packers,3
2011-01-02,Minnesota Vikings,Detroit Lions,13,20,2010,17,domingo,Regular Season,6-10,6,10,0,23,19,4,6-10,6,10,0,24,24,0,Detroit Lions,5
2011-01-02,Los Angeles Chargers,Denver Broncos,33,28,2010,17,domingo,Regular Season,9-7,9,7,0,14,14,0,4-12,4,12,0,29,31,-2,Los Angeles Chargers,17
2011-01-02,Pittsburgh Steelers,Cleveland Browns,41,9,2010,17,domingo,Regular Season,12-4,12,4,0,3,5,-2,5-11,5,11,0,27,25,2,Pittsburgh Steelers,20
2011-01-02,Cincinnati Bengals,Baltimore Ravens,7,13,2010,17,domingo,Regular Season,4-12,4,12,0,31,30,1,12-4,12,4,0,4,3,1,Baltimore Ravens,27
2011-01-02,Carolina Panthers,Atlanta Falcons,10,31,2010,17,domingo,Regular Season,2-14,2,14,0,32,32,0,13-3,13,3,0,2,2,0,Atlanta Falcons,30
2010-12-28,Minnesota Vikings,Philadelphia Eagles,24,14,2010,16,terça,Regular Season,6-9,6,9,0,19,24,-5,10-5,10,5,0,7,3,4,Minnesota Vikings,21
2010-12-27,New Orleans Saints,Atlanta Falcons,17,14,2010,16,segunda,Regular Season,11-4,11,4,0,4,7,-3,12-3,12,3,0,2,2,0,New Orleans Saints,5
2010-12-26,Seattle Seahawks,Tampa Bay Buccaneers,15,38,2010,16,domingo,Regular Season,6-9,6,9,0,26,23,3,9-6,9,6,0,13,15,-2,Tampa Bay Buccaneers,8
2010-12-26,San Francisco 49ers,Los Angeles Rams,17,25,2010,16,domingo,Regular Season,5-10,5,10,0,27,25,2,7-8,7,8,0,16,20,-4,Los Angeles Rams,5
2010-12-26,Indianapolis Colts,Oakland Raiders,31,26,2010,16,domingo,Regular Season,9-6,9,6,0,10,13,-3,7-8,7,8,0,17,16,1,Indianapolis Colts,3
2010-12-26,Detroit Lions,Miami Dolphins,34,27,2010,16,domingo,Regular Season,5-10,5,10,0,24,28,-4,7-8,7,8,0,18,17,1,Detroit Lions,11
2010-12-26,Tennessee Titans,Kansas City Chiefs,14,34,2010,16,domingo,Regular Season,6-9,6,9,0,20,19,1,10-5,10,5,0,11,11,0,Kansas City Chiefs,8
2010-12-26,Washington Redskins,Jacksonville Jaguars,20,17,2010,16,domingo,Regular Season,6-9,6,9,0,21,26,-5,8-7,8,7,0,15,14,1,Washington Redskins,12
2010-12-26,New York Giants,Green Bay Packers,17,45,2010,16,domingo,Regular Season,9-6,9,6,0,12,9,3,9-6,9,6,0,9,12,-3,Green Bay Packers,3
2010-12-26,Houston Texans,Denver Broncos,23,24,2010,16,domingo,Regular Season,5-10,5,10,0,23,21,2,4-11,4,11,0,31,31,0,Denver Broncos,10
2010-12-26,Baltimore Ravens,Cleveland Browns,20,10,2010,16,domingo,Regular Season,11-4,11,4,0,3,4,-1,5-10,5,10,0,25,22,3,Baltimore Ravens,18
2010-12-26,Los Angeles Chargers,Cincinnati Bengals,20,34,2010,16,domingo,Regular Season,8-7,8,7,0,14,10,4,4-11,4,11,0,30,30,0,Cincinnati Bengals,20
2010-12-26,New York Jets,Chicago Bears,34,38,2010,16,domingo,Regular Season,10-5,10,5,0,8,5,3,11-4,11,4,0,6,8,-2,Chicago Bears,3
2010-12-26,New England Patriots,Buffalo Bills,34,3,2010,16,domingo,Regular Season,13-2,13,2,0,1,1,0,4-11,4,11,0,28,27,1,New England Patriots,26
2010-12-25,Dallas Cowboys,Arizona Cardinals,26,27,2010,16,sábado,Regular Season,5-10,5,10,0,22,18,4,5-10,5,10,0,29,29,0,Arizona Cardinals,11
2010-12-23,Carolina Panthers,Pittsburgh Steelers,3,27,2010,16,quinta,Regular Season,2-13,2,13,0,32,32,0,11-4,11,4,0,5,6,-1,Pittsburgh Steelers,26
2010-12-20,Chicago Bears,Minnesota Vikings,40,14,2010,15,segunda,Regular Season,10-4,10,4,0,8,8,0,5-9,5,9,0,24,26,-2,Chicago Bears,18
2010-12-19,Houston Texans,Tennessee Titans,17,31,2010,15,domingo,Regular Season,5-9,5,9,0,21,19,2,6-8,6,8,0,19,22,-3,Tennessee Titans,3
2010-12-19,Detroit Lions,Tampa Bay Buccaneers,23,20,2010,15,domingo,Regular Season,4-10,4,10,0,28,29,-1,8-6,8,6,0,15,13,2,Detroit Lions,16
2010-12-19,Kansas City Chiefs,Los Angeles Rams,27,13,2010,15,domingo,Regular Season,9-5,9,5,0,11,14,-3,6-8,6,8,0,20,18,2,Kansas City Chiefs,4
2010-12-19,Atlanta Falcons,Seattle Seahawks,34,18,2010,15,domingo,Regular Season,12-2,12,2,0,2,2,0,6-8,6,8,0,23,24,-1,Atlanta Falcons,22
2010-12-19,New York Jets,Pittsburgh Steelers,22,17,2010,15,domingo,Regular Season,10-4,10,4,0,5,9,-4,10-4,10,4,0,6,3,3,New York Jets,6
2010-12-19,Denver Broncos,Oakland Raiders,23,39,2010,15,domingo,Regular Season,3-11,3,11,0,31,30,1,7-7,7,7,0,16,17,-1,Oakland Raiders,13
2010-12-19,Philadelphia Eagles,New York Giants,38,31,2010,15,domingo,Regular Season,10-4,10,4,0,3,6,-3,9-5,9,5,0,9,7,2,Philadelphia Eagles,1
2010-12-19,Green Bay Packers,New England Patriots,27,31,2010,15,domingo,Regular Season,8-6,8,6,0,12,10,2,12-2,12,2,0,1,1,0,New England Patriots,9
2010-12-19,Buffalo Bills,Miami Dolphins,17,14,2010,15,domingo,Regular Season,4-10,4,10,0,27,28,-1,7-7,7,7,0,17,16,1,Buffalo Bills,12
2010-12-19,Jacksonville Jaguars,Indianapolis Colts,24,34,2010,15,domingo,Regular Season,8-6,8,6,0,14,11,3,8-6,8,6,0,13,15,-2,Indianapolis Colts,4
2010-12-19,Washington Redskins,Dallas Cowboys,30,33,2010,15,domingo,Regular Season,5-9,5,9,0,26,25,1,5-9,5,9,0,18,20,-2,Dallas Cowboys,5
2010-12-19,Cleveland Browns,Cincinnati Bengals,17,19,2010,15,domingo,Regular Season,5-9,5,9,0,22,21,1,3-11,3,11,0,30,31,-1,Cincinnati Bengals,10
2010-12-19,Arizona Cardinals,Carolina Panthers,12,19,2010,15,domingo,Regular Season,4-10,4,10,0,29,27,2,2-12,2,12,0,32,32,0,Carolina Panthers,5
2010-12-19,New Orleans Saints,Baltimore Ravens,24,30,2010,15,domingo,Regular Season,10-4,10,4,0,7,4,3,10-4,10,4,0,4,5,-1,Baltimore Ravens,1
2010-12-16,San Francisco 49ers,Los Angeles Chargers,7,34,2010,15,quinta,Regular Season,5-9,5,9,0,25,23,2,8-6,8,6,0,10,12,-2,Los Angeles Chargers,11
2010-12-13,New York Giants,Minnesota Vikings,21,3,2010,14,segunda,Regular Season,9-4,9,4,0,7,10,-3,5-8,5,8,0,26,23,3,New York Giants,13
2010-12-13,Baltimore Ravens,Houston Texans,34,28,2010,14,segunda,Regular Season,9-4,9,4,0,5,4,1,5-8,5,8,0,19,19,0,Baltimore Ravens,15
2010-12-12,Tampa Bay Buccaneers,Washington Redskins,17,16,2010,14,domingo,Regular Season,8-5,8,5,0,13,13,0,5-8,5,8,0,25,25,0,Tampa Bay Buccaneers,12
2010-12-12,Seattle Seahawks,San Francisco 49ers,21,40,2010,14,domingo,Regular Season,6-7,6,7,0,24,20,4,5-8,5,8,0,23,26,-3,San Francisco 49ers,6
2010-12-12,Kansas City Chiefs,Los Angeles Chargers,0,31,2010,14,domingo,Regular Season,8-5,8,5,0,14,11,3,7-6,7,6,0,12,14,-2,Los Angeles Chargers,3
2010-12-12,Cincinnati Bengals,Pittsburgh Steelers,7,23,2010,14,domingo,Regular Season,2-11,2,11,0,31,30,1,10-3,10,3,0,3,3,0,Pittsburgh Steelers,27
2010-12-12,Miami Dolphins,New York Jets,10,6,2010,14,domingo,Regular Season,7-6,7,6,0,16,18,-2,9-4,9,4,0,9,6,3,Miami Dolphins,12
2010-12-12,Los Angeles Rams,New Orleans Saints,13,31,2010,14,domingo,Regular Season,6-7,6,7,0,18,17,1,10-3,10,3,0,4,5,-1,New Orleans Saints,12
2010-12-12,Oakland Raiders,Jacksonville Jaguars,31,38,2010,14,domingo,Regular Season,6-7,6,7,0,17,16,1,8-5,8,5,0,11,12,-1,Jacksonville Jaguars,4
2010-12-12,Green Bay Packers,Detroit Lions,3,7,2010,14,domingo,Regular Season,8-5,8,5,0,10,7,3,3-10,3,10,0,29,31,-2,Detroit Lions,24
2010-12-12,Philadelphia Eagles,Dallas Cowboys,30,27,2010,14,domingo,Regular Season,9-4,9,4,0,6,9,-3,4-9,4,9,0,20,24,-4,Philadelphia Eagles,15
2010-12-12,New England Patriots,Chicago Bears,36,7,2010,14,domingo,Regular Season,11-2,11,2,0,1,2,-1,9-4,9,4,0,8,8,0,New England Patriots,6
2010-12-12,Atlanta Falcons,Carolina Panthers,31,10,2010,14,domingo,Regular Season,11-2,11,2,0,2,1,1,1-12,1,12,0,32,32,0,Atlanta Falcons,31
2010-12-12,Cleveland Browns,Buffalo Bills,6,13,2010,14,domingo,Regular Season,5-8,5,8,0,21,21,0,3-10,3,10,0,28,27,1,Buffalo Bills,6
2010-12-12,Denver Broncos,Arizona Cardinals,13,43,2010,14,domingo,Regular Season,3-10,3,10,0,30,28,2,4-9,4,9,0,27,29,-2,Arizona Cardinals,1
2010-12-09,Indianapolis Colts,Tennessee Titans,30,28,2010,14,quinta,Regular Season,7-6,7,6,0,15,15,0,5-8,5,8,0,22,22,0,Indianapolis Colts,7
2010-12-06,New York Jets,New England Patriots,3,45,2010,13,segunda,Regular Season,9-3,9,3,0,6,3,3,10-2,10,2,0,2,2,0,New England Patriots,1
2010-12-05,Jacksonville Jaguars,Tennessee Titans,17,6,2010,13,domingo,Regular Season,7-5,7,5,0,12,16,-4,5-7,5,7,0,22,19,3,Jacksonville Jaguars,3
2010-12-05,Atlanta Falcons,Tampa Bay Buccaneers,28,24,2010,13,domingo,Regular Season,10-2,10,2,0,1,1,0,7-5,7,5,0,13,13,0,Atlanta Falcons,12
2010-12-05,Carolina Panthers,Seattle Seahawks,14,31,2010,13,domingo,Regular Season,1-11,1,11,0,32,32,0,6-6,6,6,0,20,22,-2,Seattle Seahawks,10
2010-12-05,Oakland Raiders,Los Angeles Chargers,28,13,2010,13,domingo,Regular Season,6-6,6,6,0,16,20,-4,6-6,6,6,0,14,11,3,Oakland Raiders,9
2010-12-05,Washington Redskins,New York Giants,7,31,2010,13,domingo,Regular Season,5-7,5,7,0,25,21,4,8-4,8,4,0,10,10,0,New York Giants,11
2010-12-05,Buffalo Bills,Minnesota Vikings,14,38,2010,13,domingo,Regular Season,2-10,2,10,0,27,27,0,5-7,5,7,0,23,23,0,Minnesota Vikings,4
2010-12-05,Cleveland Browns,Miami Dolphins,13,10,2010,13,domingo,Regular Season,5-7,5,7,0,21,24,-3,6-6,6,6,0,18,15,3,Cleveland Browns,9
2010-12-05,Denver Broncos,Kansas City Chiefs,6,10,2010,13,domingo,Regular Season,3-9,3,9,0,28,28,0,8-4,8,4,0,11,12,-1,Kansas City Chiefs,16
2010-12-05,Dallas Cowboys,Indianapolis Colts,38,35,2010,13,domingo,Regular Season,4-8,4,8,0,24,26,-2,6-6,6,6,0,15,14,1,Dallas Cowboys,12
2010-12-05,San Francisco 49ers,Green Bay Packers,16,34,2010,13,domingo,Regular Season,4-8,4,8,0,26,25,1,8-4,8,4,0,7,8,-1,Green Bay Packers,17
2010-12-05,Chicago Bears,Detroit Lions,24,20,2010,13,domingo,Regular Season,9-3,9,3,0,8,7,1,2-10,2,10,0,31,31,0,Chicago Bears,24
2010-12-05,New Orleans Saints,Cincinnati Bengals,34,30,2010,13,domingo,Regular Season,9-3,9,3,0,5,6,-1,2-10,2,10,0,30,30,0,New Orleans Saints,24
2010-12-05,Pittsburgh Steelers,Baltimore Ravens,13,10,2010,13,domingo,Regular Season,9-3,9,3,0,3,5,-2,8-4,8,4,0,4,4,0,Pittsburgh Steelers,1
2010-12-05,Los Angeles Rams,Arizona Cardinals,19,6,2010,13,domingo,Regular Season,6-6,6,6,0,17,18,-1,3-9,3,9,0,29,29,0,Los Angeles Rams,11
2010-12-02,Houston Texans,Philadelphia Eagles,24,34,2010,13,quinta,Regular Season,5-7,5,7,0,19,17,2,8-4,8,4,0,9,9,0,Philadelphia Eagles,8
2010-11-29,San Francisco 49ers,Arizona Cardinals,27,6,2010,12,segunda,Regular Season,4-7,4,7,0,25,26,-1,3-8,3,8,0,29,29,0,San Francisco 49ers,3
2010-11-28,Minnesota Vikings,Washington Redskins,17,13,2010,12,domingo,Regular Season,4-7,4,7,0,23,25,-2,5-6,5,6,0,21,18,3,Minnesota Vikings,7
2010-11-28,Kansas City Chiefs,Seattle Seahawks,42,24,2010,12,domingo,Regular Season,7-4,7,4,0,12,13,-1,5-6,5,6,0,22,21,1,Kansas City Chiefs,8
2010-11-28,Miami Dolphins,Oakland Raiders,33,17,2010,12,domingo,Regular Season,6-5,6,5,0,15,19,-4,5-6,5,6,0,20,16,4,Miami Dolphins,3
2010-11-28,Jacksonville Jaguars,New York Giants,20,24,2010,12,domingo,Regular Season,6-5,6,5,0,16,15,1,7-4,7,4,0,10,10,0,New York Giants,5
2010-11-28,Los Angeles Chargers,Indianapolis Colts,36,14,2010,12,domingo,Regular Season,6-5,6,5,0,11,14,-3,6-5,6,5,0,14,9,5,Los Angeles Chargers,5
2010-11-28,Tennessee Titans,Houston Texans,0,20,2010,12,domingo,Regular Season,5-6,5,6,0,19,17,2,5-6,5,6,0,17,20,-3,Houston Texans,3
2010-11-28,Los Angeles Rams,Denver Broncos,36,33,2010,12,domingo,Regular Season,5-6,5,6,0,18,22,-4,3-8,3,8,0,28,27,1,Los Angeles Rams,5
2010-11-28,Carolina Panthers,Cleveland Browns,23,24,2010,12,domingo,Regular Season,1-10,1,10,0,32,32,0,4-7,4,7,0,24,23,1,Cleveland Browns,9
2010-11-28,Philadelphia Eagles,Chicago Bears,26,31,2010,12,domingo,Regular Season,7-4,7,4,0,9,6,3,8-3,8,3,0,7,12,-5,Chicago Bears,6
2010-11-28,Pittsburgh Steelers,Buffalo Bills,19,16,2010,12,domingo,Regular Season,8-3,8,3,0,5,5,0,2-9,2,9,0,27,28,-1,Pittsburgh Steelers,23
2010-11-28,Tampa Bay Buccaneers,Baltimore Ravens,10,17,2010,12,domingo,Regular Season,7-4,7,4,0,13,11,2,8-3,8,3,0,4,3,1,Baltimore Ravens,8
2010-11-28,Green Bay Packers,Atlanta Falcons,17,20,2010,12,domingo,Regular Season,7-4,7,4,0,8,7,1,9-2,9,2,0,1,1,0,Atlanta Falcons,6
2010-11-25,Cincinnati Bengals,New York Jets,10,26,2010,12,quinta,Regular Season,2-9,2,9,0,30,30,0,9-2,9,2,0,3,4,-1,New York Jets,26
2010-11-25,New England Patriots,Detroit Lions,45,24,2010,12,quinta,Regular Season,9-2,9,2,0,2,2,0,2-9,2,9,0,31,31,0,New England Patriots,29
2010-11-25,New Orleans Saints,Dallas Cowboys,30,27,2010,12,quinta,Regular Season,8-3,8,3,0,6,8,-2,3-8,3,8,0,26,24,2,New Orleans Saints,16
2010-11-22,Denver Broncos,Los Angeles Chargers,14,35,2010,11,segunda,Regular Season,3-7,3,7,0,27,26,1,5-5,5,5,0,14,16,-2,Los Angeles Chargers,10
2010-11-21,Washington Redskins,Tennessee Titans,19,16,2010,11,domingo,Regular Season,5-5,5,5,0,18,21,-3,5-5,5,5,0,17,13,4,Washington Redskins,8
2010-11-21,Atlanta Falcons,Los Angeles Rams,34,17,2010,11,domingo,Regular Season,8-2,8,2,0,1,1,0,4-6,4,6,0,22,23,-1,Atlanta Falcons,22
2010-11-21,Tampa Bay Buccaneers,San Francisco 49ers,21,0,2010,11,domingo,Regular Season,7-3,7,3,0,11,11,0,3-7,3,7,0,26,25,1,Tampa Bay Buccaneers,14
2010-11-21,Oakland Raiders,Pittsburgh Steelers,3,35,2010,11,domingo,Regular Season,5-5,5,5,0,16,12,4,7-3,7,3,0,5,5,0,Pittsburgh Steelers,7
2010-11-21,New York Giants,Philadelphia Eagles,17,27,2010,11,domingo,Regular Season,6-4,6,4,0,10,8,2,7-3,7,3,0,6,6,0,Philadelphia Eagles,2
2010-11-21,Houston Texans,New York Jets,27,30,2010,11,domingo,Regular Season,4-6,4,6,0,20,19,1,8-2,8,2,0,4,3,1,New York Jets,16
2010-11-21,Seattle Seahawks,New Orleans Saints,19,34,2010,11,domingo,Regular Season,5-5,5,5,0,21,20,1,7-3,7,3,0,8,9,-1,New Orleans Saints,11
2010-11-21,Indianapolis Colts,New England Patriots,28,31,2010,11,domingo,Regular Season,6-4,6,4,0,9,10,-1,8-2,8,2,0,2,2,0,New England Patriots,8
2010-11-21,Green Bay Packers,Minnesota Vikings,31,3,2010,11,domingo,Regular Season,7-3,7,3,0,7,7,0,3-7,3,7,0,25,24,1,Green Bay Packers,17
2010-11-21,Arizona Cardinals,Kansas City Chiefs,13,31,2010,11,domingo,Regular Season,3-7,3,7,0,29,27,2,6-4,6,4,0,13,15,-2,Kansas City Chiefs,12
2010-11-21,Cleveland Browns,Jacksonville Jaguars,20,24,2010,11,domingo,Regular Season,3-7,3,7,0,23,22,1,6-4,6,4,0,15,18,-3,Jacksonville Jaguars,4
2010-11-21,Detroit Lions,Dallas Cowboys,19,35,2010,11,domingo,Regular Season,2-8,2,8,0,31,31,0,3-7,3,7,0,24,29,-5,Dallas Cowboys,2
2010-11-21,Buffalo Bills,Cincinnati Bengals,49,31,2010,11,domingo,Regular Season,2-8,2,8,0,28,30,-2,2-8,2,8,0,30,28,2,Buffalo Bills,2
2010-11-21,Baltimore Ravens,Carolina Panthers,37,13,2010,11,domingo,Regular Season,7-3,7,3,0,3,4,-1,1-9,1,9,0,32,32,0,Baltimore Ravens,28
2010-11-18,Chicago Bears,Miami Dolphins,16,0,2010,11,quinta,Regular Season,7-3,7,3,0,12,17,-5,5-5,5,5,0,19,14,5,Chicago Bears,3
2010-11-15,Philadelphia Eagles,Washington Redskins,59,28,2010,10,segunda,Regular Season,6-3,6,3,0,6,8,-2,4-5,4,5,0,21,18,3,Philadelphia Eagles,10
2010-11-14,Carolina Panthers,Tampa Bay Buccaneers,16,31,2010,10,domingo,Regular Season,1-8,1,8,0,32,31,1,6-3,6,3,0,11,13,-2,Tampa Bay Buccaneers,18
2010-11-14,Los Angeles Rams,San Francisco 49ers,20,23,2010,10,domingo,Regular Season,4-5,4,5,0,23,21,2,3-6,3,6,0,25,28,-3,San Francisco 49ers,7
2010-11-14,New England Patriots,Pittsburgh Steelers,39,26,2010,10,domingo,Regular Season,7-2,7,2,0,2,6,-4,6-3,6,3,0,5,2,3,New England Patriots,4
2010-11-14,Dallas Cowboys,New York Giants,33,20,2010,10,domingo,Regular Season,2-7,2,7,0,29,30,-1,6-3,6,3,0,8,4,4,Dallas Cowboys,26
2010-11-14,Tennessee Titans,Miami Dolphins,17,29,2010,10,domingo,Regular Season,5-4,5,4,0,13,11,2,5-4,5,4,0,14,17,-3,Miami Dolphins,6
2010-11-14,Houston Texans,Jacksonville Jaguars,24,31,2010,10,domingo,Regular Season,4-5,4,5,0,19,15,4,5-4,5,4,0,18,20,-2,Jacksonville Jaguars,5
2010-11-14,Cincinnati Bengals,Indianapolis Colts,17,23,2010,10,domingo,Regular Season,2-7,2,7,0,28,26,2,6-3,6,3,0,10,10,0,Indianapolis Colts,16
2010-11-14,Kansas City Chiefs,Denver Broncos,29,49,2010,10,domingo,Regular Season,5-4,5,4,0,15,14,1,3-6,3,6,0,26,29,-3,Denver Broncos,15
2010-11-14,New York Jets,Cleveland Browns,26,20,2010,10,domingo,Regular Season,7-2,7,2,0,3,5,-2,3-6,3,6,0,22,23,-1,New York Jets,18
2010-11-14,Minnesota Vikings,Chicago Bears,13,27,2010,10,domingo,Regular Season,3-6,3,6,0,24,22,2,6-3,6,3,0,17,19,-2,Chicago Bears,3
2010-11-14,Detroit Lions,Buffalo Bills,12,14,2010,10,domingo,Regular Season,2-7,2,7,0,31,27,4,1-8,1,8,0,30,32,-2,Buffalo Bills,5
2010-11-14,Seattle Seahawks,Arizona Cardinals,36,18,2010,10,domingo,Regular Season,5-4,5,4,0,20,24,-4,3-6,3,6,0,27,25,2,Seattle Seahawks,1
2010-11-11,Baltimore Ravens,Atlanta Falcons,21,26,2010,10,quinta,Regular Season,6-3,6,3,0,4,1,3,7-2,7,2,0,1,3,-2,Atlanta Falcons,2
2010-11-08,Pittsburgh Steelers,Cincinnati Bengals,27,21,2010,9,segunda,Regular Season,6-2,6,2,0,2,3,-1,2-6,2,6,0,26,25,1,Pittsburgh Steelers,22
2010-11-07,New York Giants,Seattle Seahawks,41,7,2010,9,domingo,Regular Season,6-2,6,2,0,4,7,-3,4-4,4,4,0,24,20,4,New York Giants,13
2010-11-07,Indianapolis Colts,Philadelphia Eagles,24,26,2010,9,domingo,Regular Season,5-3,5,3,0,10,5,5,5-3,5,3,0,8,12,-4,Philadelphia Eagles,7
2010-11-07,Kansas City Chiefs,Oakland Raiders,20,23,2010,9,domingo,Regular Season,5-3,5,3,0,14,11,3,5-4,5,4,0,12,16,-4,Oakland Raiders,5
2010-11-07,Arizona Cardinals,Minnesota Vikings,24,27,2010,9,domingo,Regular Season,3-5,3,5,0,25,24,1,3-5,3,5,0,22,23,-1,Minnesota Vikings,1
2010-11-07,Los Angeles Chargers,Houston Texans,29,23,2010,9,domingo,Regular Season,4-5,4,5,0,16,22,-6,4-4,4,4,0,15,13,2,Los Angeles Chargers,9
2010-11-07,Dallas Cowboys,Green Bay Packers,7,45,2010,9,domingo,Regular Season,1-7,1,7,0,30,29,1,6-3,6,3,0,7,8,-1,Green Bay Packers,21
2010-11-07,New York Jets,Detroit Lions,23,20,2010,9,domingo,Regular Season,6-2,6,2,0,5,4,1,2-6,2,6,0,27,27,0,New York Jets,23
2010-11-07,New England Patriots,Cleveland Browns,14,34,2010,9,domingo,Regular Season,6-2,6,2,0,6,1,5,3-5,3,5,0,23,26,-3,Cleveland Browns,25
2010-11-07,New Orleans Saints,Carolina Panthers,34,3,2010,9,domingo,Regular Season,6-3,6,3,0,9,10,-1,1-7,1,7,0,31,31,0,New Orleans Saints,21
2010-11-07,Chicago Bears,Buffalo Bills,22,19,2010,9,domingo,Regular Season,5-3,5,3,0,19,17,2,0-8,0,8,0,32,32,0,Chicago Bears,15
2010-11-07,Miami Dolphins,Baltimore Ravens,10,26,2010,9,domingo,Regular Season,4-4,4,4,0,17,15,2,6-2,6,2,0,1,2,-1,Baltimore Ravens,13
2010-11-07,Tampa Bay Buccaneers,Atlanta Falcons,21,27,2010,9,domingo,Regular Season,5-3,5,3,0,13,14,-1,6-2,6,2,0,3,6,-3,Atlanta Falcons,8
2010-11-01,Houston Texans,Indianapolis Colts,17,30,2010,8,segunda,Regular Season,4-3,4,3,0,13,8,5,5-2,5,2,0,5,6,-1,Indianapolis Colts,2
2010-10-31,Carolina Panthers,Los Angeles Rams,10,20,2010,8,domingo,Regular Season,1-6,1,6,0,31,29,2,4-4,4,4,0,21,20,1,Los Angeles Rams,9
2010-10-31,Denver Broncos,San Francisco 49ers,16,24,2010,8,domingo,Regular Season,2-6,2,6,0,28,27,1,2-6,2,6,0,30,31,-1,San Francisco 49ers,4
2010-10-31,Tennessee Titans,Los Angeles Chargers,25,33,2010,8,domingo,Regular Season,5-3,5,3,0,9,7,2,3-5,3,5,0,22,24,-2,Los Angeles Chargers,17
2010-10-31,Seattle Seahawks,Oakland Raiders,3,33,2010,8,domingo,Regular Season,4-3,4,3,0,20,17,3,4-4,4,4,0,16,23,-7,Oakland Raiders,6
2010-10-31,Green Bay Packers,New York Jets,9,0,2010,8,domingo,Regular Season,5-3,5,3,0,8,10,-2,5-2,5,2,0,4,2,2,Green Bay Packers,8
2010-10-31,Pittsburgh Steelers,New Orleans Saints,10,20,2010,8,domingo,Regular Season,5-2,5,2,0,3,1,2,5-3,5,3,0,10,14,-4,New Orleans Saints,13
2010-10-31,Minnesota Vikings,New England Patriots,18,28,2010,8,domingo,Regular Season,2-5,2,5,0,23,19,4,6-1,6,1,0,1,3,-2,New England Patriots,16
2010-10-31,Buffalo Bills,Kansas City Chiefs,10,13,2010,8,domingo,Regular Season,0-7,0,7,0,32,32,0,5-2,5,2,0,11,12,-1,Kansas City Chiefs,20
2010-10-31,Washington Redskins,Detroit Lions,25,37,2010,8,domingo,Regular Season,4-4,4,4,0,18,13,5,2-5,2,5,0,27,30,-3,Detroit Lions,17
2010-10-31,Jacksonville Jaguars,Dallas Cowboys,35,17,2010,8,domingo,Regular Season,4-4,4,4,0,19,25,-6,1-6,1,6,0,29,26,3,Jacksonville Jaguars,1
2010-10-31,Miami Dolphins,Cincinnati Bengals,22,14,2010,8,domingo,Regular Season,4-3,4,3,0,15,16,-1,2-5,2,5,0,25,22,3,Miami Dolphins,6
2010-10-31,Tampa Bay Buccaneers,Arizona Cardinals,38,35,2010,8,domingo,Regular Season,5-2,5,2,0,14,18,-4,3-4,3,4,0,24,21,3,Tampa Bay Buccaneers,3
2010-10-25,New York Giants,Dallas Cowboys,41,35,2010,7,segunda,Regular Season,5-2,5,2,0,9,11,-2,1-5,1,5,0,26,26,0,New York Giants,15
2010-10-24,Philadelphia Eagles,Tennessee Titans,19,37,2010,7,domingo,Regular Season,4-3,4,3,0,11,10,1,5-2,5,2,0,7,8,-1,Tennessee Titans,2
2010-10-24,Los Angeles Rams,Tampa Bay Buccaneers,17,18,2010,7,domingo,Regular Season,3-4,3,4,0,20,21,-1,4-2,4,2,0,18,19,-1,Tampa Bay Buccaneers,2
2010-10-24,Arizona Cardinals,Seattle Seahawks,10,22,2010,7,domingo,Regular Season,3-3,3,3,0,21,18,3,4-2,4,2,0,17,23,-6,Seattle Seahawks,5
2010-10-24,New England Patriots,Los Angeles Chargers,23,20,2010,7,domingo,Regular Season,5-1,5,1,0,3,3,0,2-5,2,5,0,24,24,0,New England Patriots,21
2010-10-24,Cleveland Browns,New Orleans Saints,30,17,2010,7,domingo,Regular Season,2-5,2,5,0,28,30,-2,4-3,4,3,0,14,6,8,Cleveland Browns,24
2010-10-24,Pittsburgh Steelers,Miami Dolphins,23,22,2010,7,domingo,Regular Season,5-1,5,1,0,1,1,0,3-3,3,3,0,16,16,0,Pittsburgh Steelers,15
2010-10-24,Jacksonville Jaguars,Kansas City Chiefs,20,42,2010,7,domingo,Regular Season,3-4,3,4,0,25,25,0,4-2,4,2,0,12,13,-1,Kansas City Chiefs,12
2010-10-24,Minnesota Vikings,Green Bay Packers,24,28,2010,7,domingo,Regular Season,2-4,2,4,0,19,17,2,4-3,4,3,0,10,15,-5,Green Bay Packers,2
2010-10-24,Oakland Raiders,Denver Broncos,59,14,2010,7,domingo,Regular Season,3-4,3,4,0,23,28,-5,2-5,2,5,0,27,22,5,Oakland Raiders,6
2010-10-24,Washington Redskins,Chicago Bears,17,14,2010,7,domingo,Regular Season,4-3,4,3,0,13,14,-1,4-3,4,3,0,15,12,3,Washington Redskins,2
2010-10-24,San Francisco 49ers,Carolina Panthers,20,23,2010,7,domingo,Regular Season,1-6,1,6,0,31,27,4,1-5,1,5,0,29,31,-2,Carolina Panthers,4
2010-10-24,Buffalo Bills,Baltimore Ravens,34,37,2010,7,domingo,Regular Season,0-6,0,6,0,32,32,0,5-2,5,2,0,4,4,0,Baltimore Ravens,28
2010-10-24,Cincinnati Bengals,Atlanta Falcons,32,39,2010,7,domingo,Regular Season,2-4,2,4,0,22,20,2,5-2,5,2,0,5,7,-2,Atlanta Falcons,13
2010-10-18,Tennessee Titans,Jacksonville Jaguars,30,3,2010,6,segunda,Regular Season,4-2,4,2,0,8,12,-4,3-3,3,3,0,25,18,7,Tennessee Titans,6
2010-10-17,Indianapolis Colts,Washington Redskins,27,24,2010,6,domingo,Regular Season,4-2,4,2,0,5,5,0,3-3,3,3,0,14,11,3,Indianapolis Colts,6
2010-10-17,New Orleans Saints,Tampa Bay Buccaneers,31,6,2010,6,domingo,Regular Season,4-2,4,2,0,6,9,-3,3-2,3,2,0,19,16,3,New Orleans Saints,7
2010-10-17,Los Angeles Chargers,Los Angeles Rams,17,20,2010,6,domingo,Regular Season,2-4,2,4,0,24,21,3,3-3,3,3,0,21,26,-5,Los Angeles Rams,5
2010-10-17,Oakland Raiders,San Francisco 49ers,9,17,2010,6,domingo,Regular Season,2-4,2,4,0,28,25,3,1-5,1,5,0,27,30,-3,San Francisco 49ers,5
2010-10-17,Cleveland Browns,Pittsburgh Steelers,10,28,2010,6,domingo,Regular Season,1-5,1,5,0,30,29,1,4-1,4,1,0,1,1,0,Pittsburgh Steelers,28
2010-10-17,Atlanta Falcons,Philadelphia Eagles,17,31,2010,6,domingo,Regular Season,4-2,4,2,0,7,4,3,4-2,4,2,0,10,14,-4,Philadelphia Eagles,10
2010-10-17,Detroit Lions,New York Giants,20,28,2010,6,domingo,Regular Season,1-5,1,5,0,29,28,1,4-2,4,2,0,11,15,-4,New York Giants,13
2010-10-17,Baltimore Ravens,New England Patriots,20,23,2010,6,domingo,Regular Season,4-2,4,2,0,4,2,2,4-1,4,1,0,3,6,-3,New England Patriots,4
2010-10-17,Dallas Cowboys,Minnesota Vikings,21,24,2010,6,domingo,Regular Season,1-4,1,4,0,26,19,7,2-3,2,3,0,17,20,-3,Minnesota Vikings,1
2010-10-17,Kansas City Chiefs,Houston Texans,31,35,2010,6,domingo,Regular Season,3-2,3,2,0,13,10,3,4-2,4,2,0,9,13,-4,Houston Texans,3
2010-10-17,Miami Dolphins,Green Bay Packers,23,20,2010,6,domingo,Regular Season,3-2,3,2,0,16,17,-1,3-3,3,3,0,15,8,7,Miami Dolphins,9
2010-10-17,New York Jets,Denver Broncos,24,20,2010,6,domingo,Regular Season,5-1,5,1,0,2,3,-1,2-4,2,4,0,22,23,-1,New York Jets,20
2010-10-17,Seattle Seahawks,Chicago Bears,23,20,2010,6,domingo,Regular Season,3-2,3,2,0,23,27,-4,4-2,4,2,0,12,7,5,Seattle Seahawks,20
2010-10-11,Minnesota Vikings,New York Jets,20,29,2010,5,segunda,Regular Season,1-3,1,3,0,20,15,5,4-1,4,1,0,3,4,-1,New York Jets,11
2010-10-10,Green Bay Packers,Washington Redskins,13,16,2010,5,domingo,Regular Season,3-2,3,2,0,8,3,5,3-2,3,2,0,11,16,-5,Washington Redskins,13
2010-10-10,Philadelphia Eagles,San Francisco 49ers,27,24,2010,5,domingo,Regular Season,3-2,3,2,0,14,17,-3,0-5,0,5,0,30,28,2,Philadelphia Eagles,11
2010-10-10,Los Angeles Chargers,Oakland Raiders,27,35,2010,5,domingo,Regular Season,2-3,2,3,0,21,12,9,2-3,2,3,0,25,29,-4,Oakland Raiders,17
2010-10-10,Kansas City Chiefs,Indianapolis Colts,9,19,2010,5,domingo,Regular Season,3-1,3,1,0,10,10,0,3-2,3,2,0,5,9,-4,Indianapolis Colts,1
2010-10-10,New York Giants,Houston Texans,34,10,2010,5,domingo,Regular Season,3-2,3,2,0,15,20,-5,3-2,3,2,0,13,7,6,New York Giants,13
2010-10-10,Los Angeles Rams,Detroit Lions,6,44,2010,5,domingo,Regular Season,2-3,2,3,0,26,24,2,1-4,1,4,0,28,31,-3,Detroit Lions,7
2010-10-10,Tennessee Titans,Dallas Cowboys,34,27,2010,5,domingo,Regular Season,3-2,3,2,0,12,19,-7,1-3,1,3,0,19,14,5,Tennessee Titans,5
2010-10-10,Atlanta Falcons,Cleveland Browns,20,10,2010,5,domingo,Regular Season,4-1,4,1,0,4,5,-1,1-4,1,4,0,29,27,2,Atlanta Falcons,22
2010-10-10,Tampa Bay Buccaneers,Cincinnati Bengals,24,21,2010,5,domingo,Regular Season,3-1,3,1,0,16,23,-7,2-3,2,3,0,22,18,4,Tampa Bay Buccaneers,5
2010-10-10,Chicago Bears,Carolina Panthers,23,6,2010,5,domingo,Regular Season,4-1,4,1,0,7,11,-4,0-5,0,5,0,31,30,1,Chicago Bears,19
2010-10-10,Jacksonville Jaguars,Buffalo Bills,36,26,2010,5,domingo,Regular Season,3-2,3,2,0,18,22,-4,0-5,0,5,0,32,32,0,Jacksonville Jaguars,10
2010-10-10,Denver Broncos,Baltimore Ravens,17,31,2010,5,domingo,Regular Season,2-3,2,3,0,23,21,2,4-1,4,1,0,2,6,-4,Baltimore Ravens,15
2010-10-10,New Orleans Saints,Arizona Cardinals,20,30,2010,5,domingo,Regular Season,3-2,3,2,0,9,2,7,3-2,3,2,0,24,25,-1,Arizona Cardinals,23
2010-10-04,New England Patriots,Miami Dolphins,41,14,2010,4,segunda,Regular Season,3-1,3,1,0,8,10,-2,2-2,2,2,0,13,11,2,New England Patriots,1
2010-10-03,Denver Broncos,Tennessee Titans,26,20,2010,4,domingo,Regular Season,2-2,2,2,0,21,23,-2,2-2,2,2,0,19,13,6,Denver Broncos,10
2010-10-03,Seattle Seahawks,Los Angeles Rams,3,20,2010,4,domingo,Regular Season,2-2,2,2,0,26,19,7,2-2,2,2,0,24,27,-3,Los Angeles Rams,8
2010-10-03,Arizona Cardinals,Los Angeles Chargers,10,41,2010,4,domingo,Regular Season,2-2,2,2,0,25,22,3,2-2,2,2,0,12,18,-6,Los Angeles Chargers,4
2010-10-03,Baltimore Ravens,Pittsburgh Steelers,17,14,2010,4,domingo,Regular Season,3-1,3,1,0,6,8,-2,3-1,3,1,0,1,1,0,Baltimore Ravens,7
2010-10-03,Washington Redskins,Philadelphia Eagles,17,12,2010,4,domingo,Regular Season,2-2,2,2,0,16,21,-5,2-2,2,2,0,17,14,3,Washington Redskins,7
2010-10-03,Houston Texans,Oakland Raiders,31,24,2010,4,domingo,Regular Season,3-1,3,1,0,7,9,-2,1-3,1,3,0,29,28,1,Houston Texans,19
2010-10-03,Chicago Bears,New York Giants,3,17,2010,4,domingo,Regular Season,3-1,3,1,0,11,6,5,2-2,2,2,0,20,24,-4,New York Giants,18
2010-10-03,Carolina Panthers,New Orleans Saints,14,16,2010,4,domingo,Regular Season,0-4,0,4,0,30,29,1,3-1,3,1,0,2,2,0,New Orleans Saints,27
2010-10-03,Indianapolis Colts,Jacksonville Jaguars,28,31,2010,4,domingo,Regular Season,2-2,2,2,0,9,3,6,2-2,2,2,0,22,26,-4,Jacksonville Jaguars,23
2010-10-03,Detroit Lions,Green Bay Packers,26,28,2010,4,domingo,Regular Season,0-4,0,4,0,31,31,0,3-1,3,1,0,3,4,-1,Green Bay Packers,27
2010-10-03,Cincinnati Bengals,Cleveland Browns,20,23,2010,4,domingo,Regular Season,2-2,2,2,0,18,12,6,1-3,1,3,0,27,30,-3,Cleveland Browns,18
2010-10-03,New York Jets,Buffalo Bills,38,14,2010,4,domingo,Regular Season,3-1,3,1,0,4,7,-3,0-4,0,4,0,32,32,0,New York Jets,25
2010-10-03,San Francisco 49ers,Atlanta Falcons,14,16,2010,4,domingo,Regular Season,0-4,0,4,0,28,25,3,3-1,3,1,0,5,5,0,Atlanta Falcons,20
2010-09-27,Green Bay Packers,Chicago Bears,17,20,2010,3,segunda,Regular Season,2-1,2,1,0,4,2,2,3-0,3,0,0,6,12,-6,Chicago Bears,10
2010-09-26,Pittsburgh Steelers,Tampa Bay Buccaneers,38,13,2010,3,domingo,Regular Season,3-0,3,0,0,1,5,-4,2-1,2,1,0,20,21,-1,Pittsburgh Steelers,16
2010-09-26,Washington Redskins,Los Angeles Rams,16,30,2010,3,domingo,Regular Season,1-2,1,2,0,21,14,7,1-2,1,2,0,27,31,-4,Los Angeles Rams,17
2010-09-26,Los Angeles Chargers,Seattle Seahawks,20,27,2010,3,domingo,Regular Season,1-2,1,2,0,18,13,5,2-1,2,1,0,19,26,-7,Seattle Seahawks,13
2010-09-26,Tennessee Titans,New York Giants,29,10,2010,3,domingo,Regular Season,2-1,2,1,0,13,15,-2,1-2,1,2,0,24,19,5,Tennessee Titans,4
2010-09-26,Atlanta Falcons,New Orleans Saints,27,24,2010,3,domingo,Regular Season,2-1,2,1,0,5,10,-5,2-1,2,1,0,2,1,1,Atlanta Falcons,9
2010-09-26,Buffalo Bills,New England Patriots,30,38,2010,3,domingo,Regular Season,0-3,0,3,0,32,32,0,2-1,2,1,0,10,9,1,New England Patriots,23
2010-09-26,Detroit Lions,Minnesota Vikings,10,24,2010,3,domingo,Regular Season,0-3,0,3,0,31,29,2,1-2,1,2,0,17,18,-1,Minnesota Vikings,11
2010-09-26,New York Jets,Miami Dolphins,31,23,2010,3,domingo,Regular Season,2-1,2,1,0,7,6,1,2-1,2,1,0,11,7,4,New York Jets,1
2010-09-26,San Francisco 49ers,Kansas City Chiefs,10,31,2010,3,domingo,Regular Season,0-3,0,3,0,25,23,2,3-0,3,0,0,15,20,-5,Kansas City Chiefs,3
2010-09-26,Philadelphia Eagles,Jacksonville Jaguars,28,3,2010,3,domingo,Regular Season,2-1,2,1,0,14,16,-2,1-2,1,2,0,26,25,1,Philadelphia Eagles,9
2010-09-26,Dallas Cowboys,Houston Texans,27,13,2010,3,domingo,Regular Season,1-2,1,2,0,16,17,-1,2-1,2,1,0,9,3,6,Dallas Cowboys,14
2010-09-26,Indianapolis Colts,Denver Broncos,27,13,2010,3,domingo,Regular Season,2-1,2,1,0,3,4,-1,1-2,1,2,0,23,22,1,Indianapolis Colts,18
2010-09-26,Cincinnati Bengals,Carolina Panthers,20,7,2010,3,domingo,Regular Season,2-1,2,1,0,12,11,1,0-3,0,3,0,29,28,1,Cincinnati Bengals,17
2010-09-26,Cleveland Browns,Baltimore Ravens,17,24,2010,3,domingo,Regular Season,0-3,0,3,0,30,30,0,2-1,2,1,0,8,8,0,Baltimore Ravens,22
2010-09-26,Oakland Raiders,Arizona Cardinals,23,24,2010,3,domingo,Regular Season,1-2,1,2,0,28,27,1,2-1,2,1,0,22,24,-2,Arizona Cardinals,3
2010-09-19,Houston Texans,Washington Redskins,30,27,2010,2,domingo,Regular Season,2-0,2,0,0,3,7,-4,1-1,1,1,0,14,14,0,Houston Texans,7
2010-09-19,Pittsburgh Steelers,Tennessee Titans,19,11,2010,2,domingo,Regular Season,2-0,2,0,0,5,10,-5,1-1,1,1,0,15,9,6,Pittsburgh Steelers,1
2010-09-20,New Orleans Saints,San Francisco 49ers,25,22,2010,2,segunda,Regular Season,2-0,2,0,0,1,1,0,0-2,0,2,0,23,20,3,New Orleans Saints,19
2010-09-19,Jacksonville Jaguars,Los Angeles Chargers,13,38,2010,2,domingo,Regular Season,1-1,1,1,0,25,24,1,1-1,1,1,0,13,12,1,Los Angeles Chargers,12
2010-09-19,Los Angeles Rams,Oakland Raiders,14,16,2010,2,domingo,Regular Season,0-2,0,2,0,31,31,0,1-1,1,1,0,27,27,0,Oakland Raiders,4
2010-09-19,New England Patriots,New York Jets,14,28,2010,2,domingo,Regular Season,1-1,1,1,0,9,4,5,1-1,1,1,0,6,11,-5,New York Jets,7
2010-09-19,Miami Dolphins,Minnesota Vikings,14,10,2010,2,domingo,Regular Season,2-0,2,0,0,7,15,-8,0-2,0,2,0,18,6,12,Miami Dolphins,9
2010-09-19,New York Giants,Indianapolis Colts,14,38,2010,2,domingo,Regular Season,1-1,1,1,0,19,16,3,1-1,1,1,0,4,5,-1,Indianapolis Colts,11
2010-09-19,Buffalo Bills,Green Bay Packers,7,34,2010,2,domingo,Regular Season,0-2,0,2,0,32,30,2,2-0,2,0,0,2,2,0,Green Bay Packers,28
2010-09-19,Philadelphia Eagles,Detroit Lions,35,32,2010,2,domingo,Regular Season,1-1,1,1,0,16,18,-2,0-2,0,2,0,29,29,0,Philadelphia Eagles,11
2010-09-19,Seattle Seahawks,Denver Broncos,14,31,2010,2,domingo,Regular Season,1-1,1,1,0,26,21,5,1-1,1,1,0,22,25,-3,Denver Broncos,4
2010-09-19,Chicago Bears,Dallas Cowboys,27,20,2010,2,domingo,Regular Season,2-0,2,0,0,12,22,-10,0-2,0,2,0,17,8,9,Chicago Bears,14
2010-09-19,Kansas City Chiefs,Cleveland Browns,16,14,2010,2,domingo,Regular Season,2-0,2,0,0,20,23,-3,0-2,0,2,0,30,32,-2,Kansas City Chiefs,9
2010-09-19,Baltimore Ravens,Cincinnati Bengals,10,15,2010,2,domingo,Regular Season,1-1,1,1,0,8,3,5,1-1,1,1,0,11,17,-6,Cincinnati Bengals,14
2010-09-19,Tampa Bay Buccaneers,Carolina Panthers,20,7,2010,2,domingo,Regular Season,2-0,2,0,0,21,28,-7,0-2,0,2,0,28,26,2,Tampa Bay Buccaneers,2
2010-09-19,Arizona Cardinals,Atlanta Falcons,7,41,2010,2,domingo,Regular Season,1-1,1,1,0,24,19,5,1-1,1,1,0,10,13,-3,Atlanta Falcons,6
2010-09-13,Baltimore Ravens,New York Jets,10,9,2010,1,segunda,Regular Season,1-0,1,0,0,3,6,-3,0-1,0,1,0,11,9,2,Baltimore Ravens,3
2010-09-13,Los Angeles Chargers,Kansas City Chiefs,14,21,2010,1,segunda,Regular Season,0-1,0,1,0,12,8,4,1-0,1,0,0,23,27,-4,Kansas City Chiefs,19
2010-09-12,Dallas Cowboys,Washington Redskins,7,13,2010,1,domingo,Regular Season,0-1,0,1,0,8,4,4,1-0,1,0,0,14,17,-3,Washington Redskins,13
2010-09-12,Oakland Raiders,Tennessee Titans,13,38,2010,1,domingo,Regular Season,0-1,0,1,0,27,24,3,1-0,1,0,0,9,16,-7,Tennessee Titans,8
2010-09-12,Cleveland Browns,Tampa Bay Buccaneers,14,17,2010,1,domingo,Regular Season,0-1,0,1,0,32,29,3,1-0,1,0,0,28,30,-2,Tampa Bay Buccaneers,1
2010-09-12,Arizona Cardinals,Los Angeles Rams,17,13,2010,1,domingo,Regular Season,1-0,1,0,0,19,20,-1,0-1,0,1,0,31,32,-1,Arizona Cardinals,12
2010-09-12,San Francisco 49ers,Seattle Seahawks,6,31,2010,1,domingo,Regular Season,0-1,0,1,0,20,13,7,1-0,1,0,0,21,26,-5,Seattle Seahawks,13
2010-09-12,Atlanta Falcons,Pittsburgh Steelers,9,15,2010,1,domingo,Regular Season,0-1,0,1,0,13,7,6,1-0,1,0,0,10,18,-8,Pittsburgh Steelers,11
2010-09-12,Green Bay Packers,Philadelphia Eagles,27,20,2010,1,domingo,Regular Season,1-0,1,0,0,2,3,-1,0-1,0,1,0,18,15,3,Green Bay Packers,12
2010-09-12,Carolina Panthers,New York Giants,18,31,2010,1,domingo,Regular Season,0-1,0,1,0,26,23,3,1-0,1,0,0,16,19,-3,New York Giants,4
2010-09-12,Cincinnati Bengals,New England Patriots,24,38,2010,1,domingo,Regular Season,0-1,0,1,0,17,12,5,1-0,1,0,0,4,10,-6,New England Patriots,2
2010-09-12,Denver Broncos,Jacksonville Jaguars,17,24,2010,1,domingo,Regular Season,0-1,0,1,0,25,22,3,1-0,1,0,0,24,25,-1,Jacksonville Jaguars,3
2010-09-12,Indianapolis Colts,Houston Texans,24,34,2010,1,domingo,Regular Season,0-1,0,1,0,5,1,4,1-0,1,0,0,7,14,-7,Houston Texans,13
2010-09-12,Detroit Lions,Chicago Bears,14,19,2010,1,domingo,Regular Season,0-1,0,1,0,29,28,1,1-0,1,0,0,22,21,1,Chicago Bears,7
2010-09-12,Miami Dolphins,Buffalo Bills,15,10,2010,1,domingo,Regular Season,1-0,1,0,0,15,11,4,0-1,0,1,0,30,31,-1,Miami Dolphins,20
2010-09-09,Minnesota Vikings,New Orleans Saints,9,14,2010,1,quinta,Regular Season,0-1,0,1,0,6,5,1,1-0,1,0,0,1,2,-1,New Orleans Saints,3
2010-01-03,Atlanta Falcons,Tampa Bay Buccaneers,20,10,2009,17,domingo,Regular Season,9-7,9,7,0,15,16,-1,3-13,3,13,0,30,29,1,Atlanta Falcons,13
2010-01-03,San Francisco 49ers,Los Angeles Rams,28,6,2009,17,domingo,Regular Season,8-8,8,8,0,19,21,-2,1-15,1,15,0,32,32,0,San Francisco 49ers,11
2010-01-03,Tennessee Titans,Seattle Seahawks,17,13,2009,17,domingo,Regular Season,8-8,8,8,0,16,17,-1,5-11,5,11,0,27,26,1,Tennessee Titans,9
2010-01-03,Washington Redskins,Los Angeles Chargers,20,23,2009,17,domingo,Regular Season,4-12,4,12,0,29,28,1,13-3,13,3,0,2,2,0,Los Angeles Chargers,26
2010-01-03,Baltimore Ravens,Oakland Raiders,21,13,2009,17,domingo,Regular Season,9-7,9,7,0,11,11,0,5-11,5,11,0,26,24,2,Baltimore Ravens,13
2010-01-03,Cincinnati Bengals,New York Jets,0,37,2009,17,domingo,Regular Season,10-6,10,6,0,9,7,2,9-7,9,7,0,12,14,-2,New York Jets,7
2010-01-03,New York Giants,Minnesota Vikings,7,44,2009,17,domingo,Regular Season,8-8,8,8,0,20,18,2,12-4,12,4,0,3,5,-2,Minnesota Vikings,13
2010-01-03,Pittsburgh Steelers,Miami Dolphins,30,24,2009,17,domingo,Regular Season,9-7,9,7,0,13,12,1,7-9,7,9,0,21,20,1,Pittsburgh Steelers,8
2010-01-03,New England Patriots,Houston Texans,27,34,2009,17,domingo,Regular Season,10-6,10,6,0,10,10,0,9-7,9,7,0,14,15,-1,Houston Texans,5
2010-01-03,Chicago Bears,Detroit Lions,37,23,2009,17,domingo,Regular Season,7-9,7,9,0,22,23,-1,2-14,2,14,0,31,31,0,Chicago Bears,8
2010-01-03,Kansas City Chiefs,Denver Broncos,44,24,2009,17,domingo,Regular Season,4-12,4,12,0,28,30,-2,8-8,8,8,0,17,13,4,Kansas City Chiefs,17
2010-01-03,Philadelphia Eagles,Dallas Cowboys,0,24,2009,17,domingo,Regular Season,11-5,11,5,0,7,4,3,11-5,11,5,0,4,9,-5,Dallas Cowboys,5
2010-01-03,Jacksonville Jaguars,Cleveland Browns,17,23,2009,17,domingo,Regular Season,7-9,7,9,0,23,22,1,5-11,5,11,0,25,27,-2,Cleveland Browns,5
2010-01-03,New Orleans Saints,Carolina Panthers,10,23,2009,17,domingo,Regular Season,13-3,13,3,0,5,3,2,8-8,8,8,0,18,19,-1,Carolina Panthers,16
2010-01-03,Indianapolis Colts,Buffalo Bills,7,30,2009,17,domingo,Regular Season,14-2,14,2,0,1,1,0,6-10,6,10,0,24,25,-1,Buffalo Bills,24
2010-01-03,Green Bay Packers,Arizona Cardinals,33,7,2009,17,domingo,Regular Season,11-5,11,5,0,6,8,-2,10-6,10,6,0,8,6,2,Green Bay Packers,2
2009-12-28,Minnesota Vikings,Chicago Bears,30,36,2009,16,segunda,Regular Season,11-4,11,4,0,5,4,1,6-9,6,9,0,23,25,-2,Chicago Bears,21
2009-12-27,Dallas Cowboys,Washington Redskins,17,0,2009,16,domingo,Regular Season,10-5,10,5,0,9,10,-1,4-11,4,11,0,28,27,1,Dallas Cowboys,17
2009-12-27,Detroit Lions,San Francisco 49ers,6,20,2009,16,domingo,Regular Season,2-13,2,13,0,31,31,0,7-8,7,8,0,21,22,-1,San Francisco 49ers,9
2009-12-27,Baltimore Ravens,Pittsburgh Steelers,20,23,2009,16,domingo,Regular Season,8-7,8,7,0,11,11,0,8-7,8,7,0,12,15,-3,Pittsburgh Steelers,4
2009-12-27,Denver Broncos,Philadelphia Eagles,27,30,2009,16,domingo,Regular Season,8-7,8,7,0,13,13,0,11-4,11,4,0,4,5,-1,Philadelphia Eagles,8
2009-12-27,Carolina Panthers,New York Giants,41,9,2009,16,domingo,Regular Season,7-8,7,8,0,19,21,-2,8-7,8,7,0,18,12,6,Carolina Panthers,9
2009-12-27,Tampa Bay Buccaneers,New Orleans Saints,20,17,2009,16,domingo,Regular Season,3-12,3,12,0,29,30,-1,13-2,13,2,0,3,2,1,Tampa Bay Buccaneers,28
2009-12-27,Jacksonville Jaguars,New England Patriots,7,35,2009,16,domingo,Regular Season,7-8,7,8,0,22,18,4,10-5,10,5,0,10,9,1,New England Patriots,9
2009-12-27,Houston Texans,Miami Dolphins,27,20,2009,16,domingo,Regular Season,8-7,8,7,0,15,20,-5,7-8,7,8,0,20,16,4,Houston Texans,4
2009-12-27,New York Jets,Indianapolis Colts,29,15,2009,16,domingo,Regular Season,8-7,8,7,0,14,19,-5,14-1,14,1,0,1,1,0,New York Jets,18
2009-12-27,Seattle Seahawks,Green Bay Packers,10,48,2009,16,domingo,Regular Season,5-10,5,10,0,26,24,2,10-5,10,5,0,8,8,0,Green Bay Packers,16
2009-12-27,Oakland Raiders,Cleveland Browns,9,23,2009,16,domingo,Regular Season,5-10,5,10,0,24,23,1,4-11,4,11,0,27,28,-1,Cleveland Browns,5
2009-12-27,Kansas City Chiefs,Cincinnati Bengals,10,17,2009,16,domingo,Regular Season,3-12,3,12,0,30,29,1,10-5,10,5,0,7,7,0,Cincinnati Bengals,22
2009-12-27,Buffalo Bills,Atlanta Falcons,3,31,2009,16,domingo,Regular Season,5-10,5,10,0,25,26,-1,8-7,8,7,0,16,17,-1,Atlanta Falcons,9
2009-12-27,Los Angeles Rams,Arizona Cardinals,10,31,2009,16,domingo,Regular Season,1-14,1,14,0,32,32,0,10-5,10,5,0,6,6,0,Arizona Cardinals,26
2009-12-25,Los Angeles Chargers,Tennessee Titans,42,17,2009,16,sexta,Regular Season,12-3,12,3,0,2,3,-1,7-8,7,8,0,17,14,3,Los Angeles Chargers,11
2009-12-21,New York Giants,Washington Redskins,45,12,2009,15,segunda,Regular Season,8-6,8,6,0,12,14,-2,4-10,4,10,0,27,26,1,New York Giants,12
2009-12-20,Miami Dolphins,Tennessee Titans,24,27,2009,15,domingo,Regular Season,7-7,7,7,0,16,13,3,7-7,7,7,0,14,17,-3,Tennessee Titans,4
2009-12-20,Houston Texans,Los Angeles Rams,16,13,2009,15,domingo,Regular Season,7-7,7,7,0,20,20,0,1-13,1,13,0,32,32,0,Houston Texans,12
2009-12-20,Tampa Bay Buccaneers,Seattle Seahawks,24,7,2009,15,domingo,Regular Season,2-12,2,12,0,30,31,-1,5-9,5,9,0,24,24,0,Tampa Bay Buccaneers,7
2009-12-20,Cincinnati Bengals,Los Angeles Chargers,24,27,2009,15,domingo,Regular Season,9-5,9,5,0,7,7,0,11-3,11,3,0,3,4,-1,Los Angeles Chargers,3
2009-12-20,Green Bay Packers,Pittsburgh Steelers,36,37,2009,15,domingo,Regular Season,9-5,9,5,0,8,6,2,7-7,7,7,0,15,19,-4,Pittsburgh Steelers,13
2009-12-20,San Francisco 49ers,Philadelphia Eagles,13,27,2009,15,domingo,Regular Season,6-8,6,8,0,22,21,1,10-4,10,4,0,5,5,0,Philadelphia Eagles,16
2009-12-20,Atlanta Falcons,New York Jets,10,7,2009,15,domingo,Regular Season,7-7,7,7,0,17,18,-1,7-7,7,7,0,19,16,3,Atlanta Falcons,2
2009-12-20,Cleveland Browns,Kansas City Chiefs,41,34,2009,15,domingo,Regular Season,3-11,3,11,0,28,29,-1,3-11,3,11,0,29,28,1,Cleveland Browns,1
2009-12-20,Arizona Cardinals,Detroit Lions,31,24,2009,15,domingo,Regular Season,9-5,9,5,0,6,8,-2,2-12,2,12,0,31,30,1,Arizona Cardinals,22
2009-12-20,Oakland Raiders,Denver Broncos,20,19,2009,15,domingo,Regular Season,5-9,5,9,0,23,27,-4,8-6,8,6,0,13,10,3,Oakland Raiders,17
2009-12-20,Minnesota Vikings,Carolina Panthers,7,26,2009,15,domingo,Regular Season,11-3,11,3,0,4,3,1,6-8,6,8,0,21,22,-1,Carolina Panthers,19
2009-12-20,New England Patriots,Buffalo Bills,17,10,2009,15,domingo,Regular Season,9-5,9,5,0,9,9,0,5-9,5,9,0,26,25,1,New England Patriots,16
2009-12-20,Chicago Bears,Baltimore Ravens,7,31,2009,15,domingo,Regular Season,5-9,5,9,0,25,23,2,8-6,8,6,0,11,12,-1,Baltimore Ravens,11
2009-12-19,Dallas Cowboys,New Orleans Saints,24,17,2009,15,sábado,Regular Season,9-5,9,5,0,10,11,-1,13-1,13,1,0,2,1,1,Dallas Cowboys,10
2009-12-17,Indianapolis Colts,Jacksonville Jaguars,35,31,2009,15,quinta,Regular Season,14-0,14,0,0,1,2,-1,7-7,7,7,0,18,15,3,Indianapolis Colts,13
2009-12-14,Arizona Cardinals,San Francisco 49ers,9,24,2009,14,segunda,Regular Season,8-5,8,5,0,8,6,2,6-7,6,7,0,21,23,-2,San Francisco 49ers,17
2009-12-13,Los Angeles Rams,Tennessee Titans,7,47,2009,14,domingo,Regular Season,1-12,1,12,0,32,31,1,6-7,6,7,0,17,17,0,Tennessee Titans,14
2009-12-13,New York Jets,Tampa Bay Buccaneers,26,3,2009,14,domingo,Regular Season,7-6,7,6,0,16,19,-3,1-12,1,12,0,31,30,1,New York Jets,11
2009-12-13,Washington Redskins,Oakland Raiders,34,13,2009,14,domingo,Regular Season,4-9,4,9,0,26,27,-1,4-9,4,9,0,27,25,2,Washington Redskins,2
2009-12-13,Philadelphia Eagles,New York Giants,45,38,2009,14,domingo,Regular Season,9-4,9,4,0,5,8,-3,7-6,7,6,0,14,12,2,Philadelphia Eagles,4
2009-12-13,Carolina Panthers,New England Patriots,10,20,2009,14,domingo,Regular Season,5-8,5,8,0,22,20,2,8-5,8,5,0,9,11,-2,New England Patriots,9
2009-12-13,Cincinnati Bengals,Minnesota Vikings,10,30,2009,14,domingo,Regular Season,9-4,9,4,0,7,5,2,11-2,11,2,0,3,3,0,Minnesota Vikings,2
2009-12-13,Buffalo Bills,Kansas City Chiefs,16,10,2009,14,domingo,Regular Season,5-8,5,8,0,25,26,-1,3-10,3,10,0,28,28,0,Buffalo Bills,2
2009-12-13,Miami Dolphins,Jacksonville Jaguars,14,10,2009,14,domingo,Regular Season,7-6,7,6,0,13,14,-1,7-6,7,6,0,15,13,2,Miami Dolphins,1
2009-12-13,Denver Broncos,Indianapolis Colts,16,28,2009,14,domingo,Regular Season,8-5,8,5,0,10,9,1,13-0,13,0,0,2,2,0,Indianapolis Colts,7
2009-12-13,Seattle Seahawks,Houston Texans,7,34,2009,14,domingo,Regular Season,5-8,5,8,0,24,21,3,6-7,6,7,0,20,22,-2,Houston Texans,1
2009-12-13,Los Angeles Chargers,Dallas Cowboys,20,17,2009,14,domingo,Regular Season,10-3,10,3,0,4,4,0,8-5,8,5,0,11,10,1,Los Angeles Chargers,6
2009-12-13,Green Bay Packers,Chicago Bears,21,14,2009,14,domingo,Regular Season,9-4,9,4,0,6,7,-1,5-8,5,8,0,23,24,-1,Green Bay Packers,17
2009-12-13,Detroit Lions,Baltimore Ravens,3,48,2009,14,domingo,Regular Season,2-11,2,11,0,30,29,1,7-6,7,6,0,12,16,-4,Baltimore Ravens,13
2009-12-13,New Orleans Saints,Atlanta Falcons,26,23,2009,14,domingo,Regular Season,13-0,13,0,0,1,1,0,6-7,6,7,0,18,18,0,New Orleans Saints,17
2009-12-10,Pittsburgh Steelers,Cleveland Browns,6,13,2009,14,quinta,Regular Season,6-7,6,7,0,19,15,4,2-11,2,11,0,29,32,-3,Cleveland Browns,17
2009-12-07,Baltimore Ravens,Green Bay Packers,14,27,2009,13,segunda,Regular Season,6-6,6,6,0,16,13,3,8-4,8,4,0,7,11,-4,Green Bay Packers,2
2009-12-06,New Orleans Saints,Washington Redskins,33,30,2009,13,domingo,Regular Season,12-0,12,0,0,1,1,0,3-9,3,9,0,27,26,1,New Orleans Saints,25
2009-12-06,San Francisco 49ers,Seattle Seahawks,17,20,2009,13,domingo,Regular Season,5-7,5,7,0,23,20,3,5-7,5,7,0,21,25,-4,Seattle Seahawks,5
2009-12-06,Oakland Raiders,Pittsburgh Steelers,27,24,2009,13,domingo,Regular Season,4-8,4,8,0,25,28,-3,6-6,6,6,0,15,12,3,Oakland Raiders,16
2009-12-06,Dallas Cowboys,New York Giants,24,31,2009,13,domingo,Regular Season,8-4,8,4,0,10,7,3,7-5,7,5,0,12,15,-3,New York Giants,8
2009-12-06,New England Patriots,Miami Dolphins,21,22,2009,13,domingo,Regular Season,7-5,7,5,0,11,6,5,6-6,6,6,0,14,19,-5,Miami Dolphins,13
2009-12-06,Denver Broncos,Kansas City Chiefs,44,13,2009,13,domingo,Regular Season,8-4,8,4,0,9,10,-1,3-9,3,9,0,28,27,1,Denver Broncos,17
2009-12-06,Houston Texans,Jacksonville Jaguars,18,23,2009,13,domingo,Regular Season,5-7,5,7,0,22,18,4,7-5,7,5,0,13,17,-4,Jacksonville Jaguars,1
2009-12-06,Tennessee Titans,Indianapolis Colts,17,27,2009,13,domingo,Regular Season,5-7,5,7,0,17,16,1,12-0,12,0,0,2,2,0,Indianapolis Colts,14
2009-12-06,Los Angeles Chargers,Cleveland Browns,30,23,2009,13,domingo,Regular Season,9-3,9,3,0,4,4,0,1-11,1,11,0,32,32,0,Los Angeles Chargers,28
2009-12-06,Detroit Lions,Cincinnati Bengals,13,23,2009,13,domingo,Regular Season,2-10,2,10,0,29,29,0,9-3,9,3,0,5,5,0,Cincinnati Bengals,24
2009-12-06,Los Angeles Rams,Chicago Bears,9,17,2009,13,domingo,Regular Season,1-11,1,11,0,31,31,0,5-7,5,7,0,24,23,1,Chicago Bears,8
2009-12-06,Tampa Bay Buccaneers,Carolina Panthers,6,16,2009,13,domingo,Regular Season,1-11,1,11,0,30,30,0,5-7,5,7,0,20,22,-2,Carolina Panthers,8
2009-12-06,Philadelphia Eagles,Atlanta Falcons,34,7,2009,13,domingo,Regular Season,8-4,8,4,0,8,9,-1,6-6,6,6,0,18,14,4,Philadelphia Eagles,5
2009-12-06,Minnesota Vikings,Arizona Cardinals,17,30,2009,13,domingo,Regular Season,10-2,10,2,0,3,3,0,8-4,8,4,0,6,8,-2,Arizona Cardinals,5
2009-12-03,New York Jets,Buffalo Bills,19,13,2009,13,quinta,Regular Season,6-6,6,6,0,19,21,-2,4-8,4,8,0,26,24,2,New York Jets,3
2009-11-30,New England Patriots,New Orleans Saints,17,38,2009,12,segunda,Regular Season,7-4,7,4,0,6,4,2,11-0,11,0,0,1,1,0,New Orleans Saints,3
2009-11-29,Arizona Cardinals,Tennessee Titans,17,20,2009,12,domingo,Regular Season,7-4,7,4,0,8,5,3,5-6,5,6,0,16,19,-3,Tennessee Titans,14
2009-11-29,Seattle Seahawks,Los Angeles Rams,27,17,2009,12,domingo,Regular Season,4-7,4,7,0,25,25,0,1-10,1,10,0,31,31,0,Seattle Seahawks,6
2009-11-29,Jacksonville Jaguars,San Francisco 49ers,3,20,2009,12,domingo,Regular Season,6-5,6,5,0,17,14,3,5-6,5,6,0,20,20,0,San Francisco 49ers,6
2009-11-29,Kansas City Chiefs,Los Angeles Chargers,14,43,2009,12,domingo,Regular Season,3-8,3,8,0,27,26,1,8-3,8,3,0,4,6,-2,Los Angeles Chargers,20
2009-11-29,Washington Redskins,Philadelphia Eagles,24,27,2009,12,domingo,Regular Season,3-8,3,8,0,26,24,2,7-4,7,4,0,9,10,-1,Philadelphia Eagles,14
2009-11-29,Carolina Panthers,New York Jets,6,17,2009,12,domingo,Regular Season,4-7,4,7,0,22,21,1,5-6,5,6,0,21,22,-1,New York Jets,1
2009-11-29,Chicago Bears,Minnesota Vikings,10,36,2009,12,domingo,Regular Season,4-7,4,7,0,23,23,0,10-1,10,1,0,3,3,0,Minnesota Vikings,20
2009-11-29,Indianapolis Colts,Houston Texans,35,27,2009,12,domingo,Regular Season,11-0,11,0,0,2,2,0,5-6,5,6,0,18,18,0,Indianapolis Colts,16
2009-11-29,Cleveland Browns,Cincinnati Bengals,7,16,2009,12,domingo,Regular Season,1-10,1,10,0,32,32,0,8-3,8,3,0,5,7,-2,Cincinnati Bengals,25
2009-11-29,Miami Dolphins,Buffalo Bills,14,31,2009,12,domingo,Regular Season,5-6,5,6,0,19,17,2,4-7,4,7,0,24,27,-3,Buffalo Bills,10
2009-11-29,Pittsburgh Steelers,Baltimore Ravens,17,20,2009,12,domingo,Regular Season,6-5,6,5,0,12,9,3,6-5,6,5,0,13,15,-2,Baltimore Ravens,6
2009-11-29,Tampa Bay Buccaneers,Atlanta Falcons,17,20,2009,12,domingo,Regular Season,1-10,1,10,0,30,30,0,6-5,6,5,0,14,16,-2,Atlanta Falcons,14
2009-11-26,Green Bay Packers,Detroit Lions,34,12,2009,12,quinta,Regular Season,7-4,7,4,0,11,12,-1,2-9,2,9,0,29,29,0,Green Bay Packers,17
2009-11-26,New York Giants,Denver Broncos,6,26,2009,12,quinta,Regular Season,6-5,6,5,0,15,11,4,7-4,7,4,0,10,13,-3,Denver Broncos,2
2009-11-26,Oakland Raiders,Dallas Cowboys,7,24,2009,12,quinta,Regular Season,3-8,3,8,0,28,28,0,8-3,8,3,0,7,8,-1,Dallas Cowboys,20
2009-11-23,Tennessee Titans,Houston Texans,20,17,2009,11,segunda,Regular Season,4-6,4,6,0,19,22,-3,5-5,5,5,0,18,13,5,Tennessee Titans,9
2009-11-22,New Orleans Saints,Tampa Bay Buccaneers,38,7,2009,11,domingo,Regular Season,10-0,10,0,0,1,1,0,1-9,1,9,0,30,29,1,New Orleans Saints,28
2009-11-22,Arizona Cardinals,Los Angeles Rams,21,13,2009,11,domingo,Regular Season,7-3,7,3,0,5,7,-2,1-9,1,9,0,31,30,1,Arizona Cardinals,23
2009-11-22,Cincinnati Bengals,Oakland Raiders,17,20,2009,11,domingo,Regular Season,7-3,7,3,0,7,4,3,3-7,3,7,0,28,28,0,Oakland Raiders,24
2009-11-22,Atlanta Falcons,New York Giants,31,34,2009,11,domingo,Regular Season,5-5,5,5,0,16,14,2,6-4,6,4,0,11,16,-5,New York Giants,2
2009-11-22,New York Jets,New England Patriots,14,31,2009,11,domingo,Regular Season,4-6,4,6,0,22,21,1,7-3,7,3,0,4,5,-1,New England Patriots,16
2009-11-22,Seattle Seahawks,Minnesota Vikings,9,35,2009,11,domingo,Regular Season,3-7,3,7,0,25,25,0,9-1,9,1,0,3,3,0,Minnesota Vikings,22
2009-11-22,Pittsburgh Steelers,Kansas City Chiefs,24,27,2009,11,domingo,Regular Season,6-4,6,4,0,9,6,3,3-7,3,7,0,26,27,-1,Kansas City Chiefs,21
2009-11-22,Buffalo Bills,Jacksonville Jaguars,15,18,2009,11,domingo,Regular Season,3-7,3,7,0,27,26,1,6-4,6,4,0,14,17,-3,Jacksonville Jaguars,9
2009-11-22,San Francisco 49ers,Green Bay Packers,24,30,2009,11,domingo,Regular Season,4-6,4,6,0,20,19,1,6-4,6,4,0,12,15,-3,Green Bay Packers,4
2009-11-22,Cleveland Browns,Detroit Lions,37,38,2009,11,domingo,Regular Season,1-9,1,9,0,32,32,0,2-8,2,8,0,29,31,-2,Detroit Lions,1
2009-11-22,Los Angeles Chargers,Denver Broncos,32,3,2009,11,domingo,Regular Season,7-3,7,3,0,6,8,-2,6-4,6,4,0,13,9,4,Los Angeles Chargers,1
2009-11-22,Washington Redskins,Dallas Cowboys,6,7,2009,11,domingo,Regular Season,3-7,3,7,0,24,24,0,7-3,7,3,0,8,10,-2,Dallas Cowboys,14
2009-11-22,Philadelphia Eagles,Chicago Bears,24,20,2009,11,domingo,Regular Season,6-4,6,4,0,10,12,-2,4-6,4,6,0,23,23,0,Philadelphia Eagles,11
2009-11-22,Indianapolis Colts,Baltimore Ravens,17,15,2009,11,domingo,Regular Season,10-0,10,0,0,2,2,0,5-5,5,5,0,15,11,4,Indianapolis Colts,9
2009-11-19,Miami Dolphins,Carolina Panthers,24,17,2009,11,quinta,Regular Season,5-5,5,5,0,17,18,-1,4-6,4,6,0,21,20,1,Miami Dolphins,2
2009-11-16,Baltimore Ravens,Cleveland Browns,16,0,2009,10,segunda,Regular Season,5-4,5,4,0,11,14,-3,1-8,1,8,0,32,32,0,Baltimore Ravens,18
2009-11-15,Denver Broncos,Washington Redskins,17,27,2009,10,domingo,Regular Season,6-3,6,3,0,9,7,2,3-6,3,6,0,24,26,-2,Washington Redskins,19
2009-11-15,Buffalo Bills,Tennessee Titans,17,41,2009,10,domingo,Regular Season,3-6,3,6,0,26,24,2,3-6,3,6,0,22,23,-1,Tennessee Titans,1
2009-11-15,New Orleans Saints,Los Angeles Rams,28,23,2009,10,domingo,Regular Season,9-0,9,0,0,1,1,0,1-8,1,8,0,30,30,0,New Orleans Saints,29
2009-11-15,Philadelphia Eagles,Los Angeles Chargers,23,31,2009,10,domingo,Regular Season,5-4,5,4,0,12,11,1,6-3,6,3,0,8,12,-4,Los Angeles Chargers,1
2009-11-15,Cincinnati Bengals,Pittsburgh Steelers,18,12,2009,10,domingo,Regular Season,7-2,7,2,0,4,4,0,6-3,6,3,0,6,5,1,Cincinnati Bengals,1
2009-11-15,Kansas City Chiefs,Oakland Raiders,16,10,2009,10,domingo,Regular Season,2-7,2,7,0,27,28,-1,2-7,2,7,0,28,27,1,Kansas City Chiefs,1
2009-11-15,Jacksonville Jaguars,New York Jets,24,22,2009,10,domingo,Regular Season,5-4,5,4,0,17,22,-5,4-5,4,5,0,21,18,3,Jacksonville Jaguars,4
2009-11-15,Detroit Lions,Minnesota Vikings,10,27,2009,10,domingo,Regular Season,1-8,1,8,0,31,29,2,8-1,8,1,0,3,3,0,Minnesota Vikings,26
2009-11-15,Tampa Bay Buccaneers,Miami Dolphins,23,25,2009,10,domingo,Regular Season,1-8,1,8,0,29,31,-2,4-5,4,5,0,18,17,1,Miami Dolphins,14
2009-11-15,New England Patriots,Indianapolis Colts,34,35,2009,10,domingo,Regular Season,6-3,6,3,0,5,6,-1,9-0,9,0,0,2,2,0,Indianapolis Colts,4
2009-11-15,Dallas Cowboys,Green Bay Packers,7,17,2009,10,domingo,Regular Season,6-3,6,3,0,10,8,2,5-4,5,4,0,15,16,-1,Green Bay Packers,8
2009-11-15,Atlanta Falcons,Carolina Panthers,19,28,2009,10,domingo,Regular Season,5-4,5,4,0,14,9,5,4-5,4,5,0,20,21,-1,Carolina Panthers,12
2009-11-15,Seattle Seahawks,Arizona Cardinals,20,31,2009,10,domingo,Regular Season,3-6,3,6,0,25,25,0,6-3,6,3,0,7,10,-3,Arizona Cardinals,15
2009-11-12,Chicago Bears,San Francisco 49ers,6,10,2009,10,quinta,Regular Season,4-5,4,5,0,23,19,4,4-5,4,5,0,19,20,-1,San Francisco 49ers,1
2009-11-09,Pittsburgh Steelers,Denver Broncos,28,10,2009,9,segunda,Regular Season,6-2,6,2,0,5,7,-2,6-2,6,2,0,7,4,3,Pittsburgh Steelers,3
2009-11-08,Green Bay Packers,Tampa Bay Buccaneers,28,38,2009,9,domingo,Regular Season,4-4,4,4,0,16,12,4,1-7,1,7,0,31,32,-1,Tampa Bay Buccaneers,20
2009-11-08,Detroit Lions,Seattle Seahawks,20,32,2009,9,domingo,Regular Season,1-7,1,7,0,29,29,0,3-5,3,5,0,25,24,1,Seattle Seahawks,5
2009-11-08,Tennessee Titans,San Francisco 49ers,34,27,2009,9,domingo,Regular Season,2-6,2,6,0,23,26,-3,3-5,3,5,0,20,19,1,Tennessee Titans,7
2009-11-08,Dallas Cowboys,Philadelphia Eagles,20,16,2009,9,domingo,Regular Season,6-2,6,2,0,8,8,0,5-3,5,3,0,11,9,2,Dallas Cowboys,1
2009-11-08,Los Angeles Chargers,New York Giants,21,20,2009,9,domingo,Regular Season,5-3,5,3,0,12,16,-4,5-4,5,4,0,15,15,0,Los Angeles Chargers,1
2009-11-08,Carolina Panthers,New Orleans Saints,20,30,2009,9,domingo,Regular Season,3-5,3,5,0,21,23,-2,8-0,8,0,0,1,1,0,New Orleans Saints,22
2009-11-08,Miami Dolphins,New England Patriots,17,27,2009,9,domingo,Regular Season,3-5,3,5,0,17,20,-3,6-2,6,2,0,6,5,1,New England Patriots,15
2009-11-08,Kansas City Chiefs,Jacksonville Jaguars,21,24,2009,9,domingo,Regular Season,1-7,1,7,0,28,28,0,4-4,4,4,0,22,21,1,Jacksonville Jaguars,7
2009-11-08,Houston Texans,Indianapolis Colts,17,20,2009,9,domingo,Regular Season,5-4,5,4,0,13,14,-1,8-0,8,0,0,2,2,0,Indianapolis Colts,12
2009-11-08,Baltimore Ravens,Cincinnati Bengals,7,17,2009,9,domingo,Regular Season,4-4,4,4,0,14,10,4,6-2,6,2,0,4,6,-2,Cincinnati Bengals,4
2009-11-08,Arizona Cardinals,Chicago Bears,41,21,2009,9,domingo,Regular Season,5-3,5,3,0,10,13,-3,4-4,4,4,0,19,17,2,Arizona Cardinals,4
2009-11-08,Washington Redskins,Atlanta Falcons,17,31,2009,9,domingo,Regular Season,2-6,2,6,0,26,25,1,5-3,5,3,0,9,11,-2,Atlanta Falcons,14
2009-11-02,Atlanta Falcons,New Orleans Saints,27,35,2009,8,segunda,Regular Season,4-3,4,3,0,11,11,0,7-0,7,0,0,1,2,-1,New Orleans Saints,9
2009-11-01,Jacksonville Jaguars,Tennessee Titans,13,30,2009,8,domingo,Regular Season,3-4,3,4,0,21,21,0,1-6,1,6,0,26,29,-3,Tennessee Titans,8
2009-11-01,Oakland Raiders,Los Angeles Chargers,16,24,2009,8,domingo,Regular Season,2-6,2,6,0,27,27,0,4-3,4,3,0,16,16,0,Los Angeles Chargers,11
2009-11-01,New York Giants,Philadelphia Eagles,17,40,2009,8,domingo,Regular Season,5-3,5,3,0,15,8,7,5-2,5,2,0,9,12,-3,Philadelphia Eagles,4
2009-11-01,Miami Dolphins,New York Jets,30,25,2009,8,domingo,Regular Season,3-4,3,4,0,20,19,1,4-4,4,4,0,18,15,3,Miami Dolphins,4
2009-11-01,San Francisco 49ers,Indianapolis Colts,14,18,2009,8,domingo,Regular Season,3-4,3,4,0,19,20,-1,7-0,7,0,0,2,1,1,Indianapolis Colts,19
2009-11-01,Minnesota Vikings,Green Bay Packers,38,26,2009,8,domingo,Regular Season,7-1,7,1,0,3,4,-1,4-3,4,3,0,12,13,-1,Minnesota Vikings,9
2009-11-01,Los Angeles Rams,Detroit Lions,17,10,2009,8,domingo,Regular Season,1-7,1,7,0,30,32,-2,1-6,1,6,0,29,26,3,Los Angeles Rams,6
2009-11-01,Seattle Seahawks,Dallas Cowboys,17,38,2009,8,domingo,Regular Season,2-5,2,5,0,24,23,1,5-2,5,2,0,8,9,-1,Dallas Cowboys,14
2009-11-01,Cleveland Browns,Chicago Bears,6,30,2009,8,domingo,Regular Season,1-7,1,7,0,31,30,1,4-3,4,3,0,17,18,-1,Chicago Bears,12
2009-11-01,Houston Texans,Buffalo Bills,31,10,2009,8,domingo,Regular Season,5-3,5,3,0,14,17,-3,3-5,3,5,0,22,22,0,Houston Texans,5
2009-11-01,Denver Broncos,Baltimore Ravens,7,30,2009,8,domingo,Regular Season,6-1,6,1,0,4,3,1,4-3,4,3,0,10,14,-4,Baltimore Ravens,11
2009-11-01,Carolina Panthers,Arizona Cardinals,34,21,2009,8,domingo,Regular Season,3-4,3,4,0,23,24,-1,4-3,4,3,0,13,10,3,Carolina Panthers,14
2009-10-26,Philadelphia Eagles,Washington Redskins,27,17,2009,7,segunda,Regular Season,4-2,4,2,0,12,12,0,2-5,2,5,0,25,27,-2,Philadelphia Eagles,15
2009-10-25,New England Patriots,Tampa Bay Buccaneers,35,7,2009,7,domingo,Regular Season,5-2,5,2,0,5,6,-1,0-7,0,7,0,31,31,0,New England Patriots,25
2009-10-25,Indianapolis Colts,Los Angeles Rams,42,6,2009,7,domingo,Regular Season,6-0,6,0,0,1,1,0,0-7,0,7,0,32,32,0,Indianapolis Colts,31
2009-10-25,Minnesota Vikings,Pittsburgh Steelers,17,27,2009,7,domingo,Regular Season,6-1,6,1,0,4,3,1,5-2,5,2,0,7,8,-1,Pittsburgh Steelers,5
2009-10-25,New York Jets,Oakland Raiders,38,0,2009,7,domingo,Regular Season,4-3,4,3,0,15,18,-3,2-5,2,5,0,27,25,2,New York Jets,7
2009-10-25,Arizona Cardinals,New York Giants,24,17,2009,7,domingo,Regular Season,4-2,4,2,0,10,16,-6,5-2,5,2,0,8,5,3,Arizona Cardinals,11
2009-10-25,New Orleans Saints,Miami Dolphins,46,34,2009,7,domingo,Regular Season,6-0,6,0,0,2,2,0,2-4,2,4,0,19,20,-1,New Orleans Saints,18
2009-10-25,Los Angeles Chargers,Kansas City Chiefs,37,7,2009,7,domingo,Regular Season,3-3,3,3,0,16,14,2,1-6,1,6,0,28,28,0,Los Angeles Chargers,14
2009-10-25,San Francisco 49ers,Houston Texans,21,24,2009,7,domingo,Regular Season,3-3,3,3,0,20,15,5,4-3,4,3,0,17,17,0,Houston Texans,2
2009-10-25,Atlanta Falcons,Dallas Cowboys,21,37,2009,7,domingo,Regular Season,4-2,4,2,0,11,7,4,4-2,4,2,0,9,19,-10,Dallas Cowboys,12
2009-10-25,Green Bay Packers,Cleveland Browns,31,3,2009,7,domingo,Regular Season,4-2,4,2,0,13,13,0,1-6,1,6,0,30,29,1,Green Bay Packers,16
2009-10-25,Chicago Bears,Cincinnati Bengals,10,45,2009,7,domingo,Regular Season,3-3,3,3,0,18,10,8,5-2,5,2,0,6,9,-3,Cincinnati Bengals,1
2009-10-25,Buffalo Bills,Carolina Panthers,20,9,2009,7,domingo,Regular Season,3-4,3,4,0,22,24,-2,2-4,2,4,0,24,22,2,Buffalo Bills,2
2009-10-19,Denver Broncos,Los Angeles Chargers,34,23,2009,6,segunda,Regular Season,6-0,6,0,0,4,5,-1,2-3,2,3,0,14,16,-2,Denver Broncos,11
2009-10-18,Kansas City Chiefs,Washington Redskins,14,6,2009,6,domingo,Regular Season,1-5,1,5,0,28,30,-2,2-4,2,4,0,27,24,3,Kansas City Chiefs,6
2009-10-18,Carolina Panthers,Tampa Bay Buccaneers,28,21,2009,6,domingo,Regular Season,2-3,2,3,0,22,23,-1,0-6,0,6,0,31,31,0,Carolina Panthers,8
2009-10-18,Arizona Cardinals,Seattle Seahawks,27,3,2009,6,domingo,Regular Season,3-2,3,2,0,16,19,-3,2-4,2,4,0,23,20,3,Arizona Cardinals,1
2009-10-18,Cleveland Browns,Pittsburgh Steelers,14,27,2009,6,domingo,Regular Season,1-5,1,5,0,29,28,1,4-2,4,2,0,8,13,-5,Pittsburgh Steelers,15
2009-10-18,Philadelphia Eagles,Oakland Raiders,9,13,2009,6,domingo,Regular Season,3-2,3,2,0,12,7,5,2-4,2,4,0,25,29,-4,Oakland Raiders,22
2009-10-18,Buffalo Bills,New York Jets,16,13,2009,6,domingo,Regular Season,2-4,2,4,0,24,25,-1,3-3,3,3,0,18,9,9,Buffalo Bills,16
2009-10-18,New York Giants,New Orleans Saints,27,48,2009,6,domingo,Regular Season,5-1,5,1,0,5,2,3,5-0,5,0,0,2,4,-2,New Orleans Saints,2
2009-10-18,Tennessee Titans,New England Patriots,0,59,2009,6,domingo,Regular Season,0-6,0,6,0,30,27,3,4-2,4,2,0,6,10,-4,New England Patriots,17
2009-10-18,Baltimore Ravens,Minnesota Vikings,31,33,2009,6,domingo,Regular Season,3-3,3,3,0,11,11,0,6-0,6,0,0,3,3,0,Minnesota Vikings,8
2009-10-18,Los Angeles Rams,Jacksonville Jaguars,20,23,2009,6,domingo,Regular Season,0-6,0,6,0,32,32,0,3-3,3,3,0,21,21,0,Jacksonville Jaguars,11
2009-10-18,Detroit Lions,Green Bay Packers,0,26,2009,6,domingo,Regular Season,1-5,1,5,0,26,26,0,3-2,3,2,0,13,14,-1,Green Bay Packers,12
2009-10-18,Houston Texans,Cincinnati Bengals,28,17,2009,6,domingo,Regular Season,3-3,3,3,0,17,22,-5,4-2,4,2,0,9,6,3,Houston Texans,16
2009-10-18,Chicago Bears,Atlanta Falcons,14,21,2009,6,domingo,Regular Season,3-2,3,2,0,10,12,-2,4-1,4,1,0,7,8,-1,Atlanta Falcons,4
2009-10-12,New York Jets,Miami Dolphins,27,31,2009,5,segunda,Regular Season,3-2,3,2,0,9,5,4,2-3,2,3,0,18,21,-3,Miami Dolphins,16
2009-10-11,Indianapolis Colts,Tennessee Titans,31,9,2009,5,domingo,Regular Season,5-0,5,0,0,1,1,0,0-5,0,5,0,27,25,2,Indianapolis Colts,24
2009-10-11,Minnesota Vikings,Los Angeles Rams,38,10,2009,5,domingo,Regular Season,5-0,5,0,0,3,3,0,0-5,0,5,0,32,32,0,Minnesota Vikings,29
2009-10-11,Jacksonville Jaguars,Seattle Seahawks,0,41,2009,5,domingo,Regular Season,2-3,2,3,0,21,18,3,2-3,2,3,0,20,24,-4,Seattle Seahawks,6
2009-10-11,Atlanta Falcons,San Francisco 49ers,45,10,2009,5,domingo,Regular Season,3-1,3,1,0,8,9,-1,3-2,3,2,0,15,12,3,Atlanta Falcons,3
2009-10-11,Tampa Bay Buccaneers,Philadelphia Eagles,14,33,2009,5,domingo,Regular Season,0-5,0,5,0,31,31,0,3-1,3,1,0,7,10,-3,Philadelphia Eagles,21
2009-10-11,Oakland Raiders,New York Giants,7,44,2009,5,domingo,Regular Season,1-4,1,4,0,29,28,1,5-0,5,0,0,2,2,0,New York Giants,26
2009-10-11,Dallas Cowboys,Kansas City Chiefs,26,20,2009,5,domingo,Regular Season,3-2,3,2,0,17,17,0,0-5,0,5,0,30,30,0,Dallas Cowboys,13
2009-10-11,Pittsburgh Steelers,Detroit Lions,28,20,2009,5,domingo,Regular Season,3-2,3,2,0,13,15,-2,1-4,1,4,0,26,27,-1,Pittsburgh Steelers,12
2009-10-11,New England Patriots,Denver Broncos,17,20,2009,5,domingo,Regular Season,3-2,3,2,0,10,6,4,5-0,5,0,0,5,8,-3,Denver Broncos,2
2009-10-11,Washington Redskins,Carolina Panthers,17,20,2009,5,domingo,Regular Season,2-3,2,3,0,24,22,2,1-3,1,3,0,23,26,-3,Carolina Panthers,4
2009-10-11,Cleveland Browns,Buffalo Bills,6,3,2009,5,domingo,Regular Season,1-4,1,4,0,28,29,-1,1-4,1,4,0,25,23,2,Cleveland Browns,6
2009-10-11,Cincinnati Bengals,Baltimore Ravens,17,14,2009,5,domingo,Regular Season,4-1,4,1,0,6,11,-5,3-2,3,2,0,11,7,4,Cincinnati Bengals,4
2009-10-11,Houston Texans,Arizona Cardinals,21,28,2009,5,domingo,Regular Season,2-3,2,3,0,22,20,2,2-2,2,2,0,19,19,0,Arizona Cardinals,1
2009-10-05,Green Bay Packers,Minnesota Vikings,23,30,2009,4,segunda,Regular Season,2-2,2,2,0,13,10,3,4-0,4,0,0,3,5,-2,Minnesota Vikings,5
2009-10-04,Tampa Bay Buccaneers,Washington Redskins,13,16,2009,4,domingo,Regular Season,0-4,0,4,0,31,31,0,2-2,2,2,0,22,26,-4,Washington Redskins,5
2009-10-04,Los Angeles Rams,San Francisco 49ers,0,35,2009,4,domingo,Regular Season,0-4,0,4,0,32,32,0,3-1,3,1,0,12,15,-3,San Francisco 49ers,17
2009-10-04,Los Angeles Chargers,Pittsburgh Steelers,28,38,2009,4,domingo,Regular Season,2-2,2,2,0,16,12,4,2-2,2,2,0,15,16,-1,Pittsburgh Steelers,4
2009-10-04,New York Jets,New Orleans Saints,10,24,2009,4,domingo,Regular Season,3-1,3,1,0,5,6,-1,4-0,4,0,0,4,4,0,New Orleans Saints,2
2009-10-04,Baltimore Ravens,New England Patriots,21,27,2009,4,domingo,Regular Season,3-1,3,1,0,7,1,6,3-1,3,1,0,6,7,-1,New England Patriots,6
2009-10-04,Buffalo Bills,Miami Dolphins,10,38,2009,4,domingo,Regular Season,1-3,1,3,0,23,21,2,1-3,1,3,0,21,24,-3,Miami Dolphins,3
2009-10-04,New York Giants,Kansas City Chiefs,27,16,2009,4,domingo,Regular Season,4-0,4,0,0,2,3,-1,0-4,0,4,0,30,30,0,New York Giants,27
2009-10-04,Tennessee Titans,Jacksonville Jaguars,17,37,2009,4,domingo,Regular Season,0-4,0,4,0,25,18,7,2-2,2,2,0,18,22,-4,Jacksonville Jaguars,4
2009-10-04,Seattle Seahawks,Indianapolis Colts,17,34,2009,4,domingo,Regular Season,1-3,1,3,0,24,23,1,4-0,4,0,0,1,2,-1,Indianapolis Colts,21
2009-10-04,Oakland Raiders,Houston Texans,6,29,2009,4,domingo,Regular Season,1-3,1,3,0,28,27,1,2-2,2,2,0,20,20,0,Houston Texans,7
2009-10-04,Dallas Cowboys,Denver Broncos,10,17,2009,4,domingo,Regular Season,2-2,2,2,0,17,17,0,4-0,4,0,0,8,13,-5,Denver Broncos,4
2009-10-04,Cincinnati Bengals,Cleveland Browns,23,20,2009,4,domingo,Regular Season,3-1,3,1,0,11,11,0,0-4,0,4,0,29,29,0,Cincinnati Bengals,18
2009-10-04,Detroit Lions,Chicago Bears,24,48,2009,4,domingo,Regular Season,1-3,1,3,0,27,28,-1,3-1,3,1,0,14,14,0,Chicago Bears,14
2009-09-28,Carolina Panthers,Dallas Cowboys,7,21,2009,3,segunda,Regular Season,0-3,0,3,0,25,25,0,2-1,2,1,0,17,15,2,Dallas Cowboys,10
2009-09-27,New York Giants,Tampa Bay Buccaneers,24,0,2009,3,domingo,Regular Season,3-0,3,0,0,3,2,1,0-3,0,3,0,31,28,3,New York Giants,26
2009-09-27,Green Bay Packers,Los Angeles Rams,36,17,2009,3,domingo,Regular Season,2-1,2,1,0,10,12,-2,0-3,0,3,0,32,32,0,Green Bay Packers,20
2009-09-27,Chicago Bears,Seattle Seahawks,25,19,2009,3,domingo,Regular Season,2-1,2,1,0,14,14,0,1-2,1,2,0,23,22,1,Chicago Bears,8
2009-09-27,Miami Dolphins,Los Angeles Chargers,13,23,2009,3,domingo,Regular Season,0-3,0,3,0,24,19,5,2-1,2,1,0,12,11,1,Los Angeles Chargers,8
2009-09-27,Kansas City Chiefs,Philadelphia Eagles,14,34,2009,3,domingo,Regular Season,0-3,0,3,0,30,30,0,2-1,2,1,0,9,9,0,Philadelphia Eagles,21
2009-09-27,Denver Broncos,Oakland Raiders,23,3,2009,3,domingo,Regular Season,3-0,3,0,0,13,20,-7,1-2,1,2,0,27,26,1,Denver Broncos,6
2009-09-27,Tennessee Titans,New York Jets,17,24,2009,3,domingo,Regular Season,0-3,0,3,0,18,16,2,3-0,3,0,0,6,8,-2,New York Jets,8
2009-09-27,Atlanta Falcons,New England Patriots,10,26,2009,3,domingo,Regular Season,2-1,2,1,0,8,4,4,2-1,2,1,0,7,10,-3,New England Patriots,6
2009-09-27,San Francisco 49ers,Minnesota Vikings,24,27,2009,3,domingo,Regular Season,2-1,2,1,0,15,13,2,3-0,3,0,0,5,5,0,Minnesota Vikings,8
2009-09-27,Jacksonville Jaguars,Houston Texans,31,24,2009,3,domingo,Regular Season,1-2,1,2,0,22,27,-5,1-2,1,2,0,20,17,3,Jacksonville Jaguars,10
2009-09-27,Washington Redskins,Detroit Lions,14,19,2009,3,domingo,Regular Season,1-2,1,2,0,26,23,3,1-2,1,2,0,28,31,-3,Detroit Lions,8
2009-09-27,Pittsburgh Steelers,Cincinnati Bengals,20,23,2009,3,domingo,Regular Season,1-2,1,2,0,16,6,10,2-1,2,1,0,11,24,-13,Cincinnati Bengals,18
2009-09-27,New Orleans Saints,Buffalo Bills,27,7,2009,3,domingo,Regular Season,3-0,3,0,0,4,7,-3,1-2,1,2,0,21,21,0,New Orleans Saints,14
2009-09-27,Cleveland Browns,Baltimore Ravens,3,34,2009,3,domingo,Regular Season,0-3,0,3,0,29,29,0,3-0,3,0,0,1,1,0,Baltimore Ravens,28
2009-09-27,Indianapolis Colts,Arizona Cardinals,31,10,2009,3,domingo,Regular Season,3-0,3,0,0,2,3,-1,1-2,1,2,0,19,18,1,Indianapolis Colts,15
2009-09-21,Indianapolis Colts,Miami Dolphins,27,23,2009,2,segunda,Regular Season,2-0,2,0,0,3,5,-2,0-2,0,2,0,19,19,0,Indianapolis Colts,14
2009-09-20,Los Angeles Rams,Washington Redskins,7,9,2009,2,domingo,Regular Season,0-2,0,2,0,32,32,0,1-1,1,1,0,23,20,3,Washington Redskins,12
2009-09-20,Houston Texans,Tennessee Titans,34,31,2009,2,domingo,Regular Season,1-1,1,1,0,17,23,-6,0-2,0,2,0,16,9,7,Houston Texans,14
2009-09-20,Seattle Seahawks,San Francisco 49ers,10,23,2009,2,domingo,Regular Season,1-1,1,1,0,22,14,8,2-0,2,0,0,13,18,-5,San Francisco 49ers,4
2009-09-20,Baltimore Ravens,Los Angeles Chargers,31,26,2009,2,domingo,Regular Season,2-0,2,0,0,1,10,-9,1-1,1,1,0,11,6,5,Baltimore Ravens,4
2009-09-20,New Orleans Saints,Philadelphia Eagles,48,22,2009,2,domingo,Regular Season,2-0,2,0,0,7,12,-5,1-1,1,1,0,9,4,5,New Orleans Saints,8
2009-09-20,New England Patriots,New York Jets,9,16,2009,2,domingo,Regular Season,1-1,1,1,0,10,2,8,2-0,2,0,0,8,16,-8,New York Jets,14
2009-09-20,Oakland Raiders,Kansas City Chiefs,13,10,2009,2,domingo,Regular Season,1-1,1,1,0,26,27,-1,0-2,0,2,0,30,30,0,Oakland Raiders,3
2009-09-20,Arizona Cardinals,Jacksonville Jaguars,31,17,2009,2,domingo,Regular Season,1-1,1,1,0,18,17,1,0-2,0,2,0,27,25,2,Arizona Cardinals,8
2009-09-20,Cincinnati Bengals,Green Bay Packers,31,24,2009,2,domingo,Regular Season,1-1,1,1,0,24,26,-2,1-1,1,1,0,12,11,1,Cincinnati Bengals,15
2009-09-20,Minnesota Vikings,Detroit Lions,27,13,2009,2,domingo,Regular Season,2-0,2,0,0,5,8,-3,0-2,0,2,0,31,31,0,Minnesota Vikings,23
2009-09-20,Cleveland Browns,Denver Broncos,6,27,2009,2,domingo,Regular Season,0-2,0,2,0,29,28,1,2-0,2,0,0,20,24,-4,Denver Broncos,4
2009-09-20,New York Giants,Dallas Cowboys,33,31,2009,2,domingo,Regular Season,2-0,2,0,0,2,3,-1,1-1,1,1,0,15,13,2,New York Giants,10
2009-09-20,Pittsburgh Steelers,Chicago Bears,14,17,2009,2,domingo,Regular Season,1-1,1,1,0,6,1,5,1-1,1,1,0,14,15,-1,Chicago Bears,14
2009-09-20,Tampa Bay Buccaneers,Buffalo Bills,20,33,2009,2,domingo,Regular Season,0-2,0,2,0,28,29,-1,1-1,1,1,0,21,21,0,Buffalo Bills,8
2009-09-20,Carolina Panthers,Atlanta Falcons,20,28,2009,2,domingo,Regular Season,0-2,0,2,0,25,22,3,2-0,2,0,0,4,7,-3,Atlanta Falcons,15
2009-09-14,Los Angeles Chargers,Oakland Raiders,24,20,2009,1,segunda,Regular Season,1-0,1,0,0,6,5,1,0-1,0,1,0,27,30,-3,Los Angeles Chargers,25
2009-09-14,Buffalo Bills,New England Patriots,24,25,2009,1,segunda,Regular Season,0-1,0,1,0,21,21,0,1-0,1,0,0,2,2,0,New England Patriots,19
2009-09-13,Dallas Cowboys,Tampa Bay Buccaneers,34,21,2009,1,domingo,Regular Season,1-0,1,0,0,13,17,-4,0-1,0,1,0,29,26,3,Dallas Cowboys,9
2009-09-13,Los Angeles Rams,Seattle Seahawks,0,28,2009,1,domingo,Regular Season,0-1,0,1,0,32,31,1,1-0,1,0,0,14,15,-1,Seattle Seahawks,16
2009-09-13,Washington Redskins,New York Giants,17,23,2009,1,domingo,Regular Season,0-1,0,1,0,20,20,0,1-0,1,0,0,3,3,0,New York Giants,17
2009-09-13,Detroit Lions,New Orleans Saints,27,45,2009,1,domingo,Regular Season,0-1,0,1,0,31,32,-1,1-0,1,0,0,12,18,-6,New Orleans Saints,14
2009-09-13,Jacksonville Jaguars,Indianapolis Colts,12,14,2009,1,domingo,Regular Season,0-1,0,1,0,25,25,0,1-0,1,0,0,5,6,-1,Indianapolis Colts,19
2009-09-13,New York Jets,Houston Texans,24,7,2009,1,domingo,Regular Season,1-0,1,0,0,16,23,-7,0-1,0,1,0,23,19,4,New York Jets,4
2009-09-13,Chicago Bears,Green Bay Packers,15,21,2009,1,domingo,Regular Season,0-1,0,1,0,15,11,4,1-0,1,0,0,11,12,-1,Green Bay Packers,1
2009-09-13,Minnesota Vikings,Cleveland Browns,34,20,2009,1,domingo,Regular Season,1-0,1,0,0,8,9,-1,0-1,0,1,0,28,28,0,Minnesota Vikings,19
2009-09-13,Denver Broncos,Cincinnati Bengals,12,7,2009,1,domingo,Regular Season,1-0,1,0,0,24,27,-3,0-1,0,1,0,26,24,2,Denver Broncos,3
2009-09-13,Philadelphia Eagles,Carolina Panthers,38,10,2009,1,domingo,Regular Season,1-0,1,0,0,4,4,0,0-1,0,1,0,22,14,8,Philadelphia Eagles,10
2009-09-13,Kansas City Chiefs,Baltimore Ravens,24,38,2009,1,domingo,Regular Season,0-1,0,1,0,30,29,1,1-0,1,0,0,10,10,0,Baltimore Ravens,19
2009-09-13,Miami Dolphins,Atlanta Falcons,7,19,2009,1,domingo,Regular Season,0-1,0,1,0,19,16,3,1-0,1,0,0,7,8,-1,Atlanta Falcons,8
2009-09-13,San Francisco 49ers,Arizona Cardinals,20,16,2009,1,domingo,Regular Season,1-0,1,0,0,18,22,-4,0-1,0,1,0,17,13,4,San Francisco 49ers,9
2009-09-10,Tennessee Titans,Pittsburgh Steelers,10,13,2009,1,quinta,Regular Season,0-1,0,1,0,9,7,2,1-0,1,0,0,1,1,0,Pittsburgh Steelers,6
2008-12-28,Oakland Raiders,Tampa Bay Buccaneers,31,24,2008,17,domingo,Regular Season,5-11,5,11,0,26,27,-1,9-7,9,7,0,16,12,4,Oakland Raiders,15
2008-12-28,Washington Redskins,San Francisco 49ers,24,27,2008,17,domingo,Regular Season,8-8,8,8,0,21,18,3,7-9,7,9,0,20,23,-3,San Francisco 49ers,5
2008-12-28,Denver Broncos,Los Angeles Chargers,21,52,2008,17,domingo,Regular Season,8-8,8,8,0,22,20,2,8-8,8,8,0,12,16,-4,Los Angeles Chargers,4
2008-12-28,Cleveland Browns,Pittsburgh Steelers,0,31,2008,17,domingo,Regular Season,4-12,4,12,0,29,28,1,12-4,12,4,0,3,4,-1,Pittsburgh Steelers,24
2008-12-28,Dallas Cowboys,Philadelphia Eagles,6,44,2008,17,domingo,Regular Season,9-7,9,7,0,14,10,4,9-6,9,6,0,11,15,-4,Philadelphia Eagles,5
2008-12-28,Miami Dolphins,New York Jets,24,17,2008,17,domingo,Regular Season,11-5,11,5,0,8,9,-1,9-7,9,7,0,17,14,3,Miami Dolphins,5
2008-12-28,Carolina Panthers,New Orleans Saints,33,31,2008,17,domingo,Regular Season,12-4,12,4,0,4,3,1,8-8,8,8,0,19,17,2,Carolina Panthers,14
2008-12-28,New York Giants,Minnesota Vikings,19,20,2008,17,domingo,Regular Season,12-4,12,4,0,2,2,0,10-6,10,6,0,10,11,-1,Minnesota Vikings,9
2008-12-28,Tennessee Titans,Indianapolis Colts,0,23,2008,17,domingo,Regular Season,13-3,13,3,0,1,1,0,12-4,12,4,0,5,5,0,Indianapolis Colts,4
2008-12-28,Chicago Bears,Houston Texans,24,31,2008,17,domingo,Regular Season,9-7,9,7,0,15,13,2,8-8,8,8,0,18,21,-3,Houston Texans,8
2008-12-28,Detroit Lions,Green Bay Packers,21,31,2008,17,domingo,Regular Season,0-16,0,16,0,32,32,0,6-10,6,10,0,24,24,0,Green Bay Packers,8
2008-12-28,Kansas City Chiefs,Cincinnati Bengals,6,16,2008,17,domingo,Regular Season,2-14,2,14,0,30,30,0,4-11,4,11,0,27,29,-2,Cincinnati Bengals,1
2008-12-28,New England Patriots,Buffalo Bills,13,0,2008,17,domingo,Regular Season,11-5,11,5,0,9,8,1,7-9,7,9,0,23,22,1,New England Patriots,14
2008-12-28,Jacksonville Jaguars,Baltimore Ravens,7,27,2008,17,domingo,Regular Season,5-11,5,11,0,25,25,0,11-5,11,5,0,6,6,0,Baltimore Ravens,19
2008-12-28,Los Angeles Rams,Atlanta Falcons,27,31,2008,17,domingo,Regular Season,2-14,2,14,0,31,31,0,11-5,11,5,0,7,7,0,Atlanta Falcons,24
2008-12-28,Seattle Seahawks,Arizona Cardinals,21,34,2008,17,domingo,Regular Season,4-12,4,12,0,28,26,2,9-7,9,7,0,13,19,-6,Arizona Cardinals,7
2008-12-22,Green Bay Packers,Chicago Bears,17,20,2008,16,segunda,Regular Season,5-10,5,10,0,24,25,-1,9-6,9,6,0,13,16,-3,Chicago Bears,9
2008-12-21,Philadelphia Eagles,Washington Redskins,3,10,2008,16,domingo,Regular Season,8-6,8,6,0,15,13,2,8-7,8,7,0,18,20,-2,Washington Redskins,7
2008-12-21,Pittsburgh Steelers,Tennessee Titans,14,31,2008,16,domingo,Regular Season,11-4,11,4,0,4,1,3,13-2,13,2,0,1,2,-1,Tennessee Titans,1
2008-12-21,Los Angeles Chargers,Tampa Bay Buccaneers,41,24,2008,16,domingo,Regular Season,7-8,7,8,0,16,21,-5,9-6,9,6,0,12,10,2,Los Angeles Chargers,11
2008-12-21,San Francisco 49ers,Los Angeles Rams,17,16,2008,16,domingo,Regular Season,6-9,6,9,0,23,24,-1,2-13,2,13,0,31,31,0,San Francisco 49ers,7
2008-12-21,New York Jets,Seattle Seahawks,3,13,2008,16,domingo,Regular Season,9-6,9,6,0,14,14,0,4-11,4,11,0,26,27,-1,Seattle Seahawks,13
2008-12-21,Houston Texans,Oakland Raiders,16,27,2008,16,domingo,Regular Season,7-8,7,8,0,21,18,3,4-11,4,11,0,27,30,-3,Oakland Raiders,12
2008-12-21,Carolina Panthers,New York Giants,28,34,2008,16,domingo,Regular Season,11-4,11,4,0,3,3,0,12-3,12,3,0,2,4,-2,New York Giants,1
2008-12-21,Arizona Cardinals,New England Patriots,7,47,2008,16,domingo,Regular Season,8-7,8,7,0,19,15,4,10-5,10,5,0,8,9,-1,New England Patriots,6
2008-12-21,Atlanta Falcons,Minnesota Vikings,24,17,2008,16,domingo,Regular Season,10-5,10,5,0,7,8,-1,9-6,9,6,0,11,12,-1,Atlanta Falcons,4
2008-12-21,Miami Dolphins,Kansas City Chiefs,38,31,2008,16,domingo,Regular Season,10-5,10,5,0,9,11,-2,2-13,2,13,0,30,28,2,Miami Dolphins,17
2008-12-21,New Orleans Saints,Detroit Lions,42,7,2008,16,domingo,Regular Season,8-7,8,7,0,17,19,-2,0-15,0,15,0,32,32,0,New Orleans Saints,13
2008-12-21,Buffalo Bills,Denver Broncos,30,23,2008,16,domingo,Regular Season,7-8,7,8,0,22,22,0,8-7,8,7,0,20,17,3,Buffalo Bills,5
2008-12-21,Cincinnati Bengals,Cleveland Browns,14,0,2008,16,domingo,Regular Season,3-11,3,11,0,29,29,0,4-11,4,11,0,28,26,2,Cincinnati Bengals,3
2008-12-20,Baltimore Ravens,Dallas Cowboys,33,24,2008,16,sábado,Regular Season,10-5,10,5,0,6,7,-1,9-6,9,6,0,10,6,4,Baltimore Ravens,1
2008-12-18,Indianapolis Colts,Jacksonville Jaguars,31,24,2008,16,quinta,Regular Season,11-4,11,4,0,5,5,0,5-10,5,10,0,25,23,2,Indianapolis Colts,18
2008-12-15,Cleveland Browns,Philadelphia Eagles,10,30,2008,15,segunda,Regular Season,4-10,4,10,0,26,26,0,8-5,8,5,0,13,14,-1,Philadelphia Eagles,12
2008-12-14,Seattle Seahawks,Los Angeles Rams,23,20,2008,15,domingo,Regular Season,3-11,3,11,0,27,28,-1,2-12,2,12,0,31,30,1,Seattle Seahawks,2
2008-12-14,New England Patriots,Oakland Raiders,49,26,2008,15,domingo,Regular Season,9-5,9,5,0,9,10,-1,3-11,3,11,0,30,29,1,New England Patriots,19
2008-12-14,Buffalo Bills,New York Jets,27,31,2008,15,domingo,Regular Season,6-8,6,8,0,22,22,0,9-5,9,5,0,14,13,1,New York Jets,9
2008-12-14,San Francisco 49ers,Miami Dolphins,9,14,2008,15,domingo,Regular Season,5-9,5,9,0,24,24,0,9-5,9,5,0,11,12,-1,Miami Dolphins,12
2008-12-14,Los Angeles Chargers,Kansas City Chiefs,22,21,2008,15,domingo,Regular Season,6-8,6,8,0,21,21,0,2-12,2,12,0,28,27,1,Los Angeles Chargers,6
2008-12-14,Green Bay Packers,Jacksonville Jaguars,16,20,2008,15,domingo,Regular Season,5-9,5,9,0,25,23,2,5-9,5,9,0,23,25,-2,Jacksonville Jaguars,2
2008-12-14,Detroit Lions,Indianapolis Colts,21,31,2008,15,domingo,Regular Season,0-14,0,14,0,32,32,0,10-4,10,4,0,5,5,0,Indianapolis Colts,27
2008-12-14,Tennessee Titans,Houston Texans,12,13,2008,15,domingo,Regular Season,12-2,12,2,0,2,1,1,7-7,7,7,0,18,20,-2,Houston Texans,19
2008-12-14,New York Giants,Dallas Cowboys,8,20,2008,15,domingo,Regular Season,11-3,11,3,0,4,2,2,9-5,9,5,0,6,8,-2,Dallas Cowboys,6
2008-12-14,Washington Redskins,Cincinnati Bengals,13,20,2008,15,domingo,Regular Season,7-7,7,7,0,20,18,2,2-11,2,11,0,29,31,-2,Cincinnati Bengals,13
2008-12-14,Denver Broncos,Carolina Panthers,10,30,2008,15,domingo,Regular Season,8-6,8,6,0,17,16,1,11-3,11,3,0,3,4,-1,Carolina Panthers,12
2008-12-14,Pittsburgh Steelers,Baltimore Ravens,13,9,2008,15,domingo,Regular Season,11-3,11,3,0,1,3,-2,9-5,9,5,0,7,7,0,Pittsburgh Steelers,4
2008-12-14,Tampa Bay Buccaneers,Atlanta Falcons,10,13,2008,15,domingo,Regular Season,9-5,9,5,0,10,6,4,9-5,9,5,0,8,11,-3,Atlanta Falcons,5
2008-12-14,Minnesota Vikings,Arizona Cardinals,35,14,2008,15,domingo,Regular Season,9-5,9,5,0,12,15,-3,8-6,8,6,0,15,9,6,Minnesota Vikings,6
2008-12-11,New Orleans Saints,Chicago Bears,24,27,2008,15,quinta,Regular Season,7-7,7,7,0,19,17,2,8-6,8,6,0,16,19,-3,Chicago Bears,2
2008-12-08,Tampa Bay Buccaneers,Carolina Panthers,23,38,2008,14,segunda,Regular Season,9-4,9,4,0,6,4,2,10-3,10,3,0,4,5,-1,Carolina Panthers,1
2008-12-07,Cleveland Browns,Tennessee Titans,9,28,2008,14,domingo,Regular Season,4-9,4,9,0,26,26,0,12-1,12,1,0,1,2,-1,Tennessee Titans,24
2008-12-07,New England Patriots,Seattle Seahawks,24,21,2008,14,domingo,Regular Season,8-5,8,5,0,10,11,-1,2-11,2,11,0,28,29,-1,New England Patriots,18
2008-12-07,New York Jets,San Francisco 49ers,14,24,2008,14,domingo,Regular Season,8-5,8,5,0,13,7,6,5-8,5,8,0,24,25,-1,San Francisco 49ers,18
2008-12-07,Dallas Cowboys,Pittsburgh Steelers,13,20,2008,14,domingo,Regular Season,8-5,8,5,0,8,8,0,10-3,10,3,0,3,3,0,Pittsburgh Steelers,5
2008-12-07,Philadelphia Eagles,New York Giants,20,14,2008,14,domingo,Regular Season,7-5,7,5,0,14,17,-3,11-2,11,2,0,2,1,1,Philadelphia Eagles,16
2008-12-07,Atlanta Falcons,New Orleans Saints,25,29,2008,14,domingo,Regular Season,8-5,8,5,0,11,9,2,7-6,7,6,0,17,18,-1,New Orleans Saints,9
2008-12-07,Cincinnati Bengals,Indianapolis Colts,3,35,2008,14,domingo,Regular Season,1-11,1,11,0,31,31,0,9-4,9,4,0,5,6,-1,Indianapolis Colts,25
2008-12-07,Houston Texans,Green Bay Packers,24,21,2008,14,domingo,Regular Season,6-7,6,7,0,20,22,-2,5-8,5,8,0,23,20,3,Houston Texans,2
2008-12-07,Minnesota Vikings,Detroit Lions,20,16,2008,14,domingo,Regular Season,8-5,8,5,0,15,15,0,0-13,0,13,0,32,32,0,Minnesota Vikings,17
2008-12-07,Kansas City Chiefs,Denver Broncos,17,24,2008,14,domingo,Regular Season,2-11,2,11,0,27,27,0,8-5,8,5,0,16,14,2,Denver Broncos,13
2008-12-07,Jacksonville Jaguars,Chicago Bears,10,23,2008,14,domingo,Regular Season,4-9,4,9,0,25,24,1,7-6,7,6,0,19,19,0,Chicago Bears,5
2008-12-07,Miami Dolphins,Buffalo Bills,16,3,2008,14,domingo,Regular Season,8-5,8,5,0,12,16,-4,6-7,6,7,0,22,21,1,Miami Dolphins,5
2008-12-07,Washington Redskins,Baltimore Ravens,10,24,2008,14,domingo,Regular Season,7-6,7,6,0,18,13,5,9-4,9,4,0,7,10,-3,Baltimore Ravens,3
2008-12-07,Los Angeles Rams,Arizona Cardinals,10,34,2008,14,domingo,Regular Season,2-11,2,11,0,30,30,0,8-5,8,5,0,9,12,-3,Arizona Cardinals,18
2008-12-04,Oakland Raiders,Los Angeles Chargers,7,34,2008,14,quinta,Regular Season,3-10,3,10,0,29,28,1,5-8,5,8,0,21,23,-2,Los Angeles Chargers,5
2008-12-01,Jacksonville Jaguars,Houston Texans,17,30,2008,13,segunda,Regular Season,4-8,4,8,0,24,24,0,5-7,5,7,0,22,23,-1,Houston Texans,1
2008-11-30,New York Giants,Washington Redskins,23,7,2008,13,domingo,Regular Season,11-1,11,1,0,1,1,0,7-5,7,5,0,13,12,1,New York Giants,11
2008-11-30,New Orleans Saints,Tampa Bay Buccaneers,20,23,2008,13,domingo,Regular Season,6-6,6,6,0,18,16,2,9-3,9,3,0,4,5,-1,Tampa Bay Buccaneers,11
2008-11-30,Miami Dolphins,Los Angeles Rams,16,12,2008,13,domingo,Regular Season,7-5,7,5,0,16,14,2,2-10,2,10,0,30,29,1,Miami Dolphins,15
2008-11-30,Atlanta Falcons,Los Angeles Chargers,22,16,2008,13,domingo,Regular Season,8-4,8,4,0,9,10,-1,4-8,4,8,0,23,22,1,Atlanta Falcons,12
2008-11-30,Kansas City Chiefs,Oakland Raiders,20,13,2008,13,domingo,Regular Season,2-10,2,10,0,27,31,-4,3-9,3,9,0,28,26,2,Kansas City Chiefs,5
2008-11-30,Denver Broncos,New York Jets,34,17,2008,13,domingo,Regular Season,7-5,7,5,0,14,19,-5,8-4,8,4,0,7,3,4,Denver Broncos,16
2008-11-30,Pittsburgh Steelers,New England Patriots,33,10,2008,13,domingo,Regular Season,9-3,9,3,0,3,4,-1,7-5,7,5,0,11,8,3,Pittsburgh Steelers,4
2008-11-30,Chicago Bears,Minnesota Vikings,14,34,2008,13,domingo,Regular Season,6-6,6,6,0,19,15,4,7-5,7,5,0,15,17,-2,Minnesota Vikings,2
2008-11-30,Carolina Panthers,Green Bay Packers,35,31,2008,13,domingo,Regular Season,9-3,9,3,0,5,7,-2,5-7,5,7,0,20,20,0,Carolina Panthers,13
2008-11-30,Indianapolis Colts,Cleveland Browns,10,6,2008,13,domingo,Regular Season,8-4,8,4,0,6,6,0,4-8,4,8,0,26,25,1,Indianapolis Colts,19
2008-11-30,Baltimore Ravens,Cincinnati Bengals,34,3,2008,13,domingo,Regular Season,8-4,8,4,0,10,13,-3,1-10,1,10,0,31,30,1,Baltimore Ravens,17
2008-11-30,San Francisco 49ers,Buffalo Bills,10,3,2008,13,domingo,Regular Season,4-8,4,8,0,25,27,-2,6-6,6,6,0,21,18,3,San Francisco 49ers,9
2008-11-27,Arizona Cardinals,Philadelphia Eagles,20,48,2008,13,quinta,Regular Season,7-5,7,5,0,12,11,1,6-5,6,5,0,17,21,-4,Philadelphia Eagles,10
2008-11-27,Tennessee Titans,Detroit Lions,47,10,2008,13,quinta,Regular Season,11-1,11,1,0,2,2,0,0-12,0,12,0,32,32,0,Tennessee Titans,30
2008-11-27,Seattle Seahawks,Dallas Cowboys,9,34,2008,13,quinta,Regular Season,2-10,2,10,0,29,28,1,8-4,8,4,0,8,9,-1,Dallas Cowboys,19
2008-11-24,Green Bay Packers,New Orleans Saints,29,51,2008,12,segunda,Regular Season,5-6,5,6,0,20,16,4,6-5,6,5,0,16,20,-4,New Orleans Saints,4
2008-11-23,New York Jets,Tennessee Titans,34,13,2008,12,domingo,Regular Season,8-3,8,3,0,3,6,-3,10-1,10,1,0,2,1,1,New York Jets,5
2008-11-23,Chicago Bears,Los Angeles Rams,27,3,2008,12,domingo,Regular Season,6-5,6,5,0,15,19,-4,2-9,2,9,0,29,28,1,Chicago Bears,9
2008-11-23,Washington Redskins,Seattle Seahawks,20,17,2008,12,domingo,Regular Season,7-4,7,4,0,12,9,3,2-9,2,9,0,28,27,1,Washington Redskins,18
2008-11-23,Indianapolis Colts,Los Angeles Chargers,23,20,2008,12,domingo,Regular Season,7-4,7,4,0,6,8,-2,4-7,4,7,0,22,22,0,Indianapolis Colts,14
2008-11-23,New England Patriots,Miami Dolphins,48,28,2008,12,domingo,Regular Season,7-4,7,4,0,8,10,-2,6-5,6,5,0,14,12,2,New England Patriots,2
2008-11-23,Buffalo Bills,Kansas City Chiefs,54,31,2008,12,domingo,Regular Season,6-5,6,5,0,18,18,0,1-10,1,10,0,31,30,1,Buffalo Bills,12
2008-11-23,Minnesota Vikings,Jacksonville Jaguars,30,12,2008,12,domingo,Regular Season,6-5,6,5,0,17,21,-4,4-7,4,7,0,24,23,1,Minnesota Vikings,2
2008-11-23,Tampa Bay Buccaneers,Detroit Lions,38,20,2008,12,domingo,Regular Season,8-3,8,3,0,5,5,0,0-11,0,11,0,32,32,0,Tampa Bay Buccaneers,27
2008-11-23,Oakland Raiders,Denver Broncos,31,10,2008,12,domingo,Regular Season,3-8,3,8,0,26,31,-5,6-5,6,5,0,19,15,4,Oakland Raiders,16
2008-11-23,San Francisco 49ers,Dallas Cowboys,22,35,2008,12,domingo,Regular Season,3-8,3,8,0,27,26,1,7-4,7,4,0,9,11,-2,Dallas Cowboys,15
2008-11-23,Houston Texans,Cleveland Browns,16,6,2008,12,domingo,Regular Season,4-7,4,7,0,23,25,-2,4-7,4,7,0,25,24,1,Houston Texans,1
2008-11-23,Philadelphia Eagles,Baltimore Ravens,7,36,2008,12,domingo,Regular Season,5-5,5,5,0,21,17,4,7-4,7,4,0,13,13,0,Baltimore Ravens,4
2008-11-23,Carolina Panthers,Atlanta Falcons,28,45,2008,12,domingo,Regular Season,8-3,8,3,0,7,3,4,7-4,7,4,0,10,14,-4,Atlanta Falcons,11
2008-11-23,New York Giants,Arizona Cardinals,37,29,2008,12,domingo,Regular Season,10-1,10,1,0,1,2,-1,7-4,7,4,0,11,7,4,New York Giants,5
2008-11-20,Cincinnati Bengals,Pittsburgh Steelers,10,27,2008,12,quinta,Regular Season,1-9,1,9,0,30,29,1,8-3,8,3,0,4,4,0,Pittsburgh Steelers,25
2008-11-17,Cleveland Browns,Buffalo Bills,29,27,2008,11,segunda,Regular Season,4-6,4,6,0,24,24,0,5-5,5,5,0,18,17,1,Cleveland Browns,7
2008-11-16,Dallas Cowboys,Washington Redskins,14,10,2008,11,domingo,Regular Season,6-4,6,4,0,11,16,-5,6-4,6,4,0,9,5,4,Dallas Cowboys,11
2008-11-16,Minnesota Vikings,Tampa Bay Buccaneers,13,19,2008,11,domingo,Regular Season,5-5,5,5,0,21,18,3,7-3,7,3,0,5,6,-1,Tampa Bay Buccaneers,12
2008-11-16,Arizona Cardinals,Seattle Seahawks,26,20,2008,11,domingo,Regular Season,7-3,7,3,0,7,11,-4,2-8,2,8,0,27,27,0,Arizona Cardinals,16
2008-11-16,Los Angeles Rams,San Francisco 49ers,16,35,2008,11,domingo,Regular Season,2-8,2,8,0,28,28,0,3-7,3,7,0,26,26,0,San Francisco 49ers,2
2008-11-16,Los Angeles Chargers,Pittsburgh Steelers,10,11,2008,11,domingo,Regular Season,4-6,4,6,0,22,20,2,7-3,7,3,0,4,4,0,Pittsburgh Steelers,16
2008-11-16,Baltimore Ravens,New York Giants,10,30,2008,11,domingo,Regular Season,6-4,6,4,0,13,12,1,9-1,9,1,0,2,2,0,New York Giants,10
2008-11-16,Oakland Raiders,Miami Dolphins,15,17,2008,11,domingo,Regular Season,2-8,2,8,0,31,31,0,6-4,6,4,0,12,15,-3,Miami Dolphins,16
2008-11-16,New Orleans Saints,Kansas City Chiefs,30,20,2008,11,domingo,Regular Season,5-5,5,5,0,20,23,-3,1-9,1,9,0,30,29,1,New Orleans Saints,6
2008-11-16,Tennessee Titans,Jacksonville Jaguars,24,14,2008,11,domingo,Regular Season,10-0,10,0,0,1,1,0,4-6,4,6,0,23,22,1,Tennessee Titans,21
2008-11-16,Houston Texans,Indianapolis Colts,27,33,2008,11,domingo,Regular Season,3-7,3,7,0,25,25,0,6-4,6,4,0,8,10,-2,Indianapolis Colts,15
2008-11-16,Chicago Bears,Green Bay Packers,3,37,2008,11,domingo,Regular Season,5-5,5,5,0,19,14,5,5-5,5,5,0,16,21,-5,Green Bay Packers,7
2008-11-16,Philadelphia Eagles,Cincinnati Bengals,13,13,2008,11,domingo,Regular Season,5-4,5,4,0,17,13,4,1-8,1,8,0,29,30,-1,Draw,17
2008-11-16,Detroit Lions,Carolina Panthers,22,31,2008,11,domingo,Regular Season,0-10,0,10,0,32,32,0,8-2,8,2,0,3,3,0,Carolina Panthers,29
2008-11-16,Denver Broncos,Atlanta Falcons,24,20,2008,11,domingo,Regular Season,6-4,6,4,0,15,19,-4,6-4,6,4,0,14,8,6,Denver Broncos,11
2008-11-13,New York Jets,New England Patriots,34,31,2008,11,quinta,Regular Season,7-3,7,3,0,6,9,-3,6-4,6,4,0,10,7,3,New York Jets,2
2008-11-10,San Francisco 49ers,Arizona Cardinals,24,29,2008,10,segunda,Regular Season,2-7,2,7,0,26,28,-2,6-3,6,3,0,11,8,3,Arizona Cardinals,20
2008-11-09,Kansas City Chiefs,Los Angeles Chargers,19,20,2008,10,domingo,Regular Season,1-8,1,8,0,29,31,-2,4-5,4,5,0,20,21,-1,Los Angeles Chargers,10
2008-11-09,Indianapolis Colts,Pittsburgh Steelers,24,20,2008,10,domingo,Regular Season,5-4,5,4,0,10,15,-5,6-3,6,3,0,4,3,1,Indianapolis Colts,12
2008-11-09,New York Giants,Philadelphia Eagles,36,31,2008,10,domingo,Regular Season,8-1,8,1,0,2,2,0,5-4,5,4,0,13,6,7,New York Giants,4
2008-11-09,Carolina Panthers,Oakland Raiders,17,6,2008,10,domingo,Regular Season,7-2,7,2,0,3,4,-1,2-7,2,7,0,31,30,1,Carolina Panthers,26
2008-11-09,Los Angeles Rams,New York Jets,3,47,2008,10,domingo,Regular Season,2-7,2,7,0,28,26,2,6-3,6,3,0,9,11,-2,New York Jets,15
2008-11-09,Buffalo Bills,New England Patriots,10,20,2008,10,domingo,Regular Season,5-4,5,4,0,17,14,3,6-3,6,3,0,7,12,-5,New England Patriots,2
2008-11-09,Green Bay Packers,Minnesota Vikings,27,28,2008,10,domingo,Regular Season,4-5,4,5,0,21,16,5,5-4,5,4,0,18,20,-2,Minnesota Vikings,4
2008-11-09,Seattle Seahawks,Miami Dolphins,19,21,2008,10,domingo,Regular Season,2-7,2,7,0,27,27,0,5-4,5,4,0,15,17,-2,Miami Dolphins,10
2008-11-09,Baltimore Ravens,Houston Texans,41,13,2008,10,domingo,Regular Season,6-3,6,3,0,12,13,-1,3-6,3,6,0,25,25,0,Baltimore Ravens,12
2008-11-09,Jacksonville Jaguars,Detroit Lions,38,14,2008,10,domingo,Regular Season,4-5,4,5,0,22,23,-1,0-9,0,9,0,32,32,0,Jacksonville Jaguars,9
2008-11-09,Tennessee Titans,Chicago Bears,21,14,2008,10,domingo,Regular Season,9-0,9,0,0,1,1,0,5-4,5,4,0,14,9,5,Tennessee Titans,8
2008-11-09,New Orleans Saints,Atlanta Falcons,20,34,2008,10,domingo,Regular Season,4-5,4,5,0,23,18,5,6-3,6,3,0,8,10,-2,Atlanta Falcons,8
2008-11-06,Denver Broncos,Cleveland Browns,34,30,2008,10,quinta,Regular Season,5-4,5,4,0,19,22,-3,3-6,3,6,0,24,24,0,Denver Broncos,2
2008-11-03,Pittsburgh Steelers,Washington Redskins,23,6,2008,9,segunda,Regular Season,6-2,6,2,0,3,4,-1,6-3,6,3,0,5,5,0,Pittsburgh Steelers,1
2008-11-02,Green Bay Packers,Tennessee Titans,16,19,2008,9,domingo,Regular Season,4-4,4,4,0,16,11,5,8-0,8,0,0,1,1,0,Tennessee Titans,10
2008-11-02,Arizona Cardinals,Los Angeles Rams,34,13,2008,9,domingo,Regular Season,5-3,5,3,0,8,13,-5,2-6,2,6,0,26,26,0,Arizona Cardinals,13
2008-11-02,Philadelphia Eagles,Seattle Seahawks,26,7,2008,9,domingo,Regular Season,5-3,5,3,0,6,10,-4,2-6,2,6,0,27,27,0,Philadelphia Eagles,17
2008-11-02,Atlanta Falcons,Oakland Raiders,24,0,2008,9,domingo,Regular Season,5-3,5,3,0,10,16,-6,2-6,2,6,0,30,28,2,Atlanta Falcons,12
2008-11-02,Dallas Cowboys,New York Giants,14,35,2008,9,domingo,Regular Season,5-4,5,4,0,19,8,11,7-1,7,1,0,2,2,0,New York Giants,6
2008-11-02,Houston Texans,Minnesota Vikings,21,28,2008,9,domingo,Regular Season,3-5,3,5,0,25,25,0,4-4,4,4,0,20,23,-3,Minnesota Vikings,2
2008-11-02,Tampa Bay Buccaneers,Kansas City Chiefs,30,27,2008,9,domingo,Regular Season,6-3,6,3,0,7,9,-2,1-7,1,7,0,31,30,1,Tampa Bay Buccaneers,21
2008-11-02,New England Patriots,Indianapolis Colts,15,18,2008,9,domingo,Regular Season,5-3,5,3,0,12,7,5,4-4,4,4,0,15,18,-3,Indianapolis Colts,11
2008-11-02,Miami Dolphins,Denver Broncos,26,17,2008,9,domingo,Regular Season,4-4,4,4,0,17,24,-7,4-4,4,4,0,22,15,7,Miami Dolphins,9
2008-11-02,Baltimore Ravens,Cleveland Browns,37,27,2008,9,domingo,Regular Season,5-3,5,3,0,13,14,-1,3-5,3,5,0,24,22,2,Baltimore Ravens,8
2008-11-02,Jacksonville Jaguars,Cincinnati Bengals,19,21,2008,9,domingo,Regular Season,3-5,3,5,0,23,20,3,1-8,1,8,0,29,31,-2,Cincinnati Bengals,11
2008-11-02,Detroit Lions,Chicago Bears,23,27,2008,9,domingo,Regular Season,0-8,0,8,0,32,32,0,5-3,5,3,0,9,12,-3,Chicago Bears,20
2008-11-02,New York Jets,Buffalo Bills,26,17,2008,9,domingo,Regular Season,5-3,5,3,0,11,19,-8,5-3,5,3,0,14,6,8,New York Jets,13
2008-10-27,Indianapolis Colts,Tennessee Titans,21,31,2008,8,segunda,Regular Season,3-4,3,4,0,18,16,2,7-0,7,0,0,1,1,0,Tennessee Titans,15
2008-10-26,Seattle Seahawks,San Francisco 49ers,34,13,2008,8,domingo,Regular Season,2-5,2,5,0,27,29,-2,2-6,2,6,0,29,28,1,Seattle Seahawks,1
2008-10-26,New York Giants,Pittsburgh Steelers,21,14,2008,8,domingo,Regular Season,6-1,6,1,0,2,2,0,5-2,5,2,0,4,3,1,New York Giants,1
2008-10-26,Atlanta Falcons,Philadelphia Eagles,14,27,2008,8,domingo,Regular Season,4-3,4,3,0,16,14,2,4-3,4,3,0,10,11,-1,Philadelphia Eagles,3
2008-10-26,Kansas City Chiefs,New York Jets,24,28,2008,8,domingo,Regular Season,1-6,1,6,0,30,30,0,4-3,4,3,0,19,19,0,New York Jets,11
2008-10-26,Los Angeles Chargers,New Orleans Saints,32,37,2008,8,domingo,Regular Season,3-5,3,5,0,21,17,4,4-4,4,4,0,17,21,-4,New Orleans Saints,4
2008-10-26,Los Angeles Rams,New England Patriots,16,23,2008,8,domingo,Regular Season,2-5,2,5,0,26,25,1,5-2,5,2,0,7,9,-2,New England Patriots,16
2008-10-26,Buffalo Bills,Miami Dolphins,16,25,2008,8,domingo,Regular Season,5-2,5,2,0,6,4,2,3-4,3,4,0,24,26,-2,Miami Dolphins,22
2008-10-26,Cleveland Browns,Jacksonville Jaguars,23,17,2008,8,domingo,Regular Season,3-4,3,4,0,22,24,-2,3-4,3,4,0,20,12,8,Cleveland Browns,12
2008-10-26,Cincinnati Bengals,Houston Texans,6,35,2008,8,domingo,Regular Season,0-8,0,8,0,31,31,0,3-4,3,4,0,25,23,2,Houston Texans,8
2008-10-26,Washington Redskins,Detroit Lions,25,17,2008,8,domingo,Regular Season,6-2,6,2,0,5,5,0,0-7,0,7,0,32,32,0,Washington Redskins,27
2008-10-26,Tampa Bay Buccaneers,Dallas Cowboys,9,13,2008,8,domingo,Regular Season,5-3,5,3,0,9,6,3,5-3,5,3,0,8,15,-7,Dallas Cowboys,9
2008-10-26,Arizona Cardinals,Carolina Panthers,23,27,2008,8,domingo,Regular Season,4-3,4,3,0,13,8,5,6-2,6,2,0,3,7,-4,Carolina Panthers,1
2008-10-26,Oakland Raiders,Baltimore Ravens,10,29,2008,8,domingo,Regular Season,2-5,2,5,0,28,27,1,4-3,4,3,0,14,20,-6,Baltimore Ravens,7
2008-10-20,Denver Broncos,New England Patriots,7,41,2008,7,segunda,Regular Season,4-3,4,3,0,18,12,6,4-2,4,2,0,9,17,-8,New England Patriots,5
2008-10-19,Cleveland Browns,Washington Redskins,11,14,2008,7,domingo,Regular Season,2-4,2,4,0,24,22,2,5-2,5,2,0,5,5,0,Washington Redskins,17
2008-10-19,Seattle Seahawks,Tampa Bay Buccaneers,10,20,2008,7,domingo,Regular Season,1-5,1,5,0,29,27,2,5-2,5,2,0,6,7,-1,Tampa Bay Buccaneers,20
2008-10-19,Dallas Cowboys,Los Angeles Rams,14,34,2008,7,domingo,Regular Season,4-3,4,3,0,15,6,9,2-4,2,4,0,25,28,-3,Los Angeles Rams,22
2008-10-19,New York Jets,Oakland Raiders,13,16,2008,7,domingo,Regular Season,3-3,3,3,0,19,16,3,2-4,2,4,0,27,29,-2,Oakland Raiders,13
2008-10-19,San Francisco 49ers,New York Giants,17,29,2008,7,domingo,Regular Season,2-5,2,5,0,28,25,3,5-1,5,1,0,2,2,0,New York Giants,23
2008-10-19,Baltimore Ravens,Miami Dolphins,27,13,2008,7,domingo,Regular Season,3-3,3,3,0,20,23,-3,2-4,2,4,0,26,24,2,Baltimore Ravens,1
2008-10-19,Tennessee Titans,Kansas City Chiefs,34,10,2008,7,domingo,Regular Season,6-0,6,0,0,1,1,0,1-5,1,5,0,30,30,0,Tennessee Titans,29
2008-10-19,Detroit Lions,Houston Texans,21,28,2008,7,domingo,Regular Season,0-6,0,6,0,32,32,0,2-4,2,4,0,23,26,-3,Houston Texans,6
2008-10-19,Indianapolis Colts,Green Bay Packers,14,34,2008,7,domingo,Regular Season,3-3,3,3,0,16,8,8,4-3,4,3,0,10,19,-9,Green Bay Packers,11
2008-10-19,Pittsburgh Steelers,Cincinnati Bengals,38,10,2008,7,domingo,Regular Season,5-1,5,1,0,3,3,0,0-7,0,7,0,31,31,0,Pittsburgh Steelers,28
2008-10-19,Minnesota Vikings,Chicago Bears,41,48,2008,7,domingo,Regular Season,3-4,3,4,0,22,21,1,4-3,4,3,0,13,20,-7,Chicago Bears,1
2008-10-19,New Orleans Saints,Carolina Panthers,7,30,2008,7,domingo,Regular Season,3-4,3,4,0,21,18,3,5-2,5,2,0,7,10,-3,Carolina Panthers,8
2008-10-19,Los Angeles Chargers,Buffalo Bills,14,23,2008,7,domingo,Regular Season,3-4,3,4,0,17,11,6,5-1,5,1,0,4,4,0,Buffalo Bills,7
2008-10-13,New York Giants,Cleveland Browns,14,35,2008,6,segunda,Regular Season,4-1,4,1,0,2,1,1,2-3,2,3,0,22,25,-3,Cleveland Browns,24
2008-10-12,Los Angeles Rams,Washington Redskins,19,17,2008,6,domingo,Regular Season,1-4,1,4,0,28,32,-4,4-2,4,2,0,5,3,2,Los Angeles Rams,29
2008-10-12,Carolina Panthers,Tampa Bay Buccaneers,3,27,2008,6,domingo,Regular Season,4-2,4,2,0,10,6,4,4-2,4,2,0,7,13,-6,Tampa Bay Buccaneers,7
2008-10-12,Green Bay Packers,Seattle Seahawks,27,17,2008,6,domingo,Regular Season,3-3,3,3,0,19,21,-2,1-4,1,4,0,27,26,1,Green Bay Packers,5
2008-10-12,Philadelphia Eagles,San Francisco 49ers,40,26,2008,6,domingo,Regular Season,3-3,3,3,0,13,12,1,2-4,2,4,0,25,24,1,Philadelphia Eagles,12
2008-10-12,New England Patriots,Los Angeles Chargers,10,30,2008,6,domingo,Regular Season,3-2,3,2,0,17,9,8,3-3,3,3,0,11,16,-5,Los Angeles Chargers,7
2008-10-12,Cincinnati Bengals,New York Jets,14,26,2008,6,domingo,Regular Season,0-6,0,6,0,31,30,1,3-2,3,2,0,16,18,-2,New York Jets,12
2008-10-12,Oakland Raiders,New Orleans Saints,3,34,2008,6,domingo,Regular Season,1-4,1,4,0,29,27,2,3-3,3,3,0,18,22,-4,New Orleans Saints,5
2008-10-12,Detroit Lions,Minnesota Vikings,10,12,2008,6,domingo,Regular Season,0-5,0,5,0,32,31,1,3-3,3,3,0,21,19,2,Minnesota Vikings,12
2008-10-12,Baltimore Ravens,Indianapolis Colts,3,31,2008,6,domingo,Regular Season,2-3,2,3,0,23,15,8,3-2,3,2,0,8,11,-3,Indianapolis Colts,4
2008-10-12,Miami Dolphins,Houston Texans,28,29,2008,6,domingo,Regular Season,2-3,2,3,0,24,23,1,1-4,1,4,0,26,28,-2,Houston Texans,5
2008-10-12,Jacksonville Jaguars,Denver Broncos,24,17,2008,6,domingo,Regular Season,3-3,3,3,0,14,17,-3,4-2,4,2,0,12,7,5,Jacksonville Jaguars,10
2008-10-12,Chicago Bears,Atlanta Falcons,20,22,2008,6,domingo,Regular Season,3-3,3,3,0,20,10,10,4-2,4,2,0,15,20,-5,Atlanta Falcons,10
2008-10-12,Dallas Cowboys,Arizona Cardinals,24,30,2008,6,domingo,Regular Season,4-2,4,2,0,6,4,2,4-2,4,2,0,9,14,-5,Arizona Cardinals,10
2008-10-06,Minnesota Vikings,New Orleans Saints,30,27,2008,5,segunda,Regular Season,2-3,2,3,0,19,21,-2,2-3,2,3,0,22,16,6,Minnesota Vikings,5
2008-10-05,New England Patriots,San Francisco 49ers,30,21,2008,5,domingo,Regular Season,3-1,3,1,0,9,13,-4,2-3,2,3,0,24,22,2,New England Patriots,9
2008-10-05,Washington Redskins,Philadelphia Eagles,23,17,2008,5,domingo,Regular Season,4-1,4,1,0,3,6,-3,2-3,2,3,0,12,9,3,Washington Redskins,3
2008-10-05,Seattle Seahawks,New York Giants,6,44,2008,5,domingo,Regular Season,1-3,1,3,0,26,23,3,4-0,4,0,0,1,1,0,New York Giants,22
2008-10-05,Los Angeles Chargers,Miami Dolphins,10,17,2008,5,domingo,Regular Season,2-3,2,3,0,16,8,8,2-2,2,2,0,23,26,-3,Miami Dolphins,18
2008-10-05,Pittsburgh Steelers,Jacksonville Jaguars,26,21,2008,5,domingo,Regular Season,4-1,4,1,0,5,5,0,2-3,2,3,0,17,12,5,Pittsburgh Steelers,7
2008-10-05,Indianapolis Colts,Houston Texans,31,27,2008,5,domingo,Regular Season,2-2,2,2,0,11,17,-6,0-4,0,4,0,28,27,1,Indianapolis Colts,10
2008-10-05,Atlanta Falcons,Green Bay Packers,27,24,2008,5,domingo,Regular Season,3-2,3,2,0,20,24,-4,2-3,2,3,0,21,15,6,Atlanta Falcons,9
2008-10-05,Chicago Bears,Detroit Lions,34,7,2008,5,domingo,Regular Season,3-2,3,2,0,10,18,-8,0-4,0,4,0,31,31,0,Chicago Bears,13
2008-10-05,Tampa Bay Buccaneers,Denver Broncos,13,16,2008,5,domingo,Regular Season,3-2,3,2,0,13,10,3,4-1,4,1,0,7,11,-4,Denver Broncos,1
2008-10-05,Cincinnati Bengals,Dallas Cowboys,22,31,2008,5,domingo,Regular Season,0-5,0,5,0,30,30,0,4-1,4,1,0,4,3,1,Dallas Cowboys,27
2008-10-05,Kansas City Chiefs,Carolina Panthers,0,34,2008,5,domingo,Regular Season,1-4,1,4,0,29,29,0,4-1,4,1,0,6,7,-1,Carolina Panthers,22
2008-10-05,Tennessee Titans,Baltimore Ravens,13,10,2008,5,domingo,Regular Season,5-0,5,0,0,2,2,0,2-2,2,2,0,15,14,1,Tennessee Titans,12
2008-10-05,Buffalo Bills,Arizona Cardinals,17,41,2008,5,domingo,Regular Season,4-1,4,1,0,8,4,4,3-2,3,2,0,14,20,-6,Arizona Cardinals,16
2008-09-29,Baltimore Ravens,Pittsburgh Steelers,23,20,2008,4,segunda,Regular Season,2-1,2,1,0,14,17,-3,3-1,3,1,0,5,5,0,Baltimore Ravens,12
2008-09-28,Minnesota Vikings,Tennessee Titans,17,30,2008,4,domingo,Regular Season,1-3,1,3,0,21,19,2,4-0,4,0,0,2,4,-2,Tennessee Titans,15
2008-09-28,Green Bay Packers,Tampa Bay Buccaneers,21,30,2008,4,domingo,Regular Season,2-2,2,2,0,15,8,7,3-1,3,1,0,10,13,-3,Tampa Bay Buccaneers,5
2008-09-28,Buffalo Bills,Los Angeles Rams,31,14,2008,4,domingo,Regular Season,4-0,4,0,0,4,6,-2,0-4,0,4,0,32,32,0,Buffalo Bills,26
2008-09-28,Los Angeles Chargers,Oakland Raiders,28,18,2008,4,domingo,Regular Season,2-2,2,2,0,8,9,-1,1-3,1,3,0,28,29,-1,Los Angeles Chargers,20
2008-09-28,Arizona Cardinals,New York Jets,35,56,2008,4,domingo,Regular Season,2-2,2,2,0,20,18,2,2-2,2,2,0,19,21,-2,New York Jets,3
2008-09-28,San Francisco 49ers,New Orleans Saints,17,31,2008,4,domingo,Regular Season,2-2,2,2,0,22,22,0,2-2,2,2,0,16,16,0,New Orleans Saints,6
2008-09-28,Denver Broncos,Kansas City Chiefs,19,33,2008,4,domingo,Regular Season,3-1,3,1,0,11,7,4,1-3,1,3,0,29,31,-2,Kansas City Chiefs,24
2008-09-28,Houston Texans,Jacksonville Jaguars,27,30,2008,4,domingo,Regular Season,0-3,0,3,0,27,27,0,2-2,2,2,0,12,14,-2,Jacksonville Jaguars,13
2008-09-28,Washington Redskins,Dallas Cowboys,26,24,2008,4,domingo,Regular Season,3-1,3,1,0,6,15,-9,3-1,3,1,0,3,1,2,Washington Redskins,14
2008-09-28,Cleveland Browns,Cincinnati Bengals,20,12,2008,4,domingo,Regular Season,1-3,1,3,0,25,26,-1,0-4,0,4,0,30,28,2,Cleveland Browns,2
2008-09-28,Philadelphia Eagles,Chicago Bears,20,24,2008,4,domingo,Regular Season,2-2,2,2,0,9,3,6,2-2,2,2,0,18,20,-2,Chicago Bears,17
2008-09-28,Atlanta Falcons,Carolina Panthers,9,24,2008,4,domingo,Regular Season,2-2,2,2,0,24,24,0,3-1,3,1,0,7,10,-3,Carolina Panthers,14
2008-09-22,New York Jets,Los Angeles Chargers,29,48,2008,3,segunda,Regular Season,1-2,1,2,0,21,16,5,1-2,1,2,0,9,13,-4,Los Angeles Chargers,3
2008-09-21,Arizona Cardinals,Washington Redskins,17,24,2008,3,domingo,Regular Season,2-1,2,1,0,18,14,4,2-1,2,1,0,15,19,-4,Washington Redskins,5
2008-09-21,Houston Texans,Tennessee Titans,12,31,2008,3,domingo,Regular Season,0-2,0,2,0,27,24,3,3-0,3,0,0,4,9,-5,Tennessee Titans,15
2008-09-21,Los Angeles Rams,Seattle Seahawks,13,37,2008,3,domingo,Regular Season,0-3,0,3,0,32,32,0,1-2,1,2,0,23,23,0,Seattle Seahawks,9
2008-09-21,Detroit Lions,San Francisco 49ers,13,31,2008,3,domingo,Regular Season,0-3,0,3,0,30,29,1,2-1,2,1,0,22,25,-3,San Francisco 49ers,4
2008-09-21,Pittsburgh Steelers,Philadelphia Eagles,6,15,2008,3,domingo,Regular Season,2-1,2,1,0,5,2,3,2-1,2,1,0,3,5,-2,Philadelphia Eagles,3
2008-09-21,Cincinnati Bengals,New York Giants,23,26,2008,3,domingo,Regular Season,0-3,0,3,0,28,28,0,3-0,3,0,0,2,3,-1,New York Giants,25
2008-09-21,Miami Dolphins,New England Patriots,38,13,2008,3,domingo,Regular Season,1-2,1,2,0,25,30,-5,2-1,2,1,0,11,6,5,Miami Dolphins,24
2008-09-21,Carolina Panthers,Minnesota Vikings,10,20,2008,3,domingo,Regular Season,2-1,2,1,0,10,8,2,1-2,1,2,0,19,21,-2,Minnesota Vikings,13
2008-09-21,Jacksonville Jaguars,Indianapolis Colts,23,21,2008,3,domingo,Regular Season,1-2,1,2,0,14,18,-4,1-2,1,2,0,12,7,5,Jacksonville Jaguars,11
2008-09-21,Dallas Cowboys,Green Bay Packers,27,16,2008,3,domingo,Regular Season,3-0,3,0,0,1,1,0,2-1,2,1,0,8,4,4,Dallas Cowboys,3
2008-09-21,New Orleans Saints,Denver Broncos,32,34,2008,3,domingo,Regular Season,1-2,1,2,0,16,12,4,3-0,3,0,0,7,11,-4,Denver Broncos,1
2008-09-21,Tampa Bay Buccaneers,Chicago Bears,27,24,2008,3,domingo,Regular Season,2-1,2,1,0,13,17,-4,1-2,1,2,0,20,15,5,Tampa Bay Buccaneers,2
2008-09-21,Oakland Raiders,Buffalo Bills,23,24,2008,3,domingo,Regular Season,1-2,1,2,0,29,27,2,3-0,3,0,0,6,10,-4,Buffalo Bills,17
2008-09-21,Cleveland Browns,Baltimore Ravens,10,28,2008,3,domingo,Regular Season,0-3,0,3,0,26,22,4,2-0,2,0,0,17,20,-3,Baltimore Ravens,2
2008-09-21,Kansas City Chiefs,Atlanta Falcons,14,38,2008,3,domingo,Regular Season,0-3,0,3,0,31,31,0,2-1,2,1,0,24,26,-2,Atlanta Falcons,5
2008-09-15,Philadelphia Eagles,Dallas Cowboys,37,41,2008,2,segunda,Regular Season,1-1,1,1,0,5,6,-1,2-0,2,0,0,1,1,0,Dallas Cowboys,5
2008-09-14,New Orleans Saints,Washington Redskins,24,29,2008,2,domingo,Regular Season,1-1,1,1,0,12,4,8,1-1,1,1,0,19,23,-4,Washington Redskins,19
2008-09-14,Atlanta Falcons,Tampa Bay Buccaneers,9,24,2008,2,domingo,Regular Season,1-1,1,1,0,26,25,1,1-1,1,1,0,17,20,-3,Tampa Bay Buccaneers,5
2008-09-14,New York Giants,Los Angeles Rams,41,13,2008,2,domingo,Regular Season,2-0,2,0,0,3,5,-2,0-2,0,2,0,32,32,0,New York Giants,27
2008-09-14,San Francisco 49ers,Seattle Seahawks,33,30,2008,2,domingo,Regular Season,1-1,1,1,0,25,27,-2,0-2,0,2,0,23,18,5,San Francisco 49ers,9
2008-09-14,New England Patriots,New York Jets,19,10,2008,2,domingo,Regular Season,2-0,2,0,0,6,9,-3,1-1,1,1,0,16,14,2,New England Patriots,5
2008-09-14,Indianapolis Colts,Minnesota Vikings,18,15,2008,2,domingo,Regular Season,1-1,1,1,0,7,8,-1,0-2,0,2,0,21,16,5,Indianapolis Colts,8
2008-09-14,Oakland Raiders,Kansas City Chiefs,23,8,2008,2,domingo,Regular Season,1-1,1,1,0,27,30,-3,0-2,0,2,0,31,29,2,Oakland Raiders,1
2008-09-14,Buffalo Bills,Jacksonville Jaguars,20,16,2008,2,domingo,Regular Season,2-0,2,0,0,10,13,-3,0-2,0,2,0,18,10,8,Buffalo Bills,3
2008-09-14,Green Bay Packers,Detroit Lions,48,25,2008,2,domingo,Regular Season,2-0,2,0,0,4,7,-3,0-2,0,2,0,29,31,-2,Green Bay Packers,24
2008-09-14,Los Angeles Chargers,Denver Broncos,38,39,2008,2,domingo,Regular Season,0-2,0,2,0,13,3,10,2-0,2,0,0,11,19,-8,Denver Broncos,16
2008-09-14,Pittsburgh Steelers,Cleveland Browns,10,6,2008,2,domingo,Regular Season,2-0,2,0,0,2,2,0,0-2,0,2,0,22,17,5,Pittsburgh Steelers,15
2008-09-14,Tennessee Titans,Cincinnati Bengals,24,7,2008,2,domingo,Regular Season,2-0,2,0,0,9,11,-2,0-2,0,2,0,28,26,2,Tennessee Titans,15
2008-09-14,Chicago Bears,Carolina Panthers,17,20,2008,2,domingo,Regular Season,1-1,1,1,0,15,15,0,2-0,2,0,0,8,12,-4,Carolina Panthers,3
2008-09-14,Miami Dolphins,Arizona Cardinals,10,31,2008,2,domingo,Regular Season,0-2,0,2,0,30,28,2,2-0,2,0,0,14,21,-7,Arizona Cardinals,7
2008-09-08,Denver Broncos,Oakland Raiders,41,14,2008,1,segunda,Regular Season,1-0,1,0,0,19,22,-3,0-1,0,1,0,30,27,3,Denver Broncos,5
2008-09-08,Minnesota Vikings,Green Bay Packers,19,24,2008,1,segunda,Regular Season,0-1,0,1,0,16,11,5,1-0,1,0,0,7,10,-3,Green Bay Packers,1
2008-09-07,Jacksonville Jaguars,Tennessee Titans,10,17,2008,1,domingo,Regular Season,0-1,0,1,0,10,5,5,1-0,1,0,0,11,14,-3,Tennessee Titans,9
2008-09-07,Arizona Cardinals,San Francisco 49ers,23,13,2008,1,domingo,Regular Season,1-0,1,0,0,21,21,0,0-1,0,1,0,27,29,-2,Arizona Cardinals,8
2008-09-07,Carolina Panthers,Los Angeles Chargers,26,24,2008,1,domingo,Regular Season,1-0,1,0,0,12,17,-5,0-1,0,1,0,3,2,1,Carolina Panthers,15
2008-09-07,Houston Texans,Pittsburgh Steelers,17,38,2008,1,domingo,Regular Season,0-1,0,1,0,24,20,4,1-0,1,0,0,2,6,-4,Pittsburgh Steelers,14
2008-09-07,Los Angeles Rams,Philadelphia Eagles,3,38,2008,1,domingo,Regular Season,0-1,0,1,0,32,28,4,1-0,1,0,0,6,12,-6,Philadelphia Eagles,16
2008-09-07,Tampa Bay Buccaneers,New Orleans Saints,20,24,2008,1,domingo,Regular Season,0-1,0,1,0,20,15,5,1-0,1,0,0,4,7,-3,New Orleans Saints,8
2008-09-07,Kansas City Chiefs,New England Patriots,10,17,2008,1,domingo,Regular Season,0-1,0,1,0,29,31,-2,1-0,1,0,0,9,1,8,New England Patriots,30
2008-09-07,New York Jets,Miami Dolphins,20,14,2008,1,domingo,Regular Season,1-0,1,0,0,14,16,-2,0-1,0,1,0,28,30,-2,New York Jets,14
2008-09-07,Chicago Bears,Indianapolis Colts,29,13,2008,1,domingo,Regular Season,1-0,1,0,0,15,25,-10,0-1,0,1,0,8,4,4,Chicago Bears,21
2008-09-07,Dallas Cowboys,Cleveland Browns,28,10,2008,1,domingo,Regular Season,1-0,1,0,0,1,3,-2,0-1,0,1,0,17,13,4,Dallas Cowboys,10
2008-09-07,Seattle Seahawks,Buffalo Bills,10,34,2008,1,domingo,Regular Season,0-1,0,1,0,18,9,9,1-0,1,0,0,13,18,-5,Buffalo Bills,9
2008-09-07,Cincinnati Bengals,Baltimore Ravens,10,17,2008,1,domingo,Regular Season,0-1,0,1,0,26,23,3,1-0,1,0,0,22,24,-2,Baltimore Ravens,1
2008-09-07,Detroit Lions,Atlanta Falcons,21,34,2008,1,domingo,Regular Season,0-1,0,1,0,31,26,5,1-0,1,0,0,25,32,-7,Atlanta Falcons,6
2008-09-04,Washington Redskins,New York Giants,7,16,2008,1,quinta,Regular Season,0-1,0,1,0,23,19,4,1-0,1,0,0,5,8,-3,New York Giants,11
2007-12-30,Dallas Cowboys,Washington Redskins,6,27,2007,17,domingo,Regular Season,13-3,13,3,0,3,3,0,9-7,9,7,0,10,13,-3,Washington Redskins,10
2007-12-30,Carolina Panthers,Tampa Bay Buccaneers,31,23,2007,17,domingo,Regular Season,7-9,7,9,0,23,24,-1,9-7,9,7,0,12,12,0,Carolina Panthers,12
2007-12-30,Buffalo Bills,Philadelphia Eagles,9,17,2007,17,domingo,Regular Season,7-9,7,9,0,19,16,3,8-8,8,8,0,14,15,-1,Philadelphia Eagles,1
2007-12-30,Los Angeles Chargers,Oakland Raiders,30,17,2007,17,domingo,Regular Season,11-5,11,5,0,6,6,0,4-12,4,12,0,27,27,0,Los Angeles Chargers,21
2007-12-30,Kansas City Chiefs,New York Jets,10,13,2007,17,domingo,Regular Season,4-12,4,12,0,28,28,0,4-12,4,12,0,30,30,0,New York Jets,2
2007-12-30,Cincinnati Bengals,Miami Dolphins,38,25,2007,17,domingo,Regular Season,7-9,7,9,0,22,23,-1,1-15,1,15,0,32,32,0,Cincinnati Bengals,9
2007-12-30,Tennessee Titans,Indianapolis Colts,16,10,2007,17,domingo,Regular Season,10-6,10,6,0,11,9,2,13-3,13,3,0,2,2,0,Tennessee Titans,7
2007-12-30,Jacksonville Jaguars,Houston Texans,28,42,2007,17,domingo,Regular Season,11-5,11,5,0,4,4,0,8-8,8,8,0,16,18,-2,Houston Texans,14
2007-12-30,Detroit Lions,Green Bay Packers,13,34,2007,17,domingo,Regular Season,7-9,7,9,0,24,21,3,13-3,13,3,0,5,5,0,Green Bay Packers,16
2007-12-30,Minnesota Vikings,Denver Broncos,19,22,2007,17,domingo,Regular Season,8-8,8,8,0,15,14,1,7-9,7,9,0,21,22,-1,Denver Broncos,8
2007-12-30,San Francisco 49ers,Cleveland Browns,7,20,2007,17,domingo,Regular Season,5-11,5,11,0,26,25,1,10-6,10,6,0,13,11,2,Cleveland Browns,14
2007-12-30,New Orleans Saints,Chicago Bears,25,33,2007,17,domingo,Regular Season,7-9,7,9,0,18,17,1,7-9,7,9,0,20,20,0,Chicago Bears,3
2007-12-30,Pittsburgh Steelers,Baltimore Ravens,21,27,2007,17,domingo,Regular Season,10-6,10,6,0,8,8,0,5-11,5,11,0,25,26,-1,Baltimore Ravens,18
2007-12-30,Seattle Seahawks,Atlanta Falcons,41,44,2007,17,domingo,Regular Season,10-6,10,6,0,7,7,0,4-12,4,12,0,31,31,0,Atlanta Falcons,24
2007-12-30,Los Angeles Rams,Arizona Cardinals,19,48,2007,17,domingo,Regular Season,3-13,3,13,0,29,29,0,8-8,8,8,0,17,19,-2,Arizona Cardinals,10
2007-12-29,New England Patriots,New York Giants,38,35,2007,17,sábado,Regular Season,16-0,16,0,0,1,1,0,10-6,10,6,0,9,10,-1,New England Patriots,9
2007-12-24,Denver Broncos,Los Angeles Chargers,3,23,2007,16,segunda,Regular Season,6-9,6,9,0,22,19,3,10-5,10,5,0,6,6,0,Los Angeles Chargers,13
2007-12-23,New York Jets,Tennessee Titans,6,10,2007,16,domingo,Regular Season,3-12,3,12,0,30,30,0,9-6,9,6,0,9,13,-4,Tennessee Titans,17
2007-12-23,Baltimore Ravens,Seattle Seahawks,6,27,2007,16,domingo,Regular Season,4-11,4,11,0,26,27,-1,10-5,10,5,0,7,10,-3,Seattle Seahawks,17
2007-12-23,Tampa Bay Buccaneers,San Francisco 49ers,19,21,2007,16,domingo,Regular Season,9-6,9,6,0,12,9,3,5-10,5,10,0,25,28,-3,San Francisco 49ers,19
2007-12-23,Philadelphia Eagles,New Orleans Saints,38,23,2007,16,domingo,Regular Season,7-8,7,8,0,15,18,-3,7-8,7,8,0,17,14,3,Philadelphia Eagles,4
2007-12-23,Miami Dolphins,New England Patriots,7,28,2007,16,domingo,Regular Season,1-14,1,14,0,32,32,0,15-0,15,0,0,1,1,0,New England Patriots,31
2007-12-23,Washington Redskins,Minnesota Vikings,32,21,2007,16,domingo,Regular Season,8-7,8,7,0,13,16,-3,8-7,8,7,0,14,11,3,Washington Redskins,5
2007-12-23,Oakland Raiders,Jacksonville Jaguars,11,49,2007,16,domingo,Regular Season,4-11,4,11,0,27,25,2,11-4,11,4,0,4,5,-1,Jacksonville Jaguars,20
2007-12-23,Houston Texans,Indianapolis Colts,15,38,2007,16,domingo,Regular Season,7-8,7,8,0,18,15,3,13-2,13,2,0,2,2,0,Indianapolis Colts,13
2007-12-23,Kansas City Chiefs,Detroit Lions,20,25,2007,16,domingo,Regular Season,4-11,4,11,0,28,26,2,7-8,7,8,0,21,22,-1,Detroit Lions,4
2007-12-23,Cleveland Browns,Cincinnati Bengals,14,19,2007,16,domingo,Regular Season,9-6,9,6,0,11,7,4,6-9,6,9,0,23,23,0,Cincinnati Bengals,16
2007-12-23,Green Bay Packers,Chicago Bears,7,35,2007,16,domingo,Regular Season,12-3,12,3,0,5,4,1,6-9,6,9,0,20,24,-4,Chicago Bears,20
2007-12-23,New York Giants,Buffalo Bills,38,21,2007,16,domingo,Regular Season,10-5,10,5,0,10,12,-2,7-8,7,8,0,16,17,-1,New York Giants,5
2007-12-23,Atlanta Falcons,Arizona Cardinals,27,30,2007,16,domingo,Regular Season,3-12,3,12,0,31,31,0,7-8,7,8,0,19,20,-1,Arizona Cardinals,11
2007-12-22,Dallas Cowboys,Carolina Panthers,20,13,2007,16,sábado,Regular Season,13-2,13,2,0,3,3,0,6-9,6,9,0,24,21,3,Dallas Cowboys,18
2007-12-20,Pittsburgh Steelers,Los Angeles Rams,41,24,2007,16,quinta,Regular Season,10-5,10,5,0,8,8,0,3-12,3,12,0,29,29,0,Pittsburgh Steelers,21
2007-12-17,Chicago Bears,Minnesota Vikings,13,20,2007,15,segunda,Regular Season,5-9,5,9,0,24,23,1,8-6,8,6,0,11,12,-1,Minnesota Vikings,11
2007-12-16,Atlanta Falcons,Tampa Bay Buccaneers,3,37,2007,15,domingo,Regular Season,3-11,3,11,0,31,30,1,9-5,9,5,0,9,11,-2,Tampa Bay Buccaneers,19
2007-12-16,Green Bay Packers,Los Angeles Rams,33,14,2007,15,domingo,Regular Season,12-2,12,2,0,4,4,0,3-11,3,11,0,29,28,1,Green Bay Packers,24
2007-12-16,Detroit Lions,Los Angeles Chargers,14,51,2007,15,domingo,Regular Season,6-8,6,8,0,22,20,2,9-5,9,5,0,6,7,-1,Los Angeles Chargers,13
2007-12-16,Jacksonville Jaguars,Pittsburgh Steelers,29,22,2007,15,domingo,Regular Season,10-4,10,4,0,5,5,0,9-5,9,5,0,8,8,0,Jacksonville Jaguars,3
2007-12-16,Indianapolis Colts,Oakland Raiders,21,14,2007,15,domingo,Regular Season,12-2,12,2,0,2,3,-1,4-10,4,10,0,25,26,-1,Indianapolis Colts,23
2007-12-16,Washington Redskins,New York Giants,22,10,2007,15,domingo,Regular Season,7-7,7,7,0,16,17,-1,9-5,9,5,0,12,9,3,Washington Redskins,8
2007-12-16,Arizona Cardinals,New Orleans Saints,24,31,2007,15,domingo,Regular Season,6-8,6,8,0,20,18,2,7-7,7,7,0,14,16,-2,New Orleans Saints,2
2007-12-16,New York Jets,New England Patriots,10,20,2007,15,domingo,Regular Season,3-11,3,11,0,30,29,1,14-0,14,0,0,1,1,0,New England Patriots,28
2007-12-16,Baltimore Ravens,Miami Dolphins,16,22,2007,15,domingo,Regular Season,4-10,4,10,0,27,25,2,1-13,1,13,0,32,32,0,Miami Dolphins,7
2007-12-16,Tennessee Titans,Kansas City Chiefs,26,17,2007,15,domingo,Regular Season,8-6,8,6,0,13,13,0,4-10,4,10,0,26,27,-1,Tennessee Titans,14
2007-12-16,Philadelphia Eagles,Dallas Cowboys,10,6,2007,15,domingo,Regular Season,6-8,6,8,0,18,21,-3,12-2,12,2,0,3,2,1,Philadelphia Eagles,19
2007-12-16,Buffalo Bills,Cleveland Browns,0,8,2007,15,domingo,Regular Season,7-7,7,7,0,17,14,3,9-5,9,5,0,7,10,-3,Cleveland Browns,4
2007-12-16,Seattle Seahawks,Carolina Panthers,10,13,2007,15,domingo,Regular Season,9-5,9,5,0,10,6,4,6-8,6,8,0,21,24,-3,Carolina Panthers,18
2007-12-15,Cincinnati Bengals,San Francisco 49ers,13,20,2007,15,sábado,Regular Season,5-9,5,9,0,23,22,1,4-10,4,10,0,28,31,-3,San Francisco 49ers,9
2007-12-13,Denver Broncos,Houston Texans,13,31,2007,15,quinta,Regular Season,6-8,6,8,0,19,15,4,7-7,7,7,0,15,19,-4,Houston Texans,4
2007-12-10,New Orleans Saints,Atlanta Falcons,34,14,2007,14,segunda,Regular Season,6-7,6,7,0,16,17,-1,3-10,3,10,0,30,31,-1,New Orleans Saints,14
2007-12-09,Los Angeles Chargers,Tennessee Titans,23,17,2007,14,domingo,Regular Season,8-5,8,5,0,7,9,-2,7-6,7,6,0,13,12,1,Los Angeles Chargers,3
2007-12-09,Arizona Cardinals,Seattle Seahawks,21,42,2007,14,domingo,Regular Season,6-7,6,7,0,18,14,4,9-4,9,4,0,6,7,-1,Seattle Seahawks,7
2007-12-09,Minnesota Vikings,San Francisco 49ers,27,7,2007,14,domingo,Regular Season,7-6,7,6,0,12,13,-1,3-10,3,10,0,31,30,1,Minnesota Vikings,17
2007-12-09,New York Giants,Philadelphia Eagles,16,13,2007,14,domingo,Regular Season,9-4,9,4,0,9,10,-1,5-8,5,8,0,21,19,2,New York Giants,9
2007-12-09,Cleveland Browns,New York Jets,24,18,2007,14,domingo,Regular Season,8-5,8,5,0,10,11,-1,3-10,3,10,0,29,29,0,Cleveland Browns,18
2007-12-09,Pittsburgh Steelers,New England Patriots,13,34,2007,14,domingo,Regular Season,9-4,9,4,0,8,5,3,13-0,13,0,0,1,1,0,New England Patriots,4
2007-12-09,Carolina Panthers,Jacksonville Jaguars,6,37,2007,14,domingo,Regular Season,5-8,5,8,0,24,23,1,9-4,9,4,0,5,6,-1,Jacksonville Jaguars,17
2007-12-09,Tampa Bay Buccaneers,Houston Texans,14,28,2007,14,domingo,Regular Season,8-5,8,5,0,11,8,3,6-7,6,7,0,19,22,-3,Houston Texans,14
2007-12-09,Oakland Raiders,Green Bay Packers,7,38,2007,14,domingo,Regular Season,4-9,4,9,0,26,26,0,11-2,11,2,0,4,4,0,Green Bay Packers,22
2007-12-09,Dallas Cowboys,Detroit Lions,28,27,2007,14,domingo,Regular Season,12-1,12,1,0,2,2,0,6-7,6,7,0,20,18,2,Dallas Cowboys,16
2007-12-09,Kansas City Chiefs,Denver Broncos,7,41,2007,14,domingo,Regular Season,4-9,4,9,0,27,27,0,6-7,6,7,0,15,20,-5,Denver Broncos,7
2007-12-09,Los Angeles Rams,Cincinnati Bengals,10,19,2007,14,domingo,Regular Season,3-10,3,10,0,28,28,0,5-8,5,8,0,22,25,-3,Cincinnati Bengals,3
2007-12-09,Miami Dolphins,Buffalo Bills,17,38,2007,14,domingo,Regular Season,0-13,0,13,0,32,32,0,7-6,7,6,0,14,15,-1,Buffalo Bills,17
2007-12-09,Indianapolis Colts,Baltimore Ravens,44,20,2007,14,domingo,Regular Season,11-2,11,2,0,3,3,0,4-9,4,9,0,25,24,1,Indianapolis Colts,21
2007-12-06,Chicago Bears,Washington Redskins,16,24,2007,14,quinta,Regular Season,5-8,5,8,0,23,16,7,6-7,6,7,0,17,21,-4,Washington Redskins,5
2007-12-03,New England Patriots,Baltimore Ravens,27,24,2007,13,segunda,Regular Season,12-0,12,0,0,1,1,0,4-8,4,8,0,24,25,-1,New England Patriots,24
2007-12-02,Buffalo Bills,Washington Redskins,17,16,2007,13,domingo,Regular Season,6-6,6,6,0,15,22,-7,5-7,5,7,0,21,20,1,Buffalo Bills,2
2007-12-02,Houston Texans,Tennessee Titans,20,28,2007,13,domingo,Regular Season,5-7,5,7,0,22,21,1,7-5,7,5,0,12,12,0,Tennessee Titans,9
2007-12-02,Atlanta Falcons,Los Angeles Rams,16,28,2007,13,domingo,Regular Season,3-9,3,9,0,31,30,1,3-9,3,9,0,28,29,-1,Los Angeles Rams,1
2007-12-02,Cincinnati Bengals,Pittsburgh Steelers,10,24,2007,13,domingo,Regular Season,4-8,4,8,0,25,23,2,9-3,9,3,0,5,6,-1,Pittsburgh Steelers,17
2007-12-02,Seattle Seahawks,Philadelphia Eagles,28,24,2007,13,domingo,Regular Season,8-4,8,4,0,7,8,-1,5-7,5,7,0,19,15,4,Seattle Seahawks,7
2007-12-02,Denver Broncos,Oakland Raiders,20,34,2007,13,domingo,Regular Season,5-7,5,7,0,20,17,3,4-8,4,8,0,26,27,-1,Oakland Raiders,10
2007-12-02,Tampa Bay Buccaneers,New Orleans Saints,27,23,2007,13,domingo,Regular Season,8-4,8,4,0,8,9,-1,5-7,5,7,0,17,13,4,Tampa Bay Buccaneers,4
2007-12-02,Detroit Lions,Minnesota Vikings,10,42,2007,13,domingo,Regular Season,6-6,6,6,0,18,14,4,6-6,6,6,0,13,18,-5,Minnesota Vikings,4
2007-12-02,New York Jets,Miami Dolphins,40,13,2007,13,domingo,Regular Season,3-9,3,9,0,29,31,-2,0-12,0,12,0,32,32,0,New York Jets,1
2007-12-02,Los Angeles Chargers,Kansas City Chiefs,24,10,2007,13,domingo,Regular Season,7-5,7,5,0,9,10,-1,4-8,4,8,0,27,24,3,Los Angeles Chargers,14
2007-12-02,Jacksonville Jaguars,Indianapolis Colts,25,28,2007,13,domingo,Regular Season,8-4,8,4,0,6,5,1,10-2,10,2,0,3,4,-1,Indianapolis Colts,1
2007-12-02,New York Giants,Chicago Bears,21,16,2007,13,domingo,Regular Season,8-4,8,4,0,10,11,-1,5-7,5,7,0,16,16,0,New York Giants,5
2007-12-02,San Francisco 49ers,Carolina Panthers,14,31,2007,13,domingo,Regular Season,3-9,3,9,0,30,28,2,5-7,5,7,0,23,26,-3,Carolina Panthers,2
2007-12-02,Cleveland Browns,Arizona Cardinals,21,27,2007,13,domingo,Regular Season,7-5,7,5,0,11,7,4,6-6,6,6,0,14,19,-5,Arizona Cardinals,12
2007-11-29,Green Bay Packers,Dallas Cowboys,27,37,2007,13,quinta,Regular Season,10-2,10,2,0,4,3,1,11-1,11,1,0,2,2,0,Dallas Cowboys,1
2007-11-26,Miami Dolphins,Pittsburgh Steelers,0,3,2007,12,segunda,Regular Season,0-11,0,11,0,32,32,0,8-3,8,3,0,6,7,-1,Pittsburgh Steelers,25
2007-11-25,Washington Redskins,Tampa Bay Buccaneers,13,19,2007,12,domingo,Regular Season,5-6,5,6,0,20,18,2,7-4,7,4,0,9,10,-1,Tampa Bay Buccaneers,8
2007-11-25,Seattle Seahawks,Los Angeles Rams,24,19,2007,12,domingo,Regular Season,7-4,7,4,0,8,9,-1,2-9,2,9,0,29,28,1,Seattle Seahawks,19
2007-11-25,Baltimore Ravens,Los Angeles Chargers,14,32,2007,12,domingo,Regular Season,4-7,4,7,0,25,24,1,6-5,6,5,0,10,13,-3,Los Angeles Chargers,11
2007-11-25,Minnesota Vikings,New York Giants,41,17,2007,12,domingo,Regular Season,5-6,5,6,0,18,23,-5,7-4,7,4,0,11,6,5,Minnesota Vikings,17
2007-11-25,Philadelphia Eagles,New England Patriots,28,31,2007,12,domingo,Regular Season,5-6,5,6,0,15,15,0,11-0,11,0,0,1,1,0,New England Patriots,14
2007-11-25,Oakland Raiders,Kansas City Chiefs,20,17,2007,12,domingo,Regular Season,3-8,3,8,0,27,30,-3,4-7,4,7,0,24,21,3,Oakland Raiders,9
2007-11-25,Buffalo Bills,Jacksonville Jaguars,14,36,2007,12,domingo,Regular Season,5-6,5,6,0,22,19,3,8-3,8,3,0,5,5,0,Jacksonville Jaguars,14
2007-11-25,Houston Texans,Cleveland Browns,17,27,2007,12,domingo,Regular Season,5-6,5,6,0,21,17,4,7-4,7,4,0,7,8,-1,Cleveland Browns,9
2007-11-25,Tennessee Titans,Cincinnati Bengals,6,35,2007,12,domingo,Regular Season,6-5,6,5,0,12,11,1,4-7,4,7,0,23,26,-3,Cincinnati Bengals,15
2007-11-25,Denver Broncos,Chicago Bears,34,37,2007,12,domingo,Regular Season,5-6,5,6,0,17,14,3,5-6,5,6,0,16,22,-6,Chicago Bears,8
2007-11-25,New Orleans Saints,Carolina Panthers,31,6,2007,12,domingo,Regular Season,5-6,5,6,0,13,20,-7,4-7,4,7,0,26,25,1,New Orleans Saints,5
2007-11-25,San Francisco 49ers,Arizona Cardinals,37,31,2007,12,domingo,Regular Season,3-8,3,8,0,28,31,-3,5-6,5,6,0,19,16,3,San Francisco 49ers,15
2007-11-22,Green Bay Packers,Detroit Lions,37,26,2007,12,quinta,Regular Season,10-1,10,1,0,3,3,0,6-5,6,5,0,14,12,2,Green Bay Packers,9
2007-11-22,New York Jets,Dallas Cowboys,3,34,2007,12,quinta,Regular Season,2-9,2,9,0,31,29,2,10-1,10,1,0,2,2,0,Dallas Cowboys,27
2007-11-22,Indianapolis Colts,Atlanta Falcons,31,13,2007,12,quinta,Regular Season,9-2,9,2,0,4,4,0,3-8,3,8,0,30,27,3,Indianapolis Colts,23
2007-11-19,Tennessee Titans,Denver Broncos,20,34,2007,11,segunda,Regular Season,6-4,6,4,0,11,8,3,5-5,5,5,0,14,18,-4,Denver Broncos,10
2007-11-18,Chicago Bears,Seattle Seahawks,23,30,2007,11,domingo,Regular Season,4-6,4,6,0,22,21,1,6-4,6,4,0,9,13,-4,Seattle Seahawks,8
2007-11-18,Los Angeles Rams,San Francisco 49ers,13,9,2007,11,domingo,Regular Season,2-8,2,8,0,28,30,-2,2-8,2,8,0,31,28,3,Los Angeles Rams,2
2007-11-18,Miami Dolphins,Philadelphia Eagles,7,17,2007,11,domingo,Regular Season,0-10,0,10,0,32,32,0,5-5,5,5,0,15,17,-2,Philadelphia Eagles,15
2007-11-18,Pittsburgh Steelers,New York Jets,16,19,2007,11,domingo,Regular Season,7-3,7,3,0,7,5,2,2-8,2,8,0,29,31,-2,New York Jets,26
2007-11-18,Oakland Raiders,Minnesota Vikings,22,29,2007,11,domingo,Regular Season,2-8,2,8,0,30,29,1,4-6,4,6,0,23,27,-4,Minnesota Vikings,2
2007-11-18,Los Angeles Chargers,Jacksonville Jaguars,17,24,2007,11,domingo,Regular Season,5-5,5,5,0,13,9,4,7-3,7,3,0,5,6,-1,Jacksonville Jaguars,3
2007-11-18,Kansas City Chiefs,Indianapolis Colts,10,13,2007,11,domingo,Regular Season,4-6,4,6,0,21,20,1,8-2,8,2,0,4,3,1,Indianapolis Colts,17
2007-11-18,New Orleans Saints,Houston Texans,10,23,2007,11,domingo,Regular Season,4-6,4,6,0,20,16,4,5-5,5,5,0,17,22,-5,Houston Texans,6
2007-11-18,Carolina Panthers,Green Bay Packers,17,31,2007,11,domingo,Regular Season,4-6,4,6,0,25,23,2,9-1,9,1,0,3,4,-1,Green Bay Packers,19
2007-11-18,New York Giants,Detroit Lions,16,10,2007,11,domingo,Regular Season,7-3,7,3,0,6,7,-1,6-4,6,4,0,12,10,2,New York Giants,3
2007-11-18,Washington Redskins,Dallas Cowboys,23,28,2007,11,domingo,Regular Season,5-5,5,5,0,18,14,4,9-1,9,1,0,2,2,0,Dallas Cowboys,12
2007-11-18,Arizona Cardinals,Cincinnati Bengals,35,27,2007,11,domingo,Regular Season,5-5,5,5,0,16,19,-3,3-7,3,7,0,26,25,1,Arizona Cardinals,6
2007-11-18,New England Patriots,Buffalo Bills,56,10,2007,11,domingo,Regular Season,10-0,10,0,0,1,1,0,5-5,5,5,0,19,15,4,New England Patriots,14
2007-11-18,Cleveland Browns,Baltimore Ravens,33,30,2007,11,domingo,Regular Season,6-4,6,4,0,8,11,-3,4-6,4,6,0,24,24,0,Cleveland Browns,13
2007-11-18,Tampa Bay Buccaneers,Atlanta Falcons,31,7,2007,11,domingo,Regular Season,6-4,6,4,0,10,12,-2,3-7,3,7,0,27,26,1,Tampa Bay Buccaneers,14
2007-11-12,San Francisco 49ers,Seattle Seahawks,0,24,2007,10,segunda,Regular Season,2-7,2,7,0,28,29,-1,5-4,5,4,0,13,16,-3,Seattle Seahawks,13
2007-11-11,Philadelphia Eagles,Washington Redskins,33,25,2007,10,domingo,Regular Season,4-5,4,5,0,17,22,-5,5-4,5,4,0,14,12,2,Philadelphia Eagles,10
2007-11-11,Jacksonville Jaguars,Tennessee Titans,28,13,2007,10,domingo,Regular Season,6-3,6,3,0,6,10,-4,6-3,6,3,0,8,7,1,Jacksonville Jaguars,3
2007-11-11,Indianapolis Colts,Los Angeles Chargers,21,23,2007,10,domingo,Regular Season,7-2,7,2,0,3,2,1,5-4,5,4,0,9,14,-5,Los Angeles Chargers,12
2007-11-11,Cleveland Browns,Pittsburgh Steelers,28,31,2007,10,domingo,Regular Season,5-4,5,4,0,11,9,2,7-2,7,2,0,5,4,1,Pittsburgh Steelers,5
2007-11-11,Chicago Bears,Oakland Raiders,17,6,2007,10,domingo,Regular Season,4-5,4,5,0,21,24,-3,2-7,2,7,0,29,27,2,Chicago Bears,3
2007-11-11,Dallas Cowboys,New York Giants,31,20,2007,10,domingo,Regular Season,8-1,8,1,0,2,3,-1,6-3,6,3,0,7,6,1,Dallas Cowboys,3
2007-11-11,Los Angeles Rams,New Orleans Saints,37,29,2007,10,domingo,Regular Season,1-8,1,8,0,30,31,-1,4-5,4,5,0,16,11,5,Los Angeles Rams,20
2007-11-11,Buffalo Bills,Miami Dolphins,13,10,2007,10,domingo,Regular Season,5-4,5,4,0,15,18,-3,0-9,0,9,0,32,32,0,Buffalo Bills,14
2007-11-11,Denver Broncos,Kansas City Chiefs,27,11,2007,10,domingo,Regular Season,4-5,4,5,0,18,25,-7,4-5,4,5,0,20,15,5,Denver Broncos,10
2007-11-11,Minnesota Vikings,Green Bay Packers,0,34,2007,10,domingo,Regular Season,3-6,3,6,0,27,23,4,8-1,8,1,0,4,5,-1,Green Bay Packers,18
2007-11-11,Atlanta Falcons,Carolina Panthers,20,13,2007,10,domingo,Regular Season,3-6,3,6,0,26,28,-2,4-5,4,5,0,23,19,4,Atlanta Falcons,9
2007-11-11,Cincinnati Bengals,Baltimore Ravens,21,7,2007,10,domingo,Regular Season,3-6,3,6,0,25,26,-1,4-5,4,5,0,24,17,7,Cincinnati Bengals,9
2007-11-11,Detroit Lions,Arizona Cardinals,21,31,2007,10,domingo,Regular Season,6-3,6,3,0,10,8,2,4-5,4,5,0,19,21,-2,Arizona Cardinals,13
2007-11-05,Baltimore Ravens,Pittsburgh Steelers,7,38,2007,9,segunda,Regular Season,4-4,4,4,0,17,14,3,6-2,6,2,0,4,6,-2,Pittsburgh Steelers,8
2007-11-04,Carolina Panthers,Tennessee Titans,7,20,2007,9,domingo,Regular Season,4-4,4,4,0,19,18,1,6-2,6,2,0,7,9,-2,Tennessee Titans,9
2007-11-04,Arizona Cardinals,Tampa Bay Buccaneers,10,17,2007,9,domingo,Regular Season,3-5,3,5,0,21,21,0,5-4,5,4,0,13,17,-4,Tampa Bay Buccaneers,4
2007-11-04,Dallas Cowboys,Philadelphia Eagles,38,17,2007,9,domingo,Regular Season,7-1,7,1,0,3,3,0,3-5,3,5,0,22,20,2,Dallas Cowboys,17
2007-11-04,Houston Texans,Oakland Raiders,24,17,2007,9,domingo,Regular Season,4-5,4,5,0,20,24,-4,2-6,2,6,0,27,27,0,Houston Texans,3
2007-11-04,Washington Redskins,New York Jets,23,20,2007,9,domingo,Regular Season,5-3,5,3,0,12,15,-3,1-8,1,8,0,30,30,0,Washington Redskins,15
2007-11-04,Jacksonville Jaguars,New Orleans Saints,24,41,2007,9,domingo,Regular Season,5-3,5,3,0,10,8,2,4-4,4,4,0,11,19,-8,New Orleans Saints,11
2007-11-04,Los Angeles Chargers,Minnesota Vikings,17,35,2007,9,domingo,Regular Season,4-4,4,4,0,14,7,7,3-5,3,5,0,23,26,-3,Minnesota Vikings,19
2007-11-04,Green Bay Packers,Kansas City Chiefs,33,22,2007,9,domingo,Regular Season,7-1,7,1,0,5,4,1,4-4,4,4,0,15,11,4,Green Bay Packers,7
2007-11-04,New England Patriots,Indianapolis Colts,24,20,2007,9,domingo,Regular Season,9-0,9,0,0,1,1,0,7-1,7,1,0,2,2,0,New England Patriots,1
2007-11-04,Denver Broncos,Detroit Lions,7,44,2007,9,domingo,Regular Season,3-5,3,5,0,25,16,9,6-2,6,2,0,8,10,-2,Detroit Lions,6
2007-11-04,Seattle Seahawks,Cleveland Browns,30,33,2007,9,domingo,Regular Season,4-4,4,4,0,16,12,4,5-3,5,3,0,9,13,-4,Cleveland Browns,1
2007-11-04,Cincinnati Bengals,Buffalo Bills,21,33,2007,9,domingo,Regular Season,2-6,2,6,0,26,25,1,4-4,4,4,0,18,22,-4,Buffalo Bills,3
2007-11-04,San Francisco 49ers,Atlanta Falcons,16,20,2007,9,domingo,Regular Season,2-6,2,6,0,29,28,1,2-6,2,6,0,28,29,-1,Atlanta Falcons,1
2007-10-29,Green Bay Packers,Denver Broncos,19,13,2007,8,segunda,Regular Season,6-1,6,1,0,4,5,-1,3-4,3,4,0,16,17,-1,Green Bay Packers,12
2007-10-28,Oakland Raiders,Tennessee Titans,9,13,2007,8,domingo,Regular Season,2-5,2,5,0,27,27,0,5-2,5,2,0,9,8,1,Tennessee Titans,19
2007-10-28,Jacksonville Jaguars,Tampa Bay Buccaneers,24,23,2007,8,domingo,Regular Season,5-2,5,2,0,8,7,1,4-4,4,4,0,17,16,1,Jacksonville Jaguars,9
2007-10-28,Cleveland Browns,Los Angeles Rams,27,20,2007,8,domingo,Regular Season,4-3,4,3,0,13,19,-6,0-8,0,8,0,31,31,0,Cleveland Browns,12
2007-10-28,New Orleans Saints,San Francisco 49ers,31,10,2007,8,domingo,Regular Season,3-4,3,4,0,19,24,-5,2-5,2,5,0,28,28,0,New Orleans Saints,4
2007-10-28,Houston Texans,Los Angeles Chargers,10,35,2007,8,domingo,Regular Season,3-5,3,5,0,24,21,3,4-3,4,3,0,7,9,-2,Los Angeles Chargers,12
2007-10-28,Buffalo Bills,New York Jets,13,3,2007,8,domingo,Regular Season,3-4,3,4,0,22,25,-3,1-7,1,7,0,30,30,0,Buffalo Bills,5
2007-10-28,Washington Redskins,New England Patriots,7,52,2007,8,domingo,Regular Season,4-3,4,3,0,15,10,5,8-0,8,0,0,1,1,0,New England Patriots,9
2007-10-28,Philadelphia Eagles,Minnesota Vikings,23,16,2007,8,domingo,Regular Season,3-4,3,4,0,20,22,-2,2-5,2,5,0,26,26,0,Philadelphia Eagles,4
2007-10-28,New York Giants,Miami Dolphins,13,10,2007,8,domingo,Regular Season,6-2,6,2,0,5,4,1,0-8,0,8,0,32,32,0,New York Giants,28
2007-10-28,Pittsburgh Steelers,Cincinnati Bengals,24,13,2007,8,domingo,Regular Season,5-2,5,2,0,6,6,0,2-5,2,5,0,25,23,2,Pittsburgh Steelers,17
2007-10-28,Detroit Lions,Chicago Bears,16,7,2007,8,domingo,Regular Season,5-2,5,2,0,10,11,-1,3-5,3,5,0,23,18,5,Detroit Lions,7
2007-10-28,Indianapolis Colts,Carolina Panthers,31,7,2007,8,domingo,Regular Season,7-0,7,0,0,2,2,0,4-3,4,3,0,18,12,6,Indianapolis Colts,10
2007-10-22,Indianapolis Colts,Jacksonville Jaguars,29,7,2007,7,segunda,Regular Season,6-0,6,0,0,2,2,0,4-2,4,2,0,7,5,2,Indianapolis Colts,3
2007-10-21,Arizona Cardinals,Washington Redskins,19,21,2007,7,domingo,Regular Season,3-4,3,4,0,20,18,2,4-2,4,2,0,10,11,-1,Washington Redskins,7
2007-10-21,Los Angeles Rams,Seattle Seahawks,6,33,2007,7,domingo,Regular Season,0-7,0,7,0,31,31,0,4-3,4,3,0,15,14,1,Seattle Seahawks,17
2007-10-21,Chicago Bears,Philadelphia Eagles,19,16,2007,7,domingo,Regular Season,3-4,3,4,0,18,23,-5,2-4,2,4,0,22,17,5,Chicago Bears,6
2007-10-21,Kansas City Chiefs,Oakland Raiders,12,10,2007,7,domingo,Regular Season,4-3,4,3,0,13,16,-3,2-4,2,4,0,27,25,2,Kansas City Chiefs,9
2007-10-21,San Francisco 49ers,New York Giants,15,33,2007,7,domingo,Regular Season,2-4,2,4,0,28,24,4,5-2,5,2,0,4,9,-5,New York Giants,15
2007-10-21,Atlanta Falcons,New Orleans Saints,16,22,2007,7,domingo,Regular Season,1-6,1,6,0,29,29,0,2-4,2,4,0,24,26,-2,New Orleans Saints,3
2007-10-21,New England Patriots,Miami Dolphins,49,28,2007,7,domingo,Regular Season,7-0,7,0,0,1,1,0,0-7,0,7,0,32,32,0,New England Patriots,31
2007-10-21,Tennessee Titans,Houston Texans,38,36,2007,7,domingo,Regular Season,4-2,4,2,0,8,12,-4,3-4,3,4,0,21,20,1,Tennessee Titans,8
2007-10-21,Tampa Bay Buccaneers,Detroit Lions,16,23,2007,7,domingo,Regular Season,4-3,4,3,0,16,8,8,4-2,4,2,0,11,15,-4,Detroit Lions,7
2007-10-21,Pittsburgh Steelers,Denver Broncos,28,31,2007,7,domingo,Regular Season,4-2,4,2,0,6,3,3,3-3,3,3,0,17,21,-4,Denver Broncos,18
2007-10-21,Minnesota Vikings,Dallas Cowboys,14,24,2007,7,domingo,Regular Season,2-4,2,4,0,26,22,4,6-1,6,1,0,3,4,-1,Dallas Cowboys,18
2007-10-21,New York Jets,Cincinnati Bengals,31,38,2007,7,domingo,Regular Season,1-6,1,6,0,30,30,0,2-4,2,4,0,23,27,-4,Cincinnati Bengals,3
2007-10-21,Baltimore Ravens,Buffalo Bills,14,19,2007,7,domingo,Regular Season,4-3,4,3,0,14,7,7,2-4,2,4,0,25,28,-3,Buffalo Bills,21
2007-10-15,New York Giants,Atlanta Falcons,31,10,2007,6,segunda,Regular Season,4-2,4,2,0,9,14,-5,1-5,1,5,0,29,29,0,New York Giants,15
2007-10-14,Tennessee Titans,Tampa Bay Buccaneers,10,13,2007,6,domingo,Regular Season,3-2,3,2,0,12,7,5,4-2,4,2,0,8,11,-3,Tampa Bay Buccaneers,4
2007-10-14,New Orleans Saints,Seattle Seahawks,28,17,2007,6,domingo,Regular Season,1-4,1,4,0,26,30,-4,3-3,3,3,0,14,10,4,New Orleans Saints,20
2007-10-14,Oakland Raiders,Los Angeles Chargers,14,28,2007,6,domingo,Regular Season,2-3,2,3,0,25,20,5,3-3,3,3,0,10,12,-2,Los Angeles Chargers,8
2007-10-14,Philadelphia Eagles,New York Jets,16,9,2007,6,domingo,Regular Season,2-3,2,3,0,17,22,-5,1-5,1,5,0,30,28,2,Philadelphia Eagles,6
2007-10-14,Cincinnati Bengals,Kansas City Chiefs,20,27,2007,6,domingo,Regular Season,1-4,1,4,0,27,23,4,3-3,3,3,0,16,25,-9,Kansas City Chiefs,2
2007-10-14,Houston Texans,Jacksonville Jaguars,17,37,2007,6,domingo,Regular Season,3-3,3,3,0,20,16,4,4-1,4,1,0,5,6,-1,Jacksonville Jaguars,10
2007-10-14,Washington Redskins,Green Bay Packers,14,17,2007,6,domingo,Regular Season,3-2,3,2,0,11,8,3,5-1,5,1,0,6,5,1,Green Bay Packers,3
2007-10-14,New England Patriots,Dallas Cowboys,48,27,2007,6,domingo,Regular Season,6-0,6,0,0,1,1,0,5-1,5,1,0,4,3,1,New England Patriots,2
2007-10-14,Miami Dolphins,Cleveland Browns,31,41,2007,6,domingo,Regular Season,0-6,0,6,0,32,32,0,3-3,3,3,0,19,24,-5,Cleveland Browns,8
2007-10-14,Minnesota Vikings,Chicago Bears,34,31,2007,6,domingo,Regular Season,2-3,2,3,0,22,27,-5,2-4,2,4,0,23,15,8,Minnesota Vikings,12
2007-10-14,Los Angeles Rams,Baltimore Ravens,3,22,2007,6,domingo,Regular Season,0-6,0,6,0,31,31,0,4-2,4,2,0,7,9,-2,Baltimore Ravens,22
2007-10-14,Carolina Panthers,Arizona Cardinals,25,10,2007,6,domingo,Regular Season,4-2,4,2,0,13,17,-4,3-3,3,3,0,18,13,5,Carolina Panthers,4
2007-10-08,Dallas Cowboys,Buffalo Bills,25,24,2007,5,segunda,Regular Season,5-0,5,0,0,3,3,0,1-4,1,4,0,26,30,-4,Dallas Cowboys,27
2007-10-07,Detroit Lions,Washington Redskins,3,34,2007,5,domingo,Regular Season,3-2,3,2,0,18,12,6,3-1,3,1,0,8,13,-5,Washington Redskins,1
2007-10-07,Atlanta Falcons,Tennessee Titans,13,20,2007,5,domingo,Regular Season,1-4,1,4,0,29,28,1,3-1,3,1,0,7,7,0,Tennessee Titans,21
2007-10-07,Arizona Cardinals,Los Angeles Rams,34,31,2007,5,domingo,Regular Season,3-2,3,2,0,13,15,-2,0-5,0,5,0,31,32,-1,Arizona Cardinals,17
2007-10-07,Baltimore Ravens,San Francisco 49ers,9,7,2007,5,domingo,Regular Season,3-2,3,2,0,9,11,-2,2-3,2,3,0,21,19,2,Baltimore Ravens,8
2007-10-07,Seattle Seahawks,Pittsburgh Steelers,0,21,2007,5,domingo,Regular Season,3-2,3,2,0,10,5,5,4-1,4,1,0,4,6,-2,Pittsburgh Steelers,1
2007-10-07,New York Jets,New York Giants,24,35,2007,5,domingo,Regular Season,1-4,1,4,0,28,26,2,3-2,3,2,0,14,18,-4,New York Giants,8
2007-10-07,Carolina Panthers,New Orleans Saints,16,13,2007,5,domingo,Regular Season,3-2,3,2,0,17,14,3,0-4,0,4,0,30,29,1,Carolina Panthers,15
2007-10-07,Cleveland Browns,New England Patriots,17,34,2007,5,domingo,Regular Season,2-3,2,3,0,24,25,-1,5-0,5,0,0,1,1,0,New England Patriots,24
2007-10-07,Jacksonville Jaguars,Kansas City Chiefs,17,7,2007,5,domingo,Regular Season,3-1,3,1,0,6,8,-2,2-3,2,3,0,25,21,4,Jacksonville Jaguars,13
2007-10-07,Tampa Bay Buccaneers,Indianapolis Colts,14,33,2007,5,domingo,Regular Season,3-2,3,2,0,11,9,2,5-0,5,0,0,2,2,0,Indianapolis Colts,7
2007-10-07,Miami Dolphins,Houston Texans,19,22,2007,5,domingo,Regular Season,0-5,0,5,0,32,31,1,3-2,3,2,0,16,17,-1,Houston Texans,14
2007-10-07,Chicago Bears,Green Bay Packers,27,20,2007,5,domingo,Regular Season,2-3,2,3,0,15,20,-5,4-1,4,1,0,5,4,1,Chicago Bears,16
2007-10-07,Los Angeles Chargers,Denver Broncos,41,3,2007,5,domingo,Regular Season,2-3,2,3,0,12,16,-4,2-3,2,3,0,19,10,9,Los Angeles Chargers,6
2007-10-01,New England Patriots,Cincinnati Bengals,34,13,2007,4,segunda,Regular Season,4-0,4,0,0,1,1,0,1-3,1,3,0,23,18,5,New England Patriots,17
2007-09-30,Seattle Seahawks,San Francisco 49ers,23,3,2007,4,domingo,Regular Season,3-1,3,1,0,5,7,-2,2-2,2,2,0,19,15,4,Seattle Seahawks,8
2007-09-30,Kansas City Chiefs,Los Angeles Chargers,30,16,2007,4,domingo,Regular Season,2-2,2,2,0,21,28,-7,1-3,1,3,0,16,9,7,Kansas City Chiefs,19
2007-09-30,Philadelphia Eagles,New York Giants,3,16,2007,4,domingo,Regular Season,1-3,1,3,0,22,16,6,2-2,2,2,0,18,23,-5,New York Giants,7
2007-09-30,Green Bay Packers,Minnesota Vikings,23,16,2007,4,domingo,Regular Season,4-0,4,0,0,4,6,-2,1-3,1,3,0,27,25,2,Green Bay Packers,19
2007-09-30,Oakland Raiders,Miami Dolphins,35,17,2007,4,domingo,Regular Season,2-2,2,2,0,24,24,0,0-4,0,4,0,31,31,0,Oakland Raiders,7
2007-09-30,Denver Broncos,Indianapolis Colts,20,38,2007,4,domingo,Regular Season,2-2,2,2,0,10,8,2,4-0,4,0,0,2,2,0,Indianapolis Colts,6
2007-09-30,Chicago Bears,Detroit Lions,27,37,2007,4,domingo,Regular Season,1-3,1,3,0,20,13,7,3-1,3,1,0,12,20,-8,Detroit Lions,7
2007-09-30,Los Angeles Rams,Dallas Cowboys,7,35,2007,4,domingo,Regular Season,0-4,0,4,0,32,30,2,4-0,4,0,0,3,3,0,Dallas Cowboys,27
2007-09-30,Baltimore Ravens,Cleveland Browns,13,27,2007,4,domingo,Regular Season,2-2,2,2,0,11,5,6,2-2,2,2,0,25,27,-2,Cleveland Browns,22
2007-09-30,Tampa Bay Buccaneers,Carolina Panthers,20,7,2007,4,domingo,Regular Season,3-1,3,1,0,9,19,-10,2-2,2,2,0,14,12,2,Tampa Bay Buccaneers,7
2007-09-30,New York Jets,Buffalo Bills,14,17,2007,4,domingo,Regular Season,1-3,1,3,0,26,21,5,1-3,1,3,0,30,29,1,Buffalo Bills,8
2007-09-30,Houston Texans,Atlanta Falcons,16,26,2007,4,domingo,Regular Season,2-2,2,2,0,17,17,0,1-3,1,3,0,28,32,-4,Atlanta Falcons,15
2007-09-30,Pittsburgh Steelers,Arizona Cardinals,14,21,2007,4,domingo,Regular Season,3-1,3,1,0,6,4,2,2-2,2,2,0,15,22,-7,Arizona Cardinals,18
2007-09-24,Tennessee Titans,New Orleans Saints,31,14,2007,3,segunda,Regular Season,2-1,2,1,0,11,15,-4,0-3,0,3,0,26,19,7,Tennessee Titans,4
2007-09-23,New York Giants,Washington Redskins,24,17,2007,3,domingo,Regular Season,1-2,1,2,0,23,27,-4,2-1,2,1,0,14,14,0,New York Giants,13
2007-09-23,Los Angeles Rams,Tampa Bay Buccaneers,3,24,2007,3,domingo,Regular Season,0-3,0,3,0,30,25,5,2-1,2,1,0,19,23,-4,Tampa Bay Buccaneers,2
2007-09-23,Cincinnati Bengals,Seattle Seahawks,21,24,2007,3,domingo,Regular Season,1-2,1,2,0,18,13,5,2-1,2,1,0,7,9,-2,Seattle Seahawks,4
2007-09-23,San Francisco 49ers,Pittsburgh Steelers,16,37,2007,3,domingo,Regular Season,2-1,2,1,0,15,10,5,3-0,3,0,0,4,5,-1,Pittsburgh Steelers,5
2007-09-23,Detroit Lions,Philadelphia Eagles,21,56,2007,3,domingo,Regular Season,2-1,2,1,0,20,18,2,1-2,1,2,0,16,20,-4,Philadelphia Eagles,2
2007-09-23,Cleveland Browns,Oakland Raiders,24,26,2007,3,domingo,Regular Season,1-2,1,2,0,27,26,1,1-2,1,2,0,24,30,-6,Oakland Raiders,4
2007-09-23,Miami Dolphins,New York Jets,28,31,2007,3,domingo,Regular Season,0-3,0,3,0,31,28,3,1-2,1,2,0,21,24,-3,New York Jets,4
2007-09-23,Buffalo Bills,New England Patriots,7,38,2007,3,domingo,Regular Season,0-3,0,3,0,29,29,0,3-0,3,0,0,1,1,0,New England Patriots,28
2007-09-23,Minnesota Vikings,Kansas City Chiefs,10,13,2007,3,domingo,Regular Season,1-2,1,2,0,25,22,3,1-2,1,2,0,28,31,-3,Kansas City Chiefs,9
2007-09-23,Indianapolis Colts,Houston Texans,30,24,2007,3,domingo,Regular Season,3-0,3,0,0,2,2,0,2-1,2,1,0,17,11,6,Indianapolis Colts,9
2007-09-23,Los Angeles Chargers,Green Bay Packers,24,31,2007,3,domingo,Regular Season,1-2,1,2,0,9,4,5,3-0,3,0,0,6,12,-6,Green Bay Packers,8
2007-09-23,Jacksonville Jaguars,Denver Broncos,23,14,2007,3,domingo,Regular Season,2-1,2,1,0,10,17,-7,2-1,2,1,0,8,8,0,Jacksonville Jaguars,9
2007-09-23,Dallas Cowboys,Chicago Bears,34,10,2007,3,domingo,Regular Season,3-0,3,0,0,3,3,0,1-2,1,2,0,13,6,7,Dallas Cowboys,3
2007-09-23,Arizona Cardinals,Baltimore Ravens,23,26,2007,3,domingo,Regular Season,1-2,1,2,0,22,21,1,2-1,2,1,0,5,7,-2,Baltimore Ravens,14
2007-09-23,Carolina Panthers,Atlanta Falcons,27,20,2007,3,domingo,Regular Season,2-1,2,1,0,12,16,-4,0-3,0,3,0,32,32,0,Carolina Panthers,16
2007-09-17,Washington Redskins,Philadelphia Eagles,20,12,2007,2,segunda,Regular Season,2-0,2,0,0,14,19,-5,0-2,0,2,0,20,13,7,Washington Redskins,6
2007-09-16,Indianapolis Colts,Tennessee Titans,22,20,2007,2,domingo,Regular Season,2-0,2,0,0,2,2,0,1-1,1,1,0,15,14,1,Indianapolis Colts,12
2007-09-16,New Orleans Saints,Tampa Bay Buccaneers,14,31,2007,2,domingo,Regular Season,0-2,0,2,0,19,11,8,1-1,1,1,0,23,28,-5,Tampa Bay Buccaneers,17
2007-09-16,San Francisco 49ers,Los Angeles Rams,17,16,2007,2,domingo,Regular Season,2-0,2,0,0,10,15,-5,0-2,0,2,0,25,20,5,San Francisco 49ers,5
2007-09-16,Buffalo Bills,Pittsburgh Steelers,3,26,2007,2,domingo,Regular Season,0-2,0,2,0,29,26,3,2-0,2,0,0,5,9,-4,Pittsburgh Steelers,17
2007-09-16,Green Bay Packers,New York Giants,35,13,2007,2,domingo,Regular Season,2-0,2,0,0,12,17,-5,0-2,0,2,0,27,22,5,Green Bay Packers,5
2007-09-16,Los Angeles Chargers,New England Patriots,14,38,2007,2,domingo,Regular Season,1-1,1,1,0,4,3,1,2-0,2,0,0,1,1,0,New England Patriots,2
2007-09-16,Dallas Cowboys,Miami Dolphins,37,20,2007,2,domingo,Regular Season,2-0,2,0,0,3,5,-2,0-2,0,2,0,28,27,1,Dallas Cowboys,22
2007-09-16,Atlanta Falcons,Jacksonville Jaguars,7,13,2007,2,domingo,Regular Season,0-2,0,2,0,32,31,1,1-1,1,1,0,17,16,1,Jacksonville Jaguars,15
2007-09-16,Minnesota Vikings,Detroit Lions,17,20,2007,2,domingo,Regular Season,1-1,1,1,0,22,24,-2,2-0,2,0,0,18,21,-3,Detroit Lions,3
2007-09-16,Oakland Raiders,Denver Broncos,20,23,2007,2,domingo,Regular Season,0-2,0,2,0,30,29,1,2-0,2,0,0,8,10,-2,Denver Broncos,19
2007-09-16,Cincinnati Bengals,Cleveland Browns,45,51,2007,2,domingo,Regular Season,1-1,1,1,0,13,6,7,1-1,1,1,0,26,32,-6,Cleveland Browns,26
2007-09-16,Kansas City Chiefs,Chicago Bears,10,20,2007,2,domingo,Regular Season,0-2,0,2,0,31,30,1,1-1,1,1,0,6,4,2,Chicago Bears,26
2007-09-16,Houston Texans,Carolina Panthers,34,21,2007,2,domingo,Regular Season,2-0,2,0,0,11,25,-14,1-1,1,1,0,16,12,4,Houston Texans,13
2007-09-16,New York Jets,Baltimore Ravens,13,20,2007,2,domingo,Regular Season,0-2,0,2,0,24,18,6,1-1,1,1,0,7,7,0,Baltimore Ravens,11
2007-09-16,Seattle Seahawks,Arizona Cardinals,20,23,2007,2,domingo,Regular Season,1-1,1,1,0,9,8,1,1-1,1,1,0,21,23,-2,Arizona Cardinals,15
2007-09-10,Arizona Cardinals,San Francisco 49ers,17,20,2007,1,segunda,Regular Season,0-1,0,1,0,23,23,0,1-0,1,0,0,15,16,-1,San Francisco 49ers,7
2007-09-10,Baltimore Ravens,Cincinnati Bengals,20,27,2007,1,segunda,Regular Season,0-1,0,1,0,7,5,2,1-0,1,0,0,6,11,-5,Cincinnati Bengals,6
2007-09-09,Miami Dolphins,Washington Redskins,13,16,2007,1,domingo,Regular Season,0-1,0,1,0,27,20,7,1-0,1,0,0,19,19,0,Washington Redskins,1
2007-09-09,Carolina Panthers,Los Angeles Rams,27,13,2007,1,domingo,Regular Season,1-0,1,0,0,12,15,-3,0-1,0,1,0,20,17,3,Carolina Panthers,2
2007-09-09,Tampa Bay Buccaneers,Seattle Seahawks,6,20,2007,1,domingo,Regular Season,0-1,0,1,0,28,28,0,1-0,1,0,0,8,10,-2,Seattle Seahawks,18
2007-09-09,Chicago Bears,Los Angeles Chargers,3,14,2007,1,domingo,Regular Season,0-1,0,1,0,4,4,0,1-0,1,0,0,3,3,0,Los Angeles Chargers,1
2007-09-09,Detroit Lions,Oakland Raiders,36,21,2007,1,domingo,Regular Season,1-0,1,0,0,21,25,-4,0-1,0,1,0,29,30,-1,Detroit Lions,5
2007-09-09,New England Patriots,New York Jets,38,14,2007,1,domingo,Regular Season,1-0,1,0,0,1,1,0,0-1,0,1,0,18,14,4,New England Patriots,13
2007-09-09,Atlanta Falcons,Minnesota Vikings,3,24,2007,1,domingo,Regular Season,0-1,0,1,0,31,31,0,1-0,1,0,0,24,27,-3,Minnesota Vikings,4
2007-09-09,Tennessee Titans,Jacksonville Jaguars,13,10,2007,1,domingo,Regular Season,1-0,1,0,0,14,22,-8,0-1,0,1,0,16,12,4,Tennessee Titans,10
2007-09-09,Kansas City Chiefs,Houston Texans,3,20,2007,1,domingo,Regular Season,0-1,0,1,0,30,26,4,1-0,1,0,0,25,29,-4,Houston Texans,3
2007-09-09,Philadelphia Eagles,Green Bay Packers,13,16,2007,1,domingo,Regular Season,0-1,0,1,0,13,7,6,1-0,1,0,0,17,24,-7,Green Bay Packers,17
2007-09-09,New York Giants,Dallas Cowboys,35,45,2007,1,domingo,Regular Season,0-1,0,1,0,22,18,4,1-0,1,0,0,5,8,-3,Dallas Cowboys,10
2007-09-09,Pittsburgh Steelers,Cleveland Browns,34,7,2007,1,domingo,Regular Season,1-0,1,0,0,9,13,-4,0-1,0,1,0,32,32,0,Pittsburgh Steelers,19
2007-09-09,Denver Broncos,Buffalo Bills,15,14,2007,1,domingo,Regular Season,1-0,1,0,0,10,9,1,0-1,0,1,0,26,21,5,Denver Broncos,12
2007-09-06,New Orleans Saints,Indianapolis Colts,10,41,2007,1,quinta,Regular Season,0-1,0,1,0,11,6,5,1-0,1,0,0,2,2,0,Indianapolis Colts,4
2006-12-31,New England Patriots,Tennessee Titans,40,23,2006,17,domingo,Regular Season,12-4,12,4,0,3,5,-2,8-8,8,8,0,15,11,4,New England Patriots,6
2006-12-31,Seattle Seahawks,Tampa Bay Buccaneers,23,7,2006,17,domingo,Regular Season,9-7,9,7,0,9,15,-6,4-12,4,12,0,29,29,0,Seattle Seahawks,14
2006-12-31,Arizona Cardinals,Los Angeles Chargers,20,27,2006,17,domingo,Regular Season,5-11,5,11,0,28,27,1,14-2,14,2,0,1,1,0,Los Angeles Chargers,26
2006-12-31,Atlanta Falcons,Philadelphia Eagles,17,24,2006,17,domingo,Regular Season,7-9,7,9,0,22,21,1,10-6,10,6,0,7,7,0,Philadelphia Eagles,14
2006-12-31,Oakland Raiders,New York Jets,3,23,2006,17,domingo,Regular Season,2-14,2,14,0,32,31,1,10-6,10,6,0,8,10,-2,New York Jets,21
2006-12-31,Carolina Panthers,New Orleans Saints,31,21,2006,17,domingo,Regular Season,8-8,8,8,0,20,22,-2,10-6,10,6,0,6,4,2,Carolina Panthers,18
2006-12-31,Los Angeles Rams,Minnesota Vikings,41,21,2006,17,domingo,Regular Season,8-8,8,8,0,18,18,0,6-10,6,10,0,26,25,1,Los Angeles Rams,7
2006-12-31,Jacksonville Jaguars,Kansas City Chiefs,30,35,2006,17,domingo,Regular Season,8-8,8,8,0,17,13,4,9-7,9,7,0,10,14,-4,Kansas City Chiefs,1
2006-12-31,Miami Dolphins,Indianapolis Colts,22,27,2006,17,domingo,Regular Season,6-10,6,10,0,24,23,1,12-4,12,4,0,4,6,-2,Indianapolis Colts,17
2006-12-31,Cleveland Browns,Houston Texans,6,14,2006,17,domingo,Regular Season,4-12,4,12,0,30,30,0,6-10,6,10,0,25,28,-3,Houston Texans,2
2006-12-31,San Francisco 49ers,Denver Broncos,26,23,2006,17,domingo,Regular Season,7-9,7,9,0,23,24,-1,9-7,9,7,0,12,8,4,San Francisco 49ers,16
2006-12-31,Detroit Lions,Dallas Cowboys,39,31,2006,17,domingo,Regular Season,3-13,3,13,0,31,32,-1,9-7,9,7,0,11,9,2,Detroit Lions,23
2006-12-31,Pittsburgh Steelers,Cincinnati Bengals,23,17,2006,17,domingo,Regular Season,8-8,8,8,0,13,19,-6,8-8,8,8,0,14,12,2,Pittsburgh Steelers,7
2006-12-31,Green Bay Packers,Chicago Bears,26,7,2006,17,domingo,Regular Season,8-8,8,8,0,19,17,2,13-3,13,3,0,5,3,2,Green Bay Packers,14
2006-12-31,Buffalo Bills,Baltimore Ravens,7,19,2006,17,domingo,Regular Season,7-9,7,9,0,21,16,5,13-3,13,3,0,2,2,0,Baltimore Ravens,14
2006-12-30,New York Giants,Washington Redskins,34,28,2006,17,sábado,Regular Season,8-8,8,8,0,16,20,-4,5-11,5,11,0,27,26,1,New York Giants,6
2006-12-25,New York Jets,Miami Dolphins,13,10,2006,16,segunda,Regular Season,9-6,9,6,0,10,11,-1,6-9,6,9,0,23,21,2,New York Jets,10
2006-12-25,Philadelphia Eagles,Dallas Cowboys,23,7,2006,16,segunda,Regular Season,9-6,9,6,0,7,9,-2,9-6,9,6,0,9,7,2,Philadelphia Eagles,2
2006-12-24,Washington Redskins,Los Angeles Rams,31,37,2006,16,domingo,Regular Season,5-10,5,10,0,26,26,0,7-8,7,8,0,18,23,-5,Los Angeles Rams,3
2006-12-24,Los Angeles Chargers,Seattle Seahawks,20,17,2006,16,domingo,Regular Season,13-2,13,2,0,1,1,0,8-7,8,7,0,15,15,0,Los Angeles Chargers,14
2006-12-24,Arizona Cardinals,San Francisco 49ers,26,20,2006,16,domingo,Regular Season,5-10,5,10,0,27,27,0,6-9,6,9,0,24,20,4,Arizona Cardinals,7
2006-12-24,Baltimore Ravens,Pittsburgh Steelers,31,7,2006,16,domingo,Regular Season,12-3,12,3,0,2,2,0,7-8,7,8,0,19,14,5,Baltimore Ravens,12
2006-12-24,New Orleans Saints,New York Giants,30,7,2006,16,domingo,Regular Season,10-5,10,5,0,4,6,-2,7-8,7,8,0,20,17,3,New Orleans Saints,11
2006-12-24,New England Patriots,Jacksonville Jaguars,24,21,2006,16,domingo,Regular Season,11-4,11,4,0,5,5,0,8-7,8,7,0,13,12,1,New England Patriots,7
2006-12-24,Indianapolis Colts,Houston Texans,24,27,2006,16,domingo,Regular Season,11-4,11,4,0,6,3,3,5-10,5,10,0,28,29,-1,Houston Texans,26
2006-12-24,Chicago Bears,Detroit Lions,26,21,2006,16,domingo,Regular Season,13-2,13,2,0,3,4,-1,2-13,2,13,0,32,32,0,Chicago Bears,28
2006-12-24,Cincinnati Bengals,Denver Broncos,23,24,2006,16,domingo,Regular Season,8-7,8,7,0,12,8,4,9-6,9,6,0,8,10,-2,Denver Broncos,2
2006-12-24,Tampa Bay Buccaneers,Cleveland Browns,22,7,2006,16,domingo,Regular Season,4-11,4,11,0,29,30,-1,4-11,4,11,0,30,28,2,Tampa Bay Buccaneers,2
2006-12-24,Tennessee Titans,Buffalo Bills,30,29,2006,16,domingo,Regular Season,8-7,8,7,0,11,13,-2,7-8,7,8,0,16,16,0,Tennessee Titans,3
2006-12-24,Carolina Panthers,Atlanta Falcons,10,3,2006,16,domingo,Regular Season,7-8,7,8,0,22,25,-3,7-8,7,8,0,21,18,3,Carolina Panthers,7
2006-12-23,Kansas City Chiefs,Oakland Raiders,20,9,2006,16,sábado,Regular Season,8-7,8,7,0,14,19,-5,2-13,2,13,0,31,31,0,Kansas City Chiefs,12
2006-12-21,Minnesota Vikings,Green Bay Packers,7,9,2006,16,quinta,Regular Season,6-9,6,9,0,25,24,1,7-8,7,8,0,17,22,-5,Green Bay Packers,2
2006-12-18,Cincinnati Bengals,Indianapolis Colts,16,34,2006,15,segunda,Regular Season,8-6,8,6,0,8,5,3,11-3,11,3,0,3,6,-3,Indianapolis Colts,1
2006-12-17,Jacksonville Jaguars,Tennessee Titans,17,24,2006,15,domingo,Regular Season,8-6,8,6,0,12,9,3,7-7,7,7,0,13,14,-1,Tennessee Titans,5
2006-12-17,Kansas City Chiefs,Los Angeles Chargers,9,20,2006,15,domingo,Regular Season,7-7,7,7,0,19,15,4,12-2,12,2,0,1,1,0,Los Angeles Chargers,14
2006-12-17,Los Angeles Rams,Oakland Raiders,20,0,2006,15,domingo,Regular Season,6-8,6,8,0,23,24,-1,2-12,2,12,0,31,31,0,Los Angeles Rams,7
2006-12-17,Philadelphia Eagles,New York Giants,36,22,2006,15,domingo,Regular Season,8-6,8,6,0,9,13,-4,7-7,7,7,0,17,11,6,Philadelphia Eagles,2
2006-12-17,Washington Redskins,New Orleans Saints,16,10,2006,15,domingo,Regular Season,5-9,5,9,0,26,27,-1,9-5,9,5,0,6,3,3,Washington Redskins,24
2006-12-17,Houston Texans,New England Patriots,7,40,2006,15,domingo,Regular Season,4-10,4,10,0,29,28,1,10-4,10,4,0,5,8,-3,New England Patriots,20
2006-12-17,New York Jets,Minnesota Vikings,26,13,2006,15,domingo,Regular Season,8-6,8,6,0,11,16,-5,6-8,6,8,0,24,21,3,New York Jets,5
2006-12-17,Detroit Lions,Green Bay Packers,9,17,2006,15,domingo,Regular Season,2-12,2,12,0,32,32,0,6-8,6,8,0,22,23,-1,Green Bay Packers,9
2006-12-17,Tampa Bay Buccaneers,Chicago Bears,31,34,2006,15,domingo,Regular Season,3-11,3,11,0,30,30,0,12-2,12,2,0,4,4,0,Chicago Bears,26
2006-12-17,Pittsburgh Steelers,Carolina Panthers,37,3,2006,15,domingo,Regular Season,7-7,7,7,0,14,20,-6,6-8,6,8,0,25,22,3,Pittsburgh Steelers,2
2006-12-17,Miami Dolphins,Buffalo Bills,0,21,2006,15,domingo,Regular Season,6-8,6,8,0,21,18,3,7-7,7,7,0,16,19,-3,Buffalo Bills,1
2006-12-17,Cleveland Browns,Baltimore Ravens,17,27,2006,15,domingo,Regular Season,4-10,4,10,0,28,29,-1,11-3,11,3,0,2,2,0,Baltimore Ravens,27
2006-12-17,Denver Broncos,Arizona Cardinals,37,20,2006,15,domingo,Regular Season,8-6,8,6,0,10,17,-7,4-10,4,10,0,27,26,1,Denver Broncos,9
2006-12-16,Dallas Cowboys,Atlanta Falcons,38,28,2006,15,sábado,Regular Season,9-5,9,5,0,7,7,0,7-7,7,7,0,18,12,6,Dallas Cowboys,5
2006-12-14,San Francisco 49ers,Seattle Seahawks,24,14,2006,15,quinta,Regular Season,6-8,6,8,0,20,25,-5,8-6,8,6,0,15,10,5,San Francisco 49ers,15
2006-12-11,Chicago Bears,Los Angeles Rams,42,27,2006,14,segunda,Regular Season,11-2,11,2,0,4,4,0,5-8,5,8,0,24,23,1,Chicago Bears,19
2006-12-10,Philadelphia Eagles,Washington Redskins,21,19,2006,14,domingo,Regular Season,7-6,7,6,0,13,17,-4,4-9,4,9,0,27,25,2,Philadelphia Eagles,8
2006-12-10,Atlanta Falcons,Tampa Bay Buccaneers,17,6,2006,14,domingo,Regular Season,7-6,7,6,0,12,14,-2,3-10,3,10,0,30,30,0,Atlanta Falcons,16
2006-12-10,Green Bay Packers,San Francisco 49ers,30,19,2006,14,domingo,Regular Season,5-8,5,8,0,23,28,-5,5-8,5,8,0,25,22,3,Green Bay Packers,6
2006-12-10,Denver Broncos,Los Angeles Chargers,20,48,2006,14,domingo,Regular Season,7-6,7,6,0,17,13,4,11-2,11,2,0,1,1,0,Los Angeles Chargers,12
2006-12-10,Buffalo Bills,New York Jets,31,13,2006,14,domingo,Regular Season,6-7,6,7,0,19,21,-2,7-6,7,6,0,16,11,5,Buffalo Bills,10
2006-12-10,New England Patriots,Miami Dolphins,0,21,2006,14,domingo,Regular Season,9-4,9,4,0,8,5,3,6-7,6,7,0,18,20,-2,Miami Dolphins,15
2006-12-10,Baltimore Ravens,Kansas City Chiefs,20,10,2006,14,domingo,Regular Season,10-3,10,3,0,2,6,-4,7-6,7,6,0,15,12,3,Baltimore Ravens,6
2006-12-10,Indianapolis Colts,Jacksonville Jaguars,17,44,2006,14,domingo,Regular Season,10-3,10,3,0,6,2,4,8-5,8,5,0,9,10,-1,Jacksonville Jaguars,8
2006-12-10,Tennessee Titans,Houston Texans,26,20,2006,14,domingo,Regular Season,6-7,6,7,0,14,16,-2,4-9,4,9,0,28,27,1,Tennessee Titans,11
2006-12-10,Minnesota Vikings,Detroit Lions,30,20,2006,14,domingo,Regular Season,6-7,6,7,0,21,24,-3,2-11,2,11,0,32,32,0,Minnesota Vikings,8
2006-12-10,New Orleans Saints,Dallas Cowboys,42,17,2006,14,domingo,Regular Season,9-4,9,4,0,3,7,-4,8-5,8,5,0,7,3,4,New Orleans Saints,4
2006-12-10,Oakland Raiders,Cincinnati Bengals,10,27,2006,14,domingo,Regular Season,2-11,2,11,0,31,31,0,8-5,8,5,0,5,8,-3,Cincinnati Bengals,23
2006-12-10,New York Giants,Carolina Panthers,27,13,2006,14,domingo,Regular Season,7-6,7,6,0,11,15,-4,6-7,6,7,0,22,18,4,New York Giants,3
2006-12-10,Seattle Seahawks,Arizona Cardinals,21,27,2006,14,domingo,Regular Season,8-5,8,5,0,10,9,1,4-9,4,9,0,26,29,-3,Arizona Cardinals,20
2006-12-07,Cleveland Browns,Pittsburgh Steelers,7,27,2006,14,quinta,Regular Season,4-9,4,9,0,29,26,3,6-7,6,7,0,20,19,1,Pittsburgh Steelers,7
2006-12-04,Carolina Panthers,Philadelphia Eagles,24,27,2006,13,segunda,Regular Season,6-6,6,6,0,18,12,6,6-6,6,6,0,17,22,-5,Philadelphia Eagles,10
2006-12-03,Atlanta Falcons,Washington Redskins,24,14,2006,13,domingo,Regular Season,6-6,6,6,0,14,18,-4,4-8,4,8,0,25,25,0,Atlanta Falcons,7
2006-12-03,Indianapolis Colts,Tennessee Titans,17,20,2006,13,domingo,Regular Season,10-2,10,2,0,2,1,1,5-7,5,7,0,16,23,-7,Tennessee Titans,22
2006-12-03,Arizona Cardinals,Los Angeles Rams,34,20,2006,13,domingo,Regular Season,3-9,3,9,0,29,31,-2,5-7,5,7,0,23,17,6,Arizona Cardinals,14
2006-12-03,Tampa Bay Buccaneers,Pittsburgh Steelers,3,20,2006,13,domingo,Regular Season,3-9,3,9,0,30,28,2,5-7,5,7,0,19,24,-5,Pittsburgh Steelers,4
2006-12-03,Houston Texans,Oakland Raiders,23,14,2006,13,domingo,Regular Season,4-8,4,8,0,27,27,0,2-10,2,10,0,31,30,1,Houston Texans,3
2006-12-03,Dallas Cowboys,New York Giants,23,20,2006,13,domingo,Regular Season,8-4,8,4,0,3,6,-3,6-6,6,6,0,15,15,0,Dallas Cowboys,9
2006-12-03,San Francisco 49ers,New Orleans Saints,10,34,2006,13,domingo,Regular Season,5-7,5,7,0,22,20,2,8-4,8,4,0,7,10,-3,New Orleans Saints,10
2006-12-03,Detroit Lions,New England Patriots,21,28,2006,13,domingo,Regular Season,2-10,2,10,0,32,32,0,9-3,9,3,0,5,4,1,New England Patriots,28
2006-12-03,Jacksonville Jaguars,Miami Dolphins,24,10,2006,13,domingo,Regular Season,7-5,7,5,0,10,13,-3,5-7,5,7,0,20,16,4,Jacksonville Jaguars,3
2006-12-03,New York Jets,Green Bay Packers,38,10,2006,13,domingo,Regular Season,7-5,7,5,0,11,14,-3,4-8,4,8,0,28,26,2,New York Jets,12
2006-12-03,Seattle Seahawks,Denver Broncos,23,20,2006,13,domingo,Regular Season,8-4,8,4,0,9,8,1,7-5,7,5,0,13,9,4,Seattle Seahawks,1
2006-12-03,Kansas City Chiefs,Cleveland Browns,28,31,2006,13,domingo,Regular Season,7-5,7,5,0,12,7,5,4-8,4,8,0,26,29,-3,Cleveland Browns,22
2006-12-03,Minnesota Vikings,Chicago Bears,13,23,2006,13,domingo,Regular Season,5-7,5,7,0,24,21,3,10-2,10,2,0,4,5,-1,Chicago Bears,16
2006-12-03,Los Angeles Chargers,Buffalo Bills,24,21,2006,13,domingo,Regular Season,10-2,10,2,0,1,2,-1,5-7,5,7,0,21,19,2,Los Angeles Chargers,17
2006-11-30,Baltimore Ravens,Cincinnati Bengals,7,13,2006,13,quinta,Regular Season,9-3,9,3,0,6,3,3,7-5,7,5,0,8,11,-3,Cincinnati Bengals,8
2006-11-27,Green Bay Packers,Seattle Seahawks,24,34,2006,12,segunda,Regular Season,4-7,4,7,0,26,22,4,7-4,7,4,0,8,11,-3,Seattle Seahawks,11
2006-11-26,Carolina Panthers,Washington Redskins,13,17,2006,12,domingo,Regular Season,6-5,6,5,0,12,8,4,4-7,4,7,0,25,28,-3,Washington Redskins,20
2006-11-26,New York Giants,Tennessee Titans,21,24,2006,12,domingo,Regular Season,6-5,6,5,0,15,14,1,4-7,4,7,0,23,25,-2,Tennessee Titans,11
2006-11-26,San Francisco 49ers,Los Angeles Rams,17,20,2006,12,domingo,Regular Season,5-6,5,6,0,20,18,2,5-6,5,6,0,17,21,-4,Los Angeles Rams,3
2006-11-26,Oakland Raiders,Los Angeles Chargers,14,21,2006,12,domingo,Regular Season,2-9,2,9,0,30,32,-2,9-2,9,2,0,2,1,1,Los Angeles Chargers,31
2006-11-26,Houston Texans,New York Jets,11,26,2006,12,domingo,Regular Season,3-8,3,8,0,27,26,1,6-5,6,5,0,14,17,-3,New York Jets,9
2006-11-26,Chicago Bears,New England Patriots,13,17,2006,12,domingo,Regular Season,9-2,9,2,0,5,3,2,8-3,8,3,0,4,5,-1,New England Patriots,2
2006-11-26,Arizona Cardinals,Minnesota Vikings,26,31,2006,12,domingo,Regular Season,2-9,2,9,0,31,30,1,5-6,5,6,0,21,24,-3,Minnesota Vikings,6
2006-11-26,Philadelphia Eagles,Indianapolis Colts,21,45,2006,12,domingo,Regular Season,5-6,5,6,0,22,20,2,10-1,10,1,0,1,2,-1,Indianapolis Colts,18
2006-11-26,Cincinnati Bengals,Cleveland Browns,30,0,2006,12,domingo,Regular Season,6-5,6,5,0,11,12,-1,3-8,3,8,0,29,29,0,Cincinnati Bengals,17
2006-11-26,Jacksonville Jaguars,Buffalo Bills,24,27,2006,12,domingo,Regular Season,6-5,6,5,0,13,9,4,5-6,5,6,0,19,23,-4,Buffalo Bills,14
2006-11-26,Pittsburgh Steelers,Baltimore Ravens,0,27,2006,12,domingo,Regular Season,4-7,4,7,0,24,15,9,9-2,9,2,0,3,4,-1,Baltimore Ravens,11
2006-11-26,New Orleans Saints,Atlanta Falcons,31,13,2006,12,domingo,Regular Season,7-4,7,4,0,10,13,-3,5-6,5,6,0,18,16,2,New Orleans Saints,3
2006-11-23,Denver Broncos,Kansas City Chiefs,10,19,2006,12,quinta,Regular Season,7-4,7,4,0,9,7,2,7-4,7,4,0,7,10,-3,Kansas City Chiefs,3
2006-11-23,Miami Dolphins,Detroit Lions,27,10,2006,12,quinta,Regular Season,5-6,5,6,0,16,19,-3,2-9,2,9,0,32,31,1,Miami Dolphins,12
2006-11-23,Tampa Bay Buccaneers,Dallas Cowboys,10,38,2006,12,quinta,Regular Season,3-8,3,8,0,28,27,1,7-4,7,4,0,6,6,0,Dallas Cowboys,21
2006-11-20,New York Giants,Jacksonville Jaguars,10,26,2006,11,segunda,Regular Season,6-4,6,4,0,14,8,6,6-4,6,4,0,9,16,-7,Jacksonville Jaguars,8
2006-11-19,Washington Redskins,Tampa Bay Buccaneers,17,20,2006,11,domingo,Regular Season,3-7,3,7,0,28,25,3,3-7,3,7,0,27,28,-1,Tampa Bay Buccaneers,3
2006-11-19,Seattle Seahawks,San Francisco 49ers,14,20,2006,11,domingo,Regular Season,6-4,6,4,0,11,7,4,5-5,5,5,0,18,22,-4,San Francisco 49ers,15
2006-11-19,Tennessee Titans,Philadelphia Eagles,31,13,2006,11,domingo,Regular Season,3-7,3,7,0,25,29,-4,5-5,5,5,0,20,11,9,Tennessee Titans,18
2006-11-19,Chicago Bears,New York Jets,10,0,2006,11,domingo,Regular Season,9-1,9,1,0,3,2,1,5-5,5,5,0,17,14,3,Chicago Bears,12
2006-11-19,Cincinnati Bengals,New Orleans Saints,31,16,2006,11,domingo,Regular Season,5-5,5,5,0,12,17,-5,6-4,6,4,0,13,9,4,Cincinnati Bengals,8
2006-11-19,Minnesota Vikings,Miami Dolphins,20,24,2006,11,domingo,Regular Season,4-6,4,6,0,24,23,1,4-6,4,6,0,19,21,-2,Miami Dolphins,2
2006-11-19,Oakland Raiders,Kansas City Chiefs,13,17,2006,11,domingo,Regular Season,2-8,2,8,0,32,31,1,6-4,6,4,0,10,13,-3,Kansas City Chiefs,18
2006-11-19,Buffalo Bills,Houston Texans,24,21,2006,11,domingo,Regular Season,4-6,4,6,0,23,27,-4,3-7,3,7,0,26,26,0,Buffalo Bills,1
2006-11-19,New England Patriots,Green Bay Packers,35,0,2006,11,domingo,Regular Season,7-3,7,3,0,5,6,-1,4-6,4,6,0,22,20,2,New England Patriots,14
2006-11-19,Los Angeles Chargers,Denver Broncos,35,27,2006,11,domingo,Regular Season,8-2,8,2,0,1,3,-2,7-3,7,3,0,7,4,3,Los Angeles Chargers,1
2006-11-19,Indianapolis Colts,Dallas Cowboys,14,21,2006,11,domingo,Regular Season,9-1,9,1,0,2,1,1,6-4,6,4,0,6,10,-4,Dallas Cowboys,9
2006-11-19,Pittsburgh Steelers,Cleveland Browns,24,20,2006,11,domingo,Regular Season,4-6,4,6,0,15,19,-4,3-7,3,7,0,29,24,5,Pittsburgh Steelers,5
2006-11-19,Los Angeles Rams,Carolina Panthers,0,15,2006,11,domingo,Regular Season,4-6,4,6,0,21,18,3,6-4,6,4,0,8,12,-4,Carolina Panthers,6
2006-11-19,Atlanta Falcons,Baltimore Ravens,10,24,2006,11,domingo,Regular Season,5-5,5,5,0,16,15,1,8-2,8,2,0,4,5,-1,Baltimore Ravens,10
2006-11-19,Detroit Lions,Arizona Cardinals,10,17,2006,11,domingo,Regular Season,2-8,2,8,0,31,30,1,2-8,2,8,0,30,32,-2,Arizona Cardinals,2
2006-11-13,Tampa Bay Buccaneers,Carolina Panthers,10,24,2006,10,segunda,Regular Season,2-7,2,7,0,28,27,1,5-4,5,4,0,12,14,-2,Carolina Panthers,13
2006-11-12,Baltimore Ravens,Tennessee Titans,27,26,2006,10,domingo,Regular Season,7-2,7,2,0,5,7,-2,2-7,2,7,0,29,29,0,Baltimore Ravens,22
2006-11-12,Los Angeles Rams,Seattle Seahawks,22,24,2006,10,domingo,Regular Season,4-5,4,5,0,18,17,1,6-3,6,3,0,7,12,-5,Seattle Seahawks,5
2006-11-12,New Orleans Saints,Pittsburgh Steelers,31,38,2006,10,domingo,Regular Season,6-3,6,3,0,9,8,1,3-6,3,6,0,19,24,-5,Pittsburgh Steelers,16
2006-11-12,Washington Redskins,Philadelphia Eagles,3,27,2006,10,domingo,Regular Season,3-6,3,6,0,25,20,5,5-4,5,4,0,11,16,-5,Philadelphia Eagles,4
2006-11-12,Denver Broncos,Oakland Raiders,17,13,2006,10,domingo,Regular Season,7-2,7,2,0,4,2,2,2-7,2,7,0,31,31,0,Denver Broncos,29
2006-11-12,Chicago Bears,New York Giants,38,20,2006,10,domingo,Regular Season,8-1,8,1,0,2,3,-1,6-3,6,3,0,8,6,2,Chicago Bears,3
2006-11-12,New York Jets,New England Patriots,17,14,2006,10,domingo,Regular Season,5-4,5,4,0,14,19,-5,6-3,6,3,0,6,4,2,New York Jets,15
2006-11-12,Green Bay Packers,Minnesota Vikings,23,17,2006,10,domingo,Regular Season,4-5,4,5,0,20,22,-2,4-5,4,5,0,23,18,5,Green Bay Packers,4
2006-11-12,Kansas City Chiefs,Miami Dolphins,10,13,2006,10,domingo,Regular Season,5-4,5,4,0,13,11,2,3-6,3,6,0,21,25,-4,Miami Dolphins,14
2006-11-12,Houston Texans,Jacksonville Jaguars,13,10,2006,10,domingo,Regular Season,3-6,3,6,0,26,28,-2,5-4,5,4,0,16,10,6,Houston Texans,18
2006-11-12,Buffalo Bills,Indianapolis Colts,16,17,2006,10,domingo,Regular Season,3-6,3,6,0,27,21,6,9-0,9,0,0,1,1,0,Indianapolis Colts,20
2006-11-12,San Francisco 49ers,Detroit Lions,19,13,2006,10,domingo,Regular Season,4-5,4,5,0,22,23,-1,2-7,2,7,0,30,26,4,San Francisco 49ers,3
2006-11-12,Los Angeles Chargers,Cincinnati Bengals,49,41,2006,10,domingo,Regular Season,7-2,7,2,0,3,5,-2,4-5,4,5,0,17,13,4,Los Angeles Chargers,8
2006-11-12,Cleveland Browns,Atlanta Falcons,17,13,2006,10,domingo,Regular Season,3-6,3,6,0,24,30,-6,5-4,5,4,0,15,9,6,Cleveland Browns,21
2006-11-12,Dallas Cowboys,Arizona Cardinals,27,10,2006,10,domingo,Regular Season,5-4,5,4,0,10,15,-5,1-8,1,8,0,32,32,0,Dallas Cowboys,17
2006-11-06,Oakland Raiders,Seattle Seahawks,0,16,2006,9,segunda,Regular Season,2-6,2,6,0,31,28,3,5-3,5,3,0,12,13,-1,Seattle Seahawks,15
2006-11-05,Dallas Cowboys,Washington Redskins,19,22,2006,9,domingo,Regular Season,4-4,4,4,0,15,11,4,3-5,3,5,0,20,23,-3,Washington Redskins,12
2006-11-05,New Orleans Saints,Tampa Bay Buccaneers,31,14,2006,9,domingo,Regular Season,6-2,6,2,0,8,9,-1,2-6,2,6,0,27,24,3,New Orleans Saints,15
2006-11-05,Kansas City Chiefs,Los Angeles Rams,31,17,2006,9,domingo,Regular Season,5-3,5,3,0,11,14,-3,4-4,4,4,0,17,18,-1,Kansas City Chiefs,4
2006-11-05,Minnesota Vikings,San Francisco 49ers,3,9,2006,9,domingo,Regular Season,4-4,4,4,0,18,16,2,3-5,3,5,0,23,29,-6,San Francisco 49ers,13
2006-11-05,Cleveland Browns,Los Angeles Chargers,25,32,2006,9,domingo,Regular Season,2-6,2,6,0,30,26,4,6-2,6,2,0,5,5,0,Los Angeles Chargers,21
2006-11-05,Denver Broncos,Pittsburgh Steelers,31,20,2006,9,domingo,Regular Season,6-2,6,2,0,2,6,-4,2-6,2,6,0,24,21,3,Denver Broncos,15
2006-11-05,Houston Texans,New York Giants,10,14,2006,9,domingo,Regular Season,2-6,2,6,0,28,25,3,6-2,6,2,0,6,4,2,New York Giants,21
2006-11-05,Indianapolis Colts,New England Patriots,27,20,2006,9,domingo,Regular Season,8-0,8,0,0,1,2,-1,6-2,6,2,0,4,3,1,Indianapolis Colts,1
2006-11-05,Tennessee Titans,Jacksonville Jaguars,7,37,2006,9,domingo,Regular Season,2-6,2,6,0,29,22,7,5-3,5,3,0,10,12,-2,Jacksonville Jaguars,10
2006-11-05,Atlanta Falcons,Detroit Lions,14,30,2006,9,domingo,Regular Season,5-3,5,3,0,9,7,2,2-6,2,6,0,26,30,-4,Detroit Lions,23
2006-11-05,Miami Dolphins,Chicago Bears,31,13,2006,9,domingo,Regular Season,2-6,2,6,0,25,31,-6,7-1,7,1,0,3,1,2,Miami Dolphins,30
2006-11-05,Green Bay Packers,Buffalo Bills,10,24,2006,9,domingo,Regular Season,3-5,3,5,0,22,20,2,3-5,3,5,0,21,27,-6,Buffalo Bills,7
2006-11-05,Cincinnati Bengals,Baltimore Ravens,20,26,2006,9,domingo,Regular Season,4-4,4,4,0,13,10,3,6-2,6,2,0,7,8,-1,Baltimore Ravens,2
2006-10-30,New England Patriots,Minnesota Vikings,31,7,2006,8,segunda,Regular Season,6-1,6,1,0,3,4,-1,4-3,4,3,0,16,12,4,New England Patriots,8
2006-10-29,Houston Texans,Tennessee Titans,22,28,2006,8,domingo,Regular Season,2-5,2,5,0,25,22,3,2-5,2,5,0,22,27,-5,Tennessee Titans,5
2006-10-29,Los Angeles Rams,Los Angeles Chargers,24,38,2006,8,domingo,Regular Season,4-3,4,3,0,18,14,4,5-2,5,2,0,5,8,-3,Los Angeles Chargers,6
2006-10-29,Jacksonville Jaguars,Philadelphia Eagles,13,6,2006,8,domingo,Regular Season,4-3,4,3,0,12,16,-4,4-4,4,4,0,17,15,2,Jacksonville Jaguars,1
2006-10-29,Pittsburgh Steelers,Oakland Raiders,13,20,2006,8,domingo,Regular Season,2-5,2,5,0,21,18,3,2-5,2,5,0,28,31,-3,Oakland Raiders,13
2006-10-29,Tampa Bay Buccaneers,New York Giants,3,17,2006,8,domingo,Regular Season,2-5,2,5,0,24,21,3,5-2,5,2,0,4,6,-2,New York Giants,15
2006-10-29,Baltimore Ravens,New Orleans Saints,35,22,2006,8,domingo,Regular Season,5-2,5,2,0,8,13,-5,5-2,5,2,0,9,5,4,Baltimore Ravens,8
2006-10-29,Seattle Seahawks,Kansas City Chiefs,28,35,2006,8,domingo,Regular Season,4-3,4,3,0,13,11,2,4-3,4,3,0,14,19,-5,Kansas City Chiefs,8
2006-10-29,Arizona Cardinals,Green Bay Packers,14,31,2006,8,domingo,Regular Season,1-7,1,7,0,32,32,0,3-4,3,4,0,20,23,-3,Green Bay Packers,9
2006-10-29,Indianapolis Colts,Denver Broncos,34,31,2006,8,domingo,Regular Season,7-0,7,0,0,2,2,0,5-2,5,2,0,6,3,3,Indianapolis Colts,1
2006-10-29,New York Jets,Cleveland Browns,13,20,2006,8,domingo,Regular Season,4-4,4,4,0,19,20,-1,2-5,2,5,0,26,30,-4,Cleveland Browns,10
2006-10-29,Atlanta Falcons,Cincinnati Bengals,29,27,2006,8,domingo,Regular Season,5-2,5,2,0,7,9,-2,4-3,4,3,0,10,7,3,Atlanta Falcons,2
2006-10-29,San Francisco 49ers,Chicago Bears,10,41,2006,8,domingo,Regular Season,2-5,2,5,0,29,25,4,7-0,7,0,0,1,1,0,Chicago Bears,24
2006-10-29,Dallas Cowboys,Carolina Panthers,35,14,2006,8,domingo,Regular Season,4-3,4,3,0,11,17,-6,4-4,4,4,0,15,10,5,Dallas Cowboys,7
2006-10-23,New York Giants,Dallas Cowboys,36,22,2006,7,segunda,Regular Season,4-2,4,2,0,6,11,-5,3-3,3,3,0,17,15,2,New York Giants,4
2006-10-22,Philadelphia Eagles,Tampa Bay Buccaneers,21,23,2006,7,domingo,Regular Season,4-3,4,3,0,15,9,6,2-4,2,4,0,21,22,-1,Tampa Bay Buccaneers,13
2006-10-22,Minnesota Vikings,Seattle Seahawks,31,13,2006,7,domingo,Regular Season,4-2,4,2,0,12,18,-6,4-2,4,2,0,11,5,6,Minnesota Vikings,13
2006-10-22,Arizona Cardinals,Oakland Raiders,9,22,2006,7,domingo,Regular Season,1-6,1,6,0,32,29,3,1-5,1,5,0,31,32,-1,Oakland Raiders,3
2006-10-22,Detroit Lions,New York Jets,24,31,2006,7,domingo,Regular Season,1-6,1,6,0,28,25,3,4-3,4,3,0,20,19,1,New York Jets,6
2006-10-22,Green Bay Packers,Miami Dolphins,34,24,2006,7,domingo,Regular Season,2-4,2,4,0,23,31,-8,1-6,1,6,0,29,27,2,Green Bay Packers,4
2006-10-22,Los Angeles Chargers,Kansas City Chiefs,27,30,2006,7,domingo,Regular Season,4-2,4,2,0,8,3,5,3-3,3,3,0,19,20,-1,Kansas City Chiefs,17
2006-10-22,Washington Redskins,Indianapolis Colts,22,36,2006,7,domingo,Regular Season,2-5,2,5,0,24,21,3,6-0,6,0,0,2,2,0,Indianapolis Colts,19
2006-10-22,Jacksonville Jaguars,Houston Texans,7,27,2006,7,domingo,Regular Season,3-3,3,3,0,16,13,3,2-4,2,4,0,22,30,-8,Houston Texans,17
2006-10-22,Denver Broncos,Cleveland Browns,17,7,2006,7,domingo,Regular Season,5-1,5,1,0,3,4,-1,1-5,1,5,0,30,28,2,Denver Broncos,24
2006-10-22,Carolina Panthers,Cincinnati Bengals,14,17,2006,7,domingo,Regular Season,4-3,4,3,0,10,8,2,4-2,4,2,0,7,12,-5,Cincinnati Bengals,4
2006-10-22,New England Patriots,Buffalo Bills,28,6,2006,7,domingo,Regular Season,5-1,5,1,0,4,6,-2,2-5,2,5,0,26,23,3,New England Patriots,17
2006-10-22,Pittsburgh Steelers,Atlanta Falcons,38,41,2006,7,domingo,Regular Season,2-4,2,4,0,18,17,1,4-2,4,2,0,9,16,-7,Atlanta Falcons,1
2006-10-16,Chicago Bears,Arizona Cardinals,24,23,2006,6,segunda,Regular Season,6-0,6,0,0,1,1,0,1-5,1,5,0,29,27,2,Chicago Bears,26
2006-10-15,Tennessee Titans,Washington Redskins,25,22,2006,6,domingo,Regular Season,1-5,1,5,0,26,30,-4,2-4,2,4,0,21,20,1,Tennessee Titans,10
2006-10-15,Cincinnati Bengals,Tampa Bay Buccaneers,13,14,2006,6,domingo,Regular Season,3-2,3,2,0,12,9,3,1-4,1,4,0,22,28,-6,Tampa Bay Buccaneers,19
2006-10-15,Seattle Seahawks,Los Angeles Rams,30,28,2006,6,domingo,Regular Season,4-1,4,1,0,5,8,-3,4-2,4,2,0,14,14,0,Seattle Seahawks,6
2006-10-15,Los Angeles Chargers,San Francisco 49ers,48,19,2006,6,domingo,Regular Season,4-1,4,1,0,3,5,-2,2-4,2,4,0,24,22,2,Los Angeles Chargers,17
2006-10-15,Kansas City Chiefs,Pittsburgh Steelers,7,45,2006,6,domingo,Regular Season,2-3,2,3,0,20,19,1,2-3,2,3,0,17,18,-1,Pittsburgh Steelers,1
2006-10-15,Miami Dolphins,New York Jets,17,20,2006,6,domingo,Regular Season,1-5,1,5,0,27,25,2,3-3,3,3,0,19,21,-2,New York Jets,4
2006-10-15,Philadelphia Eagles,New Orleans Saints,24,27,2006,6,domingo,Regular Season,4-2,4,2,0,9,4,5,5-1,5,1,0,7,13,-6,New Orleans Saints,9
2006-10-15,Buffalo Bills,Detroit Lions,17,20,2006,6,domingo,Regular Season,2-4,2,4,0,23,23,0,1-5,1,5,0,25,31,-6,Detroit Lions,8
2006-10-15,Oakland Raiders,Denver Broncos,3,13,2006,6,domingo,Regular Season,0-5,0,5,0,32,32,0,4-1,4,1,0,4,3,1,Denver Broncos,29
2006-10-15,Houston Texans,Dallas Cowboys,6,34,2006,6,domingo,Regular Season,1-4,1,4,0,30,24,6,3-2,3,2,0,15,15,0,Dallas Cowboys,9
2006-10-15,Carolina Panthers,Baltimore Ravens,23,21,2006,6,domingo,Regular Season,4-2,4,2,0,8,12,-4,4-2,4,2,0,10,6,4,Carolina Panthers,6
2006-10-15,New York Giants,Atlanta Falcons,27,14,2006,6,domingo,Regular Season,3-2,3,2,0,11,16,-5,3-2,3,2,0,16,10,6,New York Giants,6
2006-10-09,Baltimore Ravens,Denver Broncos,3,13,2006,5,segunda,Regular Season,4-1,4,1,0,6,3,3,3-1,3,1,0,3,8,-5,Denver Broncos,5
2006-10-08,Oakland Raiders,San Francisco 49ers,20,34,2006,5,domingo,Regular Season,0-5,0,5,0,32,32,0,2-3,2,3,0,22,29,-7,San Francisco 49ers,3
2006-10-08,Pittsburgh Steelers,Los Angeles Chargers,13,23,2006,5,domingo,Regular Season,1-3,1,3,0,18,13,5,3-1,3,1,0,5,9,-4,Los Angeles Chargers,4
2006-10-08,Dallas Cowboys,Philadelphia Eagles,24,38,2006,5,domingo,Regular Season,2-2,2,2,0,15,11,4,4-1,4,1,0,4,4,0,Philadelphia Eagles,7
2006-10-08,Washington Redskins,New York Giants,3,19,2006,5,domingo,Regular Season,2-3,2,3,0,20,17,3,2-2,2,2,0,16,18,-2,New York Giants,1
2006-10-08,Tampa Bay Buccaneers,New Orleans Saints,21,24,2006,5,domingo,Regular Season,0-4,0,4,0,28,27,1,4-1,4,1,0,13,15,-2,New Orleans Saints,12
2006-10-08,Miami Dolphins,New England Patriots,10,20,2006,5,domingo,Regular Season,1-4,1,4,0,25,23,2,4-1,4,1,0,7,5,2,New England Patriots,18
2006-10-08,Detroit Lions,Minnesota Vikings,17,26,2006,5,domingo,Regular Season,0-5,0,5,0,31,30,1,3-2,3,2,0,17,20,-3,Minnesota Vikings,10
2006-10-08,New York Jets,Jacksonville Jaguars,0,41,2006,5,domingo,Regular Season,2-3,2,3,0,21,19,2,3-2,3,2,0,11,12,-1,Jacksonville Jaguars,7
2006-10-08,Tennessee Titans,Indianapolis Colts,13,14,2006,5,domingo,Regular Season,0-5,0,5,0,30,31,-1,5-0,5,0,0,2,2,0,Indianapolis Colts,29
2006-10-08,Los Angeles Rams,Green Bay Packers,23,20,2006,5,domingo,Regular Season,4-1,4,1,0,14,16,-2,1-4,1,4,0,29,28,1,Los Angeles Rams,12
2006-10-08,Buffalo Bills,Chicago Bears,7,40,2006,5,domingo,Regular Season,2-3,2,3,0,23,21,2,5-0,5,0,0,1,1,0,Chicago Bears,20
2006-10-08,Cleveland Browns,Carolina Panthers,12,20,2006,5,domingo,Regular Season,1-4,1,4,0,26,24,2,3-2,3,2,0,12,14,-2,Carolina Panthers,10
2006-10-08,Kansas City Chiefs,Arizona Cardinals,23,20,2006,5,domingo,Regular Season,2-2,2,2,0,19,22,-3,1-4,1,4,0,27,26,1,Kansas City Chiefs,4
2006-10-02,Green Bay Packers,Philadelphia Eagles,9,31,2006,4,segunda,Regular Season,1-3,1,3,0,28,26,2,3-1,3,1,0,4,10,-6,Philadelphia Eagles,16
2006-10-01,Jacksonville Jaguars,Washington Redskins,30,36,2006,4,domingo,Regular Season,2-2,2,2,0,12,7,5,2-2,2,2,0,17,20,-3,Washington Redskins,13
2006-10-01,Dallas Cowboys,Tennessee Titans,45,14,2006,4,domingo,Regular Season,2-1,2,1,0,11,13,-2,0-4,0,4,0,31,30,1,Dallas Cowboys,17
2006-10-01,Detroit Lions,Los Angeles Rams,34,41,2006,4,domingo,Regular Season,0-4,0,4,0,30,29,1,3-1,3,1,0,16,17,-1,Los Angeles Rams,12
2006-10-01,Cleveland Browns,Oakland Raiders,24,21,2006,4,domingo,Regular Season,1-3,1,3,0,24,28,-4,0-3,0,3,0,32,32,0,Cleveland Browns,4
2006-10-01,Indianapolis Colts,New York Jets,31,28,2006,4,domingo,Regular Season,4-0,4,0,0,2,1,1,2-2,2,2,0,19,19,0,Indianapolis Colts,18
2006-10-01,San Francisco 49ers,Kansas City Chiefs,0,41,2006,4,domingo,Regular Season,1-3,1,3,0,29,25,4,1-2,1,2,0,22,24,-2,Kansas City Chiefs,1
2006-10-01,Miami Dolphins,Houston Texans,15,17,2006,4,domingo,Regular Season,1-3,1,3,0,23,21,2,1-3,1,3,0,25,31,-6,Houston Texans,10
2006-10-01,New England Patriots,Cincinnati Bengals,38,13,2006,4,domingo,Regular Season,3-1,3,1,0,5,11,-6,3-1,3,1,0,7,2,5,New England Patriots,9
2006-10-01,Seattle Seahawks,Chicago Bears,6,37,2006,4,domingo,Regular Season,3-1,3,1,0,6,3,3,4-0,4,0,0,1,4,-3,Chicago Bears,1
2006-10-01,New Orleans Saints,Carolina Panthers,18,21,2006,4,domingo,Regular Season,3-1,3,1,0,15,14,1,2-2,2,2,0,14,18,-4,Carolina Panthers,4
2006-10-01,Minnesota Vikings,Buffalo Bills,12,17,2006,4,domingo,Regular Season,2-2,2,2,0,20,15,5,2-2,2,2,0,21,23,-2,Buffalo Bills,8
2006-10-01,Los Angeles Chargers,Baltimore Ravens,13,16,2006,4,domingo,Regular Season,2-1,2,1,0,9,5,4,4-0,4,0,0,3,6,-3,Baltimore Ravens,1
2006-10-01,Arizona Cardinals,Atlanta Falcons,10,32,2006,4,domingo,Regular Season,1-3,1,3,0,26,22,4,3-1,3,1,0,10,9,1,Atlanta Falcons,13
2006-09-25,Atlanta Falcons,New Orleans Saints,3,23,2006,3,segunda,Regular Season,2-1,2,1,0,9,5,4,3-0,3,0,0,14,17,-3,New Orleans Saints,12
2006-09-24,Carolina Panthers,Tampa Bay Buccaneers,26,24,2006,3,domingo,Regular Season,1-2,1,2,0,18,16,2,0-3,0,3,0,27,23,4,Carolina Panthers,7
2006-09-24,New York Giants,Seattle Seahawks,30,42,2006,3,domingo,Regular Season,1-2,1,2,0,16,11,5,3-0,3,0,0,3,2,1,Seattle Seahawks,9
2006-09-24,Philadelphia Eagles,San Francisco 49ers,38,24,2006,3,domingo,Regular Season,2-1,2,1,0,10,15,-5,1-2,1,2,0,25,25,0,Philadelphia Eagles,10
2006-09-24,Cincinnati Bengals,Pittsburgh Steelers,28,20,2006,3,domingo,Regular Season,3-0,3,0,0,2,3,-1,1-2,1,2,0,12,9,3,Cincinnati Bengals,6
2006-09-24,Denver Broncos,New England Patriots,17,7,2006,3,domingo,Regular Season,2-1,2,1,0,8,12,-4,2-1,2,1,0,11,10,1,Denver Broncos,2
2006-09-24,Chicago Bears,Minnesota Vikings,19,16,2006,3,domingo,Regular Season,3-0,3,0,0,4,6,-2,2-1,2,1,0,15,14,1,Chicago Bears,8
2006-09-24,Tennessee Titans,Miami Dolphins,10,13,2006,3,domingo,Regular Season,0-3,0,3,0,30,31,-1,1-2,1,2,0,21,21,0,Miami Dolphins,10
2006-09-24,Jacksonville Jaguars,Indianapolis Colts,14,21,2006,3,domingo,Regular Season,2-1,2,1,0,7,4,3,3-0,3,0,0,1,1,0,Indianapolis Colts,3
2006-09-24,Washington Redskins,Houston Texans,31,15,2006,3,domingo,Regular Season,1-2,1,2,0,20,24,-4,0-3,0,3,0,31,29,2,Washington Redskins,5
2006-09-24,Green Bay Packers,Detroit Lions,31,24,2006,3,domingo,Regular Season,1-2,1,2,0,26,30,-4,0-3,0,3,0,29,27,2,Green Bay Packers,3
2006-09-24,Baltimore Ravens,Cleveland Browns,15,14,2006,3,domingo,Regular Season,3-0,3,0,0,6,8,-2,0-3,0,3,0,28,28,0,Baltimore Ravens,20
2006-09-24,New York Jets,Buffalo Bills,28,20,2006,3,domingo,Regular Season,2-1,2,1,0,19,22,-3,1-2,1,2,0,23,20,3,New York Jets,2
2006-09-24,Los Angeles Rams,Arizona Cardinals,16,14,2006,3,domingo,Regular Season,2-1,2,1,0,17,18,-1,1-2,1,2,0,22,19,3,Los Angeles Rams,1
2006-09-18,Pittsburgh Steelers,Jacksonville Jaguars,0,9,2006,2,segunda,Regular Season,1-1,1,1,0,9,1,8,2-0,2,0,0,4,5,-1,Jacksonville Jaguars,4
2006-09-17,Arizona Cardinals,Seattle Seahawks,10,21,2006,2,domingo,Regular Season,1-1,1,1,0,19,19,0,2-0,2,0,0,2,3,-1,Seattle Seahawks,16
2006-09-17,Los Angeles Rams,San Francisco 49ers,13,20,2006,2,domingo,Regular Season,1-1,1,1,0,18,18,0,1-1,1,1,0,25,30,-5,San Francisco 49ers,12
2006-09-17,Tennessee Titans,Los Angeles Chargers,7,40,2006,2,domingo,Regular Season,0-2,0,2,0,31,29,2,2-0,2,0,0,7,9,-2,Los Angeles Chargers,20
2006-09-17,New York Giants,Philadelphia Eagles,30,24,2006,2,domingo,Regular Season,1-1,1,1,0,11,14,-3,1-1,1,1,0,15,11,4,New York Giants,3
2006-09-17,New England Patriots,New York Jets,24,17,2006,2,domingo,Regular Season,2-0,2,0,0,10,10,0,1-1,1,1,0,22,23,-1,New England Patriots,13
2006-09-17,Carolina Panthers,Minnesota Vikings,13,16,2006,2,domingo,Regular Season,0-2,0,2,0,16,12,4,2-0,2,0,0,14,17,-3,Minnesota Vikings,5
2006-09-17,Buffalo Bills,Miami Dolphins,16,6,2006,2,domingo,Regular Season,1-1,1,1,0,20,26,-6,0-2,0,2,0,21,16,5,Buffalo Bills,10
2006-09-17,Houston Texans,Indianapolis Colts,24,43,2006,2,domingo,Regular Season,0-2,0,2,0,29,27,2,2-0,2,0,0,1,2,-1,Indianapolis Colts,25
2006-09-17,New Orleans Saints,Green Bay Packers,34,27,2006,2,domingo,Regular Season,2-0,2,0,0,17,24,-7,0-2,0,2,0,30,32,-2,New Orleans Saints,8
2006-09-17,Kansas City Chiefs,Denver Broncos,6,9,2006,2,domingo,Regular Season,0-2,0,2,0,26,22,4,1-1,1,1,0,12,13,-1,Denver Broncos,9
2006-09-17,Washington Redskins,Dallas Cowboys,10,27,2006,2,domingo,Regular Season,0-2,0,2,0,24,20,4,1-1,1,1,0,13,15,-2,Dallas Cowboys,5
2006-09-17,Cleveland Browns,Cincinnati Bengals,17,34,2006,2,domingo,Regular Season,0-2,0,2,0,28,28,0,2-0,2,0,0,3,4,-1,Cincinnati Bengals,24
2006-09-17,Detroit Lions,Chicago Bears,7,34,2006,2,domingo,Regular Season,0-2,0,2,0,27,25,2,2-0,2,0,0,6,8,-2,Chicago Bears,17
2006-09-17,Oakland Raiders,Baltimore Ravens,6,28,2006,2,domingo,Regular Season,0-2,0,2,0,32,31,1,2-0,2,0,0,8,6,2,Baltimore Ravens,25
2006-09-17,Tampa Bay Buccaneers,Atlanta Falcons,3,14,2006,2,domingo,Regular Season,0-2,0,2,0,23,21,2,2-0,2,0,0,5,7,-2,Atlanta Falcons,14
2006-09-11,Minnesota Vikings,Washington Redskins,19,16,2006,1,segunda,Regular Season,1-0,1,0,0,17,19,-2,0-1,0,1,0,20,14,6,Minnesota Vikings,5
2006-09-11,Los Angeles Chargers,Oakland Raiders,27,0,2006,1,segunda,Regular Season,1-0,1,0,0,9,16,-7,0-1,0,1,0,31,25,6,Los Angeles Chargers,9
2006-09-10,New York Jets,Tennessee Titans,23,16,2006,1,domingo,Regular Season,1-0,1,0,0,23,31,-8,0-1,0,1,0,29,26,3,New York Jets,5
2006-09-10,Baltimore Ravens,Tampa Bay Buccaneers,27,0,2006,1,domingo,Regular Season,1-0,1,0,0,6,18,-12,0-1,0,1,0,21,12,9,Baltimore Ravens,6
2006-09-10,Denver Broncos,Los Angeles Rams,10,18,2006,1,domingo,Regular Season,0-1,0,1,0,13,5,8,1-0,1,0,0,18,22,-4,Los Angeles Rams,17
2006-09-10,Indianapolis Colts,New York Giants,26,21,2006,1,domingo,Regular Season,1-0,1,0,0,2,4,-2,0-1,0,1,0,14,10,4,Indianapolis Colts,6
2006-09-10,Buffalo Bills,New England Patriots,17,19,2006,1,domingo,Regular Season,0-1,0,1,0,26,30,-4,1-0,1,0,0,10,7,3,New England Patriots,23
2006-09-10,Cincinnati Bengals,Kansas City Chiefs,23,10,2006,1,domingo,Regular Season,1-0,1,0,0,4,6,-2,0-1,0,1,0,22,20,2,Cincinnati Bengals,14
2006-09-10,Dallas Cowboys,Jacksonville Jaguars,17,24,2006,1,domingo,Regular Season,0-1,0,1,0,15,8,7,1-0,1,0,0,5,11,-6,Jacksonville Jaguars,3
2006-09-10,Philadelphia Eagles,Houston Texans,24,10,2006,1,domingo,Regular Season,1-0,1,0,0,11,15,-4,0-1,0,1,0,27,24,3,Philadelphia Eagles,9
2006-09-10,Chicago Bears,Green Bay Packers,26,0,2006,1,domingo,Regular Season,1-0,1,0,0,8,13,-5,0-1,0,1,0,32,28,4,Chicago Bears,15
2006-09-10,Seattle Seahawks,Detroit Lions,9,6,2006,1,domingo,Regular Season,1-0,1,0,0,3,1,2,0-1,0,1,0,25,23,2,Seattle Seahawks,22
2006-09-10,New Orleans Saints,Cleveland Browns,19,14,2006,1,domingo,Regular Season,1-0,1,0,0,24,29,-5,0-1,0,1,0,28,27,1,New Orleans Saints,2
2006-09-10,Atlanta Falcons,Carolina Panthers,20,6,2006,1,domingo,Regular Season,1-0,1,0,0,7,17,-10,0-1,0,1,0,12,2,10,Atlanta Falcons,15
2006-09-10,San Francisco 49ers,Arizona Cardinals,27,34,2006,1,domingo,Regular Season,0-1,0,1,0,30,32,-2,1-0,1,0,0,19,21,-2,Arizona Cardinals,11
2006-09-07,Miami Dolphins,Pittsburgh Steelers,17,28,2006,1,quinta,Regular Season,0-1,0,1,0,16,9,7,1-0,1,0,0,1,3,-2,Pittsburgh Steelers,6
