week,record,n_wins,n_loses,team,year,n_ties,rank,Previous_Rank,Rank_change
17,10-6,10,6,New York Giants,2010,0,12,12,0
16,9-6,9,6,New York Giants,2010,0,12,9,3
15,9-5,9,5,New York Giants,2010,0,9,7,2
14,9-4,9,4,New York Giants,2010,0,7,10,-3
13,8-4,8,4,New York Giants,2010,0,10,10,0
12,7-4,7,4,New York Giants,2010,0,10,10,0
11,6-4,6,4,New York Giants,2010,0,10,8,2
10,6-3,6,3,New York Giants,2010,0,8,4,4
9,6-2,6,2,New York Giants,2010,0,4,7,-3
8,5-2,5,2,New York Giants,2010,0,7,9,-2
7,5-2,5,2,New York Giants,2010,0,9,11,-2
6,4-2,4,2,New York Giants,2010,0,11,15,-4
5,3-2,3,2,New York Giants,2010,0,15,20,-5
4,2-2,2,2,New York Giants,2010,0,20,24,-4
3,1-2,1,2,New York Giants,2010,0,24,19,5
2,1-1,1,1,New York Giants,2010,0,19,16,3
1,1-0,1,0,New York Giants,2010,0,16,19,-3
0,8-8,8,8,New York Giants,2010,0,19,0,19
17,9-7,9,7,New York Giants,2012,0,14,15,-1
16,8-7,8,7,New York Giants,2012,0,15,12,3
15,8-6,8,6,New York Giants,2012,0,12,7,5
14,8-5,8,5,New York Giants,2012,0,7,10,-3
13,7-5,7,5,New York Giants,2012,0,10,8,2
12,7-4,7,4,New York Giants,2012,0,8,9,-1
11,6-4,6,4,New York Giants,2012,0,9,10,-1
10,6-4,6,4,New York Giants,2012,0,10,5,5
9,6-3,6,3,New York Giants,2012,0,5,2,3
8,6-2,6,2,New York Giants,2012,0,2,2,0
7,5-2,5,2,New York Giants,2012,0,2,3,-1
6,4-2,4,2,New York Giants,2012,0,3,7,-4
5,3-2,3,2,New York Giants,2012,0,7,10,-3
4,2-2,2,2,New York Giants,2012,0,10,6,4
3,2-1,2,1,New York Giants,2012,0,6,8,-2
2,1-1,1,1,New York Giants,2012,0,8,7,1
1,0-1,0,1,New York Giants,2012,0,7,3,4
0,9-7,9,7,New York Giants,2012,0,3,0,3
17,9-7,9,7,New York Giants,2011,0,9,12,-3
16,8-7,8,7,New York Giants,2011,0,12,16,-4
15,7-7,7,7,New York Giants,2011,0,16,12,4
14,7-6,7,6,New York Giants,2011,0,12,16,-4
13,6-6,6,6,New York Giants,2011,0,16,14,2
12,6-5,6,5,New York Giants,2011,0,14,12,2
11,6-4,6,4,New York Giants,2011,0,12,7,5
10,6-3,6,3,New York Giants,2011,0,7,6,1
9,6-2,6,2,New York Giants,2011,0,6,9,-3
8,5-2,5,2,New York Giants,2011,0,9,11,-2
7,4-2,4,2,New York Giants,2011,0,11,11,0
6,4-2,4,2,New York Giants,2011,0,11,14,-3
5,3-2,3,2,New York Giants,2011,0,14,10,4
4,3-1,3,1,New York Giants,2011,0,10,12,-2
3,2-1,2,1,New York Giants,2011,0,12,18,-6
2,1-1,1,1,New York Giants,2011,0,18,17,1
1,0-1,0,1,New York Giants,2011,0,17,15,2
0,10-6,10,6,New York Giants,2011,0,15,0,15
17,10-6,10,6,New York Giants,2007,0,9,10,-1
16,10-5,10,5,New York Giants,2007,0,10,12,-2
15,9-5,9,5,New York Giants,2007,0,12,9,3
14,9-4,9,4,New York Giants,2007,0,9,10,-1
13,8-4,8,4,New York Giants,2007,0,10,11,-1
12,7-4,7,4,New York Giants,2007,0,11,6,5
11,7-3,7,3,New York Giants,2007,0,6,7,-1
10,6-3,6,3,New York Giants,2007,0,7,6,1
9,6-2,6,2,New York Giants,2007,0,6,5,1
8,6-2,6,2,New York Giants,2007,0,5,4,1
7,5-2,5,2,New York Giants,2007,0,4,9,-5
6,4-2,4,2,New York Giants,2007,0,9,14,-5
5,3-2,3,2,New York Giants,2007,0,14,18,-4
4,2-2,2,2,New York Giants,2007,0,18,23,-5
3,1-2,1,2,New York Giants,2007,0,23,27,-4
2,0-2,0,2,New York Giants,2007,0,27,22,5
1,0-1,0,1,New York Giants,2007,0,22,18,4
0,8-8,8,8,New York Giants,2007,0,18,0,18
17,8-8,8,8,New York Giants,2006,0,16,20,-4
16,7-8,7,8,New York Giants,2006,0,20,17,3
15,7-7,7,7,New York Giants,2006,0,17,11,6
14,7-6,7,6,New York Giants,2006,0,11,15,-4
13,6-6,6,6,New York Giants,2006,0,15,15,0
12,6-5,6,5,New York Giants,2006,0,15,14,1
11,6-4,6,4,New York Giants,2006,0,14,8,6
10,6-3,6,3,New York Giants,2006,0,8,6,2
9,6-2,6,2,New York Giants,2006,0,6,4,2
8,5-2,5,2,New York Giants,2006,0,4,6,-2
7,4-2,4,2,New York Giants,2006,0,6,11,-5
6,3-2,3,2,New York Giants,2006,0,11,16,-5
5,2-2,2,2,New York Giants,2006,0,16,18,-2
4,1-2,1,2,New York Giants,2006,0,18,16,2
3,1-2,1,2,New York Giants,2006,0,16,11,5
2,1-1,1,1,New York Giants,2006,0,11,14,-3
1,0-1,0,1,New York Giants,2006,0,14,10,4
0,11-5,11,5,New York Giants,2006,0,10,0,10
17,7-9,7,9,New York Giants,2013,0,23,24,-1
16,6-9,6,9,New York Giants,2013,0,24,26,-2
15,5-9,5,9,New York Giants,2013,0,26,23,3
14,5-8,5,8,New York Giants,2013,0,23,22,1
13,5-7,5,7,New York Giants,2013,0,22,23,-1
12,4-7,4,7,New York Giants,2013,0,23,22,1
11,4-6,4,6,New York Giants,2013,0,22,25,-3
10,3-6,3,6,New York Giants,2013,0,25,29,-4
9,2-6,2,6,New York Giants,2013,0,29,29,0
8,2-6,2,6,New York Giants,2013,0,29,29,0
7,1-6,1,6,New York Giants,2013,0,29,31,-2
6,0-6,0,6,New York Giants,2013,0,31,31,0
5,0-5,0,5,New York Giants,2013,0,31,30,1
4,0-4,0,4,New York Giants,2013,0,30,29,1
3,0-3,0,3,New York Giants,2013,0,29,20,9
2,0-2,0,2,New York Giants,2013,0,20,16,4
1,0-1,0,1,New York Giants,2013,0,16,12,4
0,9-7,9,7,New York Giants,2013,0,12,0,12
17,8-8,8,8,New York Giants,2009,0,20,18,2
16,8-7,8,7,New York Giants,2009,0,18,12,6
15,8-6,8,6,New York Giants,2009,0,12,14,-2
14,7-6,7,6,New York Giants,2009,0,14,12,2
13,7-5,7,5,New York Giants,2009,0,12,15,-3
12,6-5,6,5,New York Giants,2009,0,15,11,4
11,6-4,6,4,New York Giants,2009,0,11,16,-5
10,5-4,5,4,New York Giants,2009,0,16,15,1
9,5-4,5,4,New York Giants,2009,0,15,15,0
8,5-3,5,3,New York Giants,2009,0,15,8,7
7,5-2,5,2,New York Giants,2009,0,8,5,3
6,5-1,5,1,New York Giants,2009,0,5,2,3
5,5-0,5,0,New York Giants,2009,0,2,2,0
4,4-0,4,0,New York Giants,2009,0,2,3,-1
3,3-0,3,0,New York Giants,2009,0,3,2,1
17,12-4,12,4,New York Giants,2008,0,2,2,0
16,12-3,12,3,New York Giants,2008,0,2,4,-2
15,11-3,11,3,New York Giants,2008,0,4,2,2
14,11-2,11,2,New York Giants,2008,0,2,1,1
13,11-1,11,1,New York Giants,2008,0,1,1,0
12,10-1,10,1,New York Giants,2008,0,1,2,-1
11,9-1,9,1,New York Giants,2008,0,2,2,0
10,8-1,8,1,New York Giants,2008,0,2,2,0
9,7-1,7,1,New York Giants,2008,0,2,2,0
8,6-1,6,1,New York Giants,2008,0,2,2,0
7,5-1,5,1,New York Giants,2008,0,2,2,0
6,4-1,4,1,New York Giants,2008,0,2,1,1
5,4-0,4,0,New York Giants,2008,0,1,1,0
4,3-0,3,0,New York Giants,2008,0,1,2,-1
3,3-0,3,0,New York Giants,2008,0,2,3,-1
2,2-0,2,0,New York Giants,2008,0,3,5,-2
1,1-0,1,0,New York Giants,2008,0,5,8,-3
0,10-6,10,6,New York Giants,2008,0,8,0,8
2,2-0,2,0,New York Giants,2009,0,2,3,-1
1,1-0,1,0,New York Giants,2009,0,3,3,0
0,12-4,12,4,New York Giants,2009,0,3,0,3
17,6-10,6,10,New York Giants,2014,0,24,22,2
16,6-9,6,9,New York Giants,2014,0,22,25,-3
15,5-9,5,9,New York Giants,2014,0,25,26,-1
14,4-9,4,9,New York Giants,2014,0,26,26,0
13,3-9,3,9,New York Giants,2014,0,26,26,0
12,3-8,3,8,New York Giants,2014,0,26,26,0
11,3-7,3,7,New York Giants,2014,0,26,24,2
10,3-6,3,6,New York Giants,2014,0,24,24,0
9,3-5,3,5,New York Giants,2014,0,24,22,2
8,3-4,3,4,New York Giants,2014,0,22,21,1
7,3-4,3,4,New York Giants,2014,0,21,20,1
6,3-3,3,3,New York Giants,2014,0,20,13,7
5,3-2,3,2,New York Giants,2014,0,13,19,-6
4,2-2,2,2,New York Giants,2014,0,19,26,-7
3,1-2,1,2,New York Giants,2014,0,26,30,-4
2,0-2,0,2,New York Giants,2014,0,30,26,4
1,0-1,0,1,New York Giants,2014,0,26,20,6
0,7-9,7,9,New York Giants,2014,0,20,0,20
17,10-6,10,6,New York Jets,2006,0,8,10,-2
16,9-6,9,6,New York Jets,2006,0,10,11,-1
15,8-6,8,6,New York Jets,2006,0,11,16,-5
14,7-6,7,6,New York Jets,2006,0,16,11,5
13,7-5,7,5,New York Jets,2006,0,11,14,-3
12,6-5,6,5,New York Jets,2006,0,14,17,-3
11,5-5,5,5,New York Jets,2006,0,17,14,3
10,5-4,5,4,New York Jets,2006,0,14,19,-5
9,4-4,4,4,New York Jets,2006,0,19,19,0
8,4-4,4,4,New York Jets,2006,0,19,20,-1
7,4-3,4,3,New York Jets,2006,0,20,19,1
6,3-3,3,3,New York Jets,2006,0,19,21,-2
5,2-3,2,3,New York Jets,2006,0,21,19,2
4,2-2,2,2,New York Jets,2006,0,19,19,0
3,2-1,2,1,New York Jets,2006,0,19,22,-3
2,1-1,1,1,New York Jets,2006,0,22,23,-1
1,1-0,1,0,New York Jets,2006,0,23,31,-8
0,4-12,4,12,New York Jets,2006,0,31,0,31
17,9-7,9,7,New York Jets,2008,0,17,14,3
16,9-6,9,6,New York Jets,2008,0,14,14,0
15,9-5,9,5,New York Jets,2008,0,14,13,1
14,8-5,8,5,New York Jets,2008,0,13,7,6
13,8-4,8,4,New York Jets,2008,0,7,3,4
12,8-3,8,3,New York Jets,2008,0,3,6,-3
11,7-3,7,3,New York Jets,2008,0,6,9,-3
10,6-3,6,3,New York Jets,2008,0,9,11,-2
9,5-3,5,3,New York Jets,2008,0,11,19,-8
8,4-3,4,3,New York Jets,2008,0,19,19,0
7,3-3,3,3,New York Jets,2008,0,19,16,3
6,3-2,3,2,New York Jets,2008,0,16,18,-2
5,2-2,2,2,New York Jets,2008,0,18,19,-1
4,2-2,2,2,New York Jets,2008,0,19,21,-2
3,1-2,1,2,New York Jets,2008,0,21,16,5
2,1-1,1,1,New York Jets,2008,0,16,14,2
1,1-0,1,0,New York Jets,2008,0,14,16,-2
0,4-12,4,12,New York Jets,2008,0,16,0,16
17,4-12,4,12,New York Jets,2007,0,30,30,0
16,3-12,3,12,New York Jets,2007,0,30,30,0
15,3-11,3,11,New York Jets,2007,0,30,29,1
14,3-10,3,10,New York Jets,2007,0,29,29,0
13,3-9,3,9,New York Jets,2007,0,29,31,-2
12,2-9,2,9,New York Jets,2007,0,31,29,2
11,2-8,2,8,New York Jets,2007,0,29,31,-2
10,1-8,1,8,New York Jets,2007,0,31,30,1
9,1-8,1,8,New York Jets,2007,0,30,30,0
8,1-7,1,7,New York Jets,2007,0,30,30,0
7,1-6,1,6,New York Jets,2007,0,30,30,0
6,1-5,1,5,New York Jets,2007,0,30,28,2
5,1-4,1,4,New York Jets,2007,0,28,26,2
4,1-3,1,3,New York Jets,2007,0,26,21,5
3,1-2,1,2,New York Jets,2007,0,21,24,-3
2,0-2,0,2,New York Jets,2007,0,24,18,6
1,0-1,0,1,New York Jets,2007,0,18,14,4
0,10-6,10,6,New York Jets,2007,0,14,0,14
17,9-7,9,7,New York Jets,2009,0,12,14,-2
16,8-7,8,7,New York Jets,2009,0,14,19,-5
15,7-7,7,7,New York Jets,2009,0,19,16,3
14,7-6,7,6,New York Jets,2009,0,16,19,-3
13,6-6,6,6,New York Jets,2009,0,19,21,-2
12,5-6,5,6,New York Jets,2009,0,21,22,-1
11,4-6,4,6,New York Jets,2009,0,22,21,1
10,4-5,4,5,New York Jets,2009,0,21,18,3
9,4-4,4,4,New York Jets,2009,0,18,18,0
8,4-4,4,4,New York Jets,2009,0,18,15,3
7,4-3,4,3,New York Jets,2009,0,15,18,-3
6,3-3,3,3,New York Jets,2009,0,18,9,9
5,3-2,3,2,New York Jets,2009,0,9,5,4
4,3-1,3,1,New York Jets,2009,0,5,6,-1
3,3-0,3,0,New York Jets,2009,0,6,8,-2
2,2-0,2,0,New York Jets,2009,0,8,16,-8
1,1-0,1,0,New York Jets,2009,0,16,23,-7
0,9-7,9,7,New York Jets,2009,0,23,0,23
17,11-5,11,5,New York Jets,2010,0,8,8,0
16,10-5,10,5,New York Jets,2010,0,8,5,3
15,10-4,10,4,New York Jets,2010,0,5,9,-4
14,9-4,9,4,New York Jets,2010,0,9,6,3
13,9-3,9,3,New York Jets,2010,0,6,3,3
12,9-2,9,2,New York Jets,2010,0,3,4,-1
11,8-2,8,2,New York Jets,2010,0,4,3,1
10,7-2,7,2,New York Jets,2010,0,3,5,-2
9,6-2,6,2,New York Jets,2010,0,5,4,1
8,5-2,5,2,New York Jets,2010,0,4,2,2
7,5-1,5,1,New York Jets,2010,0,2,2,0
6,5-1,5,1,New York Jets,2010,0,2,3,-1
5,4-1,4,1,New York Jets,2010,0,3,4,-1
4,3-1,3,1,New York Jets,2010,0,4,7,-3
3,2-1,2,1,New York Jets,2010,0,7,6,1
2,1-1,1,1,New York Jets,2010,0,6,11,-5
1,0-1,0,1,New York Jets,2010,0,11,9,2
0,9-7,9,7,New York Jets,2010,0,9,0,9
17,6-10,6,10,New York Giants,2015,0,23,21,2
16,6-9,6,9,New York Giants,2015,0,21,15,6
15,6-8,6,8,New York Giants,2015,0,15,17,-2
14,6-7,6,7,New York Giants,2015,0,17,20,-3
13,5-7,5,7,New York Giants,2015,0,20,18,2
12,5-6,5,6,New York Giants,2015,0,18,15,3
11,5-5,5,5,New York Giants,2015,0,15,10,5
10,5-5,5,5,New York Giants,2015,0,10,15,-5
9,5-4,5,4,New York Giants,2015,0,15,14,1
8,4-4,4,4,New York Giants,2015,0,14,14,0
7,4-3,4,3,New York Giants,2015,0,14,14,0
6,3-3,3,3,New York Giants,2015,0,14,12,2
5,3-2,3,2,New York Giants,2015,0,12,15,-3
4,2-2,2,2,New York Giants,2015,0,15,16,-1
3,1-2,1,2,New York Giants,2015,0,16,26,-10
2,0-2,0,2,New York Giants,2015,0,26,24,2
1,0-1,0,1,New York Giants,2015,0,24,21,3
0,6-10,6,10,New York Giants,2015,0,21,0,21
17,8-8,8,8,New York Jets,2011,0,19,16,3
16,8-7,8,7,New York Jets,2011,0,16,12,4
15,8-6,8,6,New York Jets,2011,0,12,10,2
14,8-5,8,5,New York Jets,2011,0,10,11,-1
13,7-5,7,5,New York Jets,2011,0,11,15,-4
12,6-5,6,5,New York Jets,2011,0,15,15,0
11,5-5,5,5,New York Jets,2011,0,15,14,1
10,5-4,5,4,New York Jets,2011,0,14,11,3
9,5-3,5,3,New York Jets,2011,0,11,13,-2
8,4-3,4,3,New York Jets,2011,0,13,13,0
7,4-3,4,3,New York Jets,2011,0,13,16,-3
6,3-3,3,3,New York Jets,2011,0,16,17,-1
5,2-3,2,3,New York Jets,2011,0,17,14,3
4,2-2,2,2,New York Jets,2011,0,14,7,7
3,2-1,2,1,New York Jets,2011,0,7,3,4
2,2-0,2,0,New York Jets,2011,0,3,5,-2
1,1-0,1,0,New York Jets,2011,0,5,7,-2
0,11-5,11,5,New York Jets,2011,0,7,0,7
17,6-10,6,10,New York Jets,2012,0,25,23,2
16,6-9,6,9,New York Jets,2012,0,23,21,2
15,6-8,6,8,New York Jets,2012,0,21,19,2
14,6-7,6,7,New York Jets,2012,0,19,22,-3
13,5-7,5,7,New York Jets,2012,0,22,23,-1
12,4-7,4,7,New York Jets,2012,0,23,22,1
11,4-6,4,6,New York Jets,2012,0,22,26,-4
10,3-6,3,6,New York Jets,2012,0,26,25,1
9,3-5,3,5,New York Jets,2012,0,25,25,0
8,3-5,3,5,New York Jets,2012,0,25,24,1
7,3-4,3,4,New York Jets,2012,0,24,23,1
6,3-3,3,3,New York Jets,2012,0,23,25,-2
5,2-3,2,3,New York Jets,2012,0,25,23,2
4,2-2,2,2,New York Jets,2012,0,23,17,6
3,2-1,2,1,New York Jets,2012,0,17,18,-1
2,1-1,1,1,New York Jets,2012,0,18,17,1
1,1-0,1,0,New York Jets,2012,0,17,21,-4
0,8-8,8,8,New York Jets,2012,0,21,0,21
17,8-8,8,8,New York Jets,2013,0,19,22,-3
16,7-8,7,8,New York Jets,2013,0,22,22,0
15,6-8,6,8,New York Jets,2013,0,22,21,1
14,6-7,6,7,New York Jets,2013,0,21,23,-2
13,5-7,5,7,New York Jets,2013,0,23,22,1
12,5-6,5,6,New York Jets,2013,0,22,16,6
11,5-5,5,5,New York Jets,2013,0,16,12,4
10,5-4,5,4,New York Jets,2013,0,12,14,-2
9,5-4,5,4,New York Jets,2013,0,14,16,-2
8,4-4,4,4,New York Jets,2013,0,16,15,1
7,4-3,4,3,New York Jets,2013,0,15,20,-5
6,3-3,3,3,New York Jets,2013,0,20,18,2
5,3-2,3,2,New York Jets,2013,0,18,22,-4
4,2-2,2,2,New York Jets,2013,0,22,18,4
3,2-1,2,1,New York Jets,2013,0,18,28,-10
2,1-1,1,1,New York Jets,2013,0,28,27,1
1,1-0,1,0,New York Jets,2013,0,27,32,-5
0,6-10,6,10,New York Jets,2013,0,32,0,32
17,10-6,10,6,New York Jets,2015,0,12,5,7
16,10-5,10,5,New York Jets,2015,0,5,10,-5
15,9-5,9,5,New York Jets,2015,0,10,10,0
14,8-5,8,5,New York Jets,2015,0,10,10,0
13,7-5,7,5,New York Jets,2015,0,10,12,-2
12,6-5,6,5,New York Jets,2015,0,12,16,-4
11,5-5,5,5,New York Jets,2015,0,16,13,3
10,5-4,5,4,New York Jets,2015,0,13,11,2
9,5-3,5,3,New York Jets,2015,0,11,12,-1
8,4-3,4,3,New York Jets,2015,0,12,8,4
7,4-2,4,2,New York Jets,2015,0,8,8,0
6,4-1,4,1,New York Jets,2015,0,8,11,-3
5,3-1,3,1,New York Jets,2015,0,11,9,2
4,3-1,3,1,New York Jets,2015,0,9,15,-6
3,2-1,2,1,New York Jets,2015,0,15,9,6
2,2-0,2,0,New York Jets,2015,0,9,21,-12
1,1-0,1,0,New York Jets,2015,0,21,26,-5
0,4-12,4,12,New York Jets,2015,0,26,0,26
17,4-12,4,12,New York Jets,2014,0,27,29,-2
16,3-12,3,12,New York Jets,2014,0,29,27,2
15,3-11,3,11,New York Jets,2014,0,27,28,-1
14,2-11,2,11,New York Jets,2014,0,28,29,-1
13,2-10,2,10,New York Jets,2014,0,29,30,-1
12,2-9,2,9,New York Jets,2014,0,30,28,2
11,2-8,2,8,New York Jets,2014,0,28,28,0
10,2-8,2,8,New York Jets,2014,0,28,30,-2
9,1-8,1,8,New York Jets,2014,0,30,30,0
8,1-7,1,7,New York Jets,2014,0,30,29,1
7,1-6,1,6,New York Jets,2014,0,29,29,0
6,1-5,1,5,New York Jets,2014,0,29,30,-1
5,1-4,1,4,New York Jets,2014,0,30,26,4
4,1-3,1,3,New York Jets,2014,0,26,21,5
3,1-2,1,2,New York Jets,2014,0,21,21,0
2,1-1,1,1,New York Jets,2014,0,21,21,0
1,1-0,1,0,New York Jets,2014,0,21,21,0
0,8-8,8,8,New York Jets,2014,0,21,0,21
17,8-8,8,8,Los Angeles Rams,2006,0,18,18,0
16,7-8,7,8,Los Angeles Rams,2006,0,18,23,-5
15,6-8,6,8,Los Angeles Rams,2006,0,23,24,-1
14,5-8,5,8,Los Angeles Rams,2006,0,24,23,1
13,5-7,5,7,Los Angeles Rams,2006,0,23,17,6
12,5-6,5,6,Los Angeles Rams,2006,0,17,21,-4
11,4-6,4,6,Los Angeles Rams,2006,0,21,18,3
10,4-5,4,5,Los Angeles Rams,2006,0,18,17,1
9,4-4,4,4,Los Angeles Rams,2006,0,17,18,-1
8,4-3,4,3,Los Angeles Rams,2006,0,18,14,4
7,4-2,4,2,Los Angeles Rams,2006,0,14,14,0
6,4-2,4,2,Los Angeles Rams,2006,0,14,14,0
5,4-1,4,1,Los Angeles Rams,2006,0,14,16,-2
4,3-1,3,1,Los Angeles Rams,2006,0,16,17,-1
3,2-1,2,1,Los Angeles Rams,2006,0,17,18,-1
2,1-1,1,1,Los Angeles Rams,2006,0,18,18,0
1,1-0,1,0,Los Angeles Rams,2006,0,18,22,-4
0,6-10,6,10,Los Angeles Rams,2006,0,22,0,22
17,3-13,3,13,Los Angeles Rams,2007,0,29,29,0
16,3-12,3,12,Los Angeles Rams,2007,0,29,29,0
15,3-11,3,11,Los Angeles Rams,2007,0,29,28,1
14,3-10,3,10,Los Angeles Rams,2007,0,28,28,0
13,3-9,3,9,Los Angeles Rams,2007,0,28,29,-1
12,2-9,2,9,Los Angeles Rams,2007,0,29,28,1
11,2-8,2,8,Los Angeles Rams,2007,0,28,30,-2
10,1-8,1,8,Los Angeles Rams,2007,0,30,31,-1
9,0-8,0,8,Los Angeles Rams,2007,0,31,31,0
8,0-8,0,8,Los Angeles Rams,2007,0,31,31,0
7,0-7,0,7,Los Angeles Rams,2007,0,31,31,0
6,0-6,0,6,Los Angeles Rams,2007,0,31,31,0
5,0-5,0,5,Los Angeles Rams,2007,0,31,32,-1
4,0-4,0,4,Los Angeles Rams,2007,0,32,30,2
3,0-3,0,3,Los Angeles Rams,2007,0,30,25,5
2,0-2,0,2,Los Angeles Rams,2007,0,25,20,5
1,0-1,0,1,Los Angeles Rams,2007,0,20,17,3
0,8-8,8,8,Los Angeles Rams,2007,0,17,0,17
17,2-14,2,14,Los Angeles Rams,2008,0,31,31,0
16,2-13,2,13,Los Angeles Rams,2008,0,31,31,0
15,2-12,2,12,Los Angeles Rams,2008,0,31,30,1
14,2-11,2,11,Los Angeles Rams,2008,0,30,30,0
13,2-10,2,10,Los Angeles Rams,2008,0,30,29,1
12,2-9,2,9,Los Angeles Rams,2008,0,29,28,1
11,2-8,2,8,Los Angeles Rams,2008,0,28,28,0
10,2-7,2,7,Los Angeles Rams,2008,0,28,26,2
9,2-6,2,6,Los Angeles Rams,2008,0,26,26,0
8,2-5,2,5,Los Angeles Rams,2008,0,26,25,1
7,2-4,2,4,Los Angeles Rams,2008,0,25,28,-3
6,1-4,1,4,Los Angeles Rams,2008,0,28,32,-4
5,0-4,0,4,Los Angeles Rams,2008,0,32,32,0
4,0-4,0,4,Los Angeles Rams,2008,0,32,32,0
3,0-3,0,3,Los Angeles Rams,2008,0,32,32,0
2,0-2,0,2,Los Angeles Rams,2008,0,32,32,0
1,0-1,0,1,Los Angeles Rams,2008,0,32,28,4
0,3-13,3,13,Los Angeles Rams,2008,0,28,0,28
17,7-9,7,9,Los Angeles Rams,2010,0,17,16,1
16,7-8,7,8,Los Angeles Rams,2010,0,16,20,-4
15,6-8,6,8,Los Angeles Rams,2010,0,20,18,2
14,6-7,6,7,Los Angeles Rams,2010,0,18,17,1
13,6-6,6,6,Los Angeles Rams,2010,0,17,18,-1
12,5-6,5,6,Los Angeles Rams,2010,0,18,22,-4
11,4-6,4,6,Los Angeles Rams,2010,0,22,23,-1
10,4-5,4,5,Los Angeles Rams,2010,0,23,21,2
9,4-4,4,4,Los Angeles Rams,2010,0,21,21,0
8,4-4,4,4,Los Angeles Rams,2010,0,21,20,1
7,3-4,3,4,Los Angeles Rams,2010,0,20,21,-1
6,3-3,3,3,Los Angeles Rams,2010,0,21,26,-5
5,2-3,2,3,Los Angeles Rams,2010,0,26,24,2
4,2-2,2,2,Los Angeles Rams,2010,0,24,27,-3
3,1-2,1,2,Los Angeles Rams,2010,0,27,31,-4
2,0-2,0,2,Los Angeles Rams,2010,0,31,31,0
1,0-1,0,1,Los Angeles Rams,2010,0,31,32,-1
0,1-15,1,15,Los Angeles Rams,2010,0,32,0,32
17,2-14,2,14,Los Angeles Rams,2011,0,31,32,-1
16,2-13,2,13,Los Angeles Rams,2011,0,32,31,1
15,2-12,2,12,Los Angeles Rams,2011,0,31,31,0
14,2-11,2,11,Los Angeles Rams,2011,0,31,31,0
13,2-10,2,10,Los Angeles Rams,2011,0,31,31,0
12,2-9,2,9,Los Angeles Rams,2011,0,31,31,0
11,2-8,2,8,Los Angeles Rams,2011,0,31,30,1
10,2-7,2,7,Los Angeles Rams,2011,0,30,30,0
9,1-7,1,7,Los Angeles Rams,2011,0,30,29,1
8,1-6,1,6,Los Angeles Rams,2011,0,29,30,-1
7,0-6,0,6,Los Angeles Rams,2011,0,30,31,-1
6,0-5,0,5,Los Angeles Rams,2011,0,31,31,0
5,0-4,0,4,Los Angeles Rams,2011,0,31,32,-1
4,0-4,0,4,Los Angeles Rams,2011,0,32,31,1
3,0-3,0,3,Los Angeles Rams,2011,0,31,22,9
2,0-2,0,2,Los Angeles Rams,2011,0,22,20,2
1,0-1,0,1,Los Angeles Rams,2011,0,20,17,3
0,7-9,7,9,Los Angeles Rams,2011,0,17,0,17
17,1-15,1,15,Los Angeles Rams,2009,0,32,32,0
16,1-14,1,14,Los Angeles Rams,2009,0,32,32,0
15,1-13,1,13,Los Angeles Rams,2009,0,32,32,0
14,1-12,1,12,Los Angeles Rams,2009,0,32,31,1
13,1-11,1,11,Los Angeles Rams,2009,0,31,31,0
12,1-10,1,10,Los Angeles Rams,2009,0,31,31,0
11,1-9,1,9,Los Angeles Rams,2009,0,31,30,1
10,1-8,1,8,Los Angeles Rams,2009,0,30,30,0
9,1-7,1,7,Los Angeles Rams,2009,0,30,30,0
8,1-7,1,7,Los Angeles Rams,2009,0,30,32,-2
7,0-7,0,7,Los Angeles Rams,2009,0,32,32,0
6,0-6,0,6,Los Angeles Rams,2009,0,32,32,0
5,0-5,0,5,Los Angeles Rams,2009,0,32,32,0
4,0-4,0,4,Los Angeles Rams,2009,0,32,32,0
3,0-3,0,3,Los Angeles Rams,2009,0,32,32,0
2,0-2,0,2,Los Angeles Rams,2009,0,32,32,0
1,0-1,0,1,Los Angeles Rams,2009,0,32,31,1
0,2-14,2,14,Los Angeles Rams,2009,0,31,0,31
17,7-8,7,8,Los Angeles Rams,2012,0,16,16,0
16,7-7,7,7,Los Angeles Rams,2012,0,16,17,-1
15,6-7,6,7,Los Angeles Rams,2012,0,17,17,0
14,6-6,6,6,Los Angeles Rams,2012,0,17,19,-2
13,5-6,5,6,Los Angeles Rams,2012,0,19,21,-2
12,4-6,4,6,Los Angeles Rams,2012,0,21,26,-5
11,3-6,3,6,Los Angeles Rams,2012,0,26,23,3
10,3-5,3,5,Los Angeles Rams,2012,0,23,24,-1
9,3-5,3,5,Los Angeles Rams,2012,0,24,23,1
8,3-5,3,5,Los Angeles Rams,2012,0,23,21,2
7,3-4,3,4,Los Angeles Rams,2012,0,21,20,1
6,3-3,3,3,Los Angeles Rams,2012,0,20,18,2
5,3-2,3,2,Los Angeles Rams,2012,0,18,19,-1
4,2-2,2,2,Los Angeles Rams,2012,0,19,25,-6
3,1-2,1,2,Los Angeles Rams,2012,0,25,23,2
2,1-1,1,1,Los Angeles Rams,2012,0,23,27,-4
1,0-1,0,1,Los Angeles Rams,2012,0,27,28,-1
0,2-14,2,14,Los Angeles Rams,2012,0,28,0,28
17,7-9,7,9,Los Angeles Rams,2013,0,20,19,1
16,7-8,7,8,Los Angeles Rams,2013,0,19,20,-1
15,6-8,6,8,Los Angeles Rams,2013,0,20,20,0
14,5-8,5,8,Los Angeles Rams,2013,0,20,20,0
13,5-7,5,7,Los Angeles Rams,2013,0,20,19,1
12,5-6,5,6,Los Angeles Rams,2013,0,19,21,-2
11,4-6,4,6,Los Angeles Rams,2013,0,21,20,1
10,4-6,4,6,Los Angeles Rams,2013,0,20,25,-5
9,3-6,3,6,Los Angeles Rams,2013,0,25,25,0
8,3-5,3,5,Los Angeles Rams,2013,0,25,27,-2
7,3-4,3,4,Los Angeles Rams,2013,0,27,19,8
6,3-3,3,3,Los Angeles Rams,2013,0,19,25,-6
5,2-3,2,3,Los Angeles Rams,2013,0,25,26,-1
4,1-3,1,3,Los Angeles Rams,2013,0,26,20,6
3,1-2,1,2,Los Angeles Rams,2013,0,20,17,3
2,1-1,1,1,Los Angeles Rams,2013,0,17,15,2
1,1-0,1,0,Los Angeles Rams,2013,0,15,15,0
0,7-8,7,8,Los Angeles Rams,2013,0,15,0,15
17,6-10,6,10,Los Angeles Rams,2014,0,22,25,-3
16,6-9,6,9,Los Angeles Rams,2014,0,25,20,5
15,6-8,6,8,Los Angeles Rams,2014,0,20,20,0
14,6-7,6,7,Los Angeles Rams,2014,0,20,21,-1
13,5-7,5,7,Los Angeles Rams,2014,0,21,23,-2
12,4-7,4,7,Los Angeles Rams,2014,0,23,22,1
11,4-6,4,6,Los Angeles Rams,2014,0,22,25,-3
10,3-6,3,6,Los Angeles Rams,2014,0,25,25,0
9,3-5,3,5,Los Angeles Rams,2014,0,25,27,-2
8,2-5,2,5,Los Angeles Rams,2014,0,27,24,3
7,2-4,2,4,Los Angeles Rams,2014,0,24,26,-2
6,1-4,1,4,Los Angeles Rams,2014,0,26,28,-2
5,1-3,1,3,Los Angeles Rams,2014,0,28,30,-2
4,1-2,1,2,Los Angeles Rams,2014,0,30,28,2
3,1-2,1,2,Los Angeles Rams,2014,0,28,28,0
2,1-1,1,1,Los Angeles Rams,2014,0,28,32,-4
1,0-1,0,1,Los Angeles Rams,2014,0,32,24,8
0,7-9,7,9,Los Angeles Rams,2014,0,24,0,24
17,7-9,7,9,Los Angeles Rams,2015,0,22,17,5
16,7-8,7,8,Los Angeles Rams,2015,0,17,22,-5
15,6-8,6,8,Los Angeles Rams,2015,0,22,26,-4
14,5-8,5,8,Los Angeles Rams,2015,0,26,28,-2
13,4-8,4,8,Los Angeles Rams,2015,0,28,26,2
12,4-7,4,7,Los Angeles Rams,2015,0,26,22,4
11,4-6,4,6,Los Angeles Rams,2015,0,22,21,1
10,4-5,4,5,Los Angeles Rams,2015,0,21,10,11
9,4-4,4,4,Los Angeles Rams,2015,0,10,10,0
8,4-3,4,3,Los Angeles Rams,2015,0,10,12,-2
7,3-3,3,3,Los Angeles Rams,2015,0,12,18,-6
6,2-3,2,3,Los Angeles Rams,2015,0,18,17,1
5,2-3,2,3,Los Angeles Rams,2015,0,17,11,6
4,2-2,2,2,Los Angeles Rams,2015,0,11,19,-8
3,1-2,1,2,Los Angeles Rams,2015,0,19,19,0
2,1-1,1,1,Los Angeles Rams,2015,0,19,14,5
1,1-0,1,0,Los Angeles Rams,2015,0,14,22,-8
0,6-10,6,10,Los Angeles Rams,2015,0,22,0,22
17,8-8,8,8,Los Angeles Chargers,2008,0,12,16,-4
16,7-8,7,8,Los Angeles Chargers,2008,0,16,21,-5
15,6-8,6,8,Los Angeles Chargers,2008,0,21,21,0
14,5-8,5,8,Los Angeles Chargers,2008,0,21,23,-2
13,4-8,4,8,Los Angeles Chargers,2008,0,23,22,1
12,4-7,4,7,Los Angeles Chargers,2008,0,22,22,0
11,4-6,4,6,Los Angeles Chargers,2008,0,22,20,2
10,4-5,4,5,Los Angeles Chargers,2008,0,20,21,-1
9,3-5,3,5,Los Angeles Chargers,2008,0,21,21,0
8,3-5,3,5,Los Angeles Chargers,2008,0,21,17,4
7,3-4,3,4,Los Angeles Chargers,2008,0,17,11,6
6,3-3,3,3,Los Angeles Chargers,2008,0,11,16,-5
5,2-3,2,3,Los Angeles Chargers,2008,0,16,8,8
4,2-2,2,2,Los Angeles Chargers,2008,0,8,9,-1
3,1-2,1,2,Los Angeles Chargers,2008,0,9,13,-4
2,0-2,0,2,Los Angeles Chargers,2008,0,13,3,10
1,0-1,0,1,Los Angeles Chargers,2008,0,3,2,1
0,11-5,11,5,Los Angeles Chargers,2008,0,2,0,2
17,14-2,14,2,Los Angeles Chargers,2006,0,1,1,0
16,13-2,13,2,Los Angeles Chargers,2006,0,1,1,0
15,12-2,12,2,Los Angeles Chargers,2006,0,1,1,0
14,11-2,11,2,Los Angeles Chargers,2006,0,1,1,0
13,10-2,10,2,Los Angeles Chargers,2006,0,1,2,-1
12,9-2,9,2,Los Angeles Chargers,2006,0,2,1,1
11,8-2,8,2,Los Angeles Chargers,2006,0,1,3,-2
10,7-2,7,2,Los Angeles Chargers,2006,0,3,5,-2
9,6-2,6,2,Los Angeles Chargers,2006,0,5,5,0
8,5-2,5,2,Los Angeles Chargers,2006,0,5,8,-3
7,4-2,4,2,Los Angeles Chargers,2006,0,8,3,5
6,4-1,4,1,Los Angeles Chargers,2006,0,3,5,-2
5,3-1,3,1,Los Angeles Chargers,2006,0,5,9,-4
4,2-1,2,1,Los Angeles Chargers,2006,0,9,5,4
3,2-0,2,0,Los Angeles Chargers,2006,0,5,7,-2
2,2-0,2,0,Los Angeles Chargers,2006,0,7,9,-2
1,1-0,1,0,Los Angeles Chargers,2006,0,9,16,-7
0,9-7,9,7,Los Angeles Chargers,2006,0,16,0,16
17,13-3,13,3,Los Angeles Chargers,2009,0,2,2,0
16,12-3,12,3,Los Angeles Chargers,2009,0,2,3,-1
15,11-3,11,3,Los Angeles Chargers,2009,0,3,4,-1
14,10-3,10,3,Los Angeles Chargers,2009,0,4,4,0
13,9-3,9,3,Los Angeles Chargers,2009,0,4,4,0
12,8-3,8,3,Los Angeles Chargers,2009,0,4,6,-2
11,7-3,7,3,Los Angeles Chargers,2009,0,6,8,-2
10,6-3,6,3,Los Angeles Chargers,2009,0,8,12,-4
9,5-3,5,3,Los Angeles Chargers,2009,0,12,16,-4
8,4-3,4,3,Los Angeles Chargers,2009,0,16,16,0
7,3-3,3,3,Los Angeles Chargers,2009,0,16,14,2
6,2-3,2,3,Los Angeles Chargers,2009,0,14,16,-2
5,2-2,2,2,Los Angeles Chargers,2009,0,16,16,0
4,2-2,2,2,Los Angeles Chargers,2009,0,16,12,4
3,2-1,2,1,Los Angeles Chargers,2009,0,12,11,1
2,1-1,1,1,Los Angeles Chargers,2009,0,11,6,5
1,1-0,1,0,Los Angeles Chargers,2009,0,6,5,1
0,8-8,8,8,Los Angeles Chargers,2009,0,5,0,5
17,11-5,11,5,Los Angeles Chargers,2007,0,6,6,0
16,10-5,10,5,Los Angeles Chargers,2007,0,6,6,0
15,9-5,9,5,Los Angeles Chargers,2007,0,6,7,-1
14,8-5,8,5,Los Angeles Chargers,2007,0,7,9,-2
13,7-5,7,5,Los Angeles Chargers,2007,0,9,10,-1
12,6-5,6,5,Los Angeles Chargers,2007,0,10,13,-3
11,5-5,5,5,Los Angeles Chargers,2007,0,13,9,4
10,5-4,5,4,Los Angeles Chargers,2007,0,9,14,-5
9,4-4,4,4,Los Angeles Chargers,2007,0,14,7,7
8,4-3,4,3,Los Angeles Chargers,2007,0,7,9,-2
7,3-3,3,3,Los Angeles Chargers,2007,0,9,10,-1
6,3-3,3,3,Los Angeles Chargers,2007,0,10,12,-2
5,2-3,2,3,Los Angeles Chargers,2007,0,12,16,-4
4,1-3,1,3,Los Angeles Chargers,2007,0,16,9,7
3,1-2,1,2,Los Angeles Chargers,2007,0,9,4,5
2,1-1,1,1,Los Angeles Chargers,2007,0,4,3,1
1,1-0,1,0,Los Angeles Chargers,2007,0,3,3,0
0,14-2,14,2,Los Angeles Chargers,2007,0,3,0,3
17,9-7,9,7,Los Angeles Chargers,2010,0,14,14,0
16,8-7,8,7,Los Angeles Chargers,2010,0,14,10,4
15,8-6,8,6,Los Angeles Chargers,2010,0,10,12,-2
14,7-6,7,6,Los Angeles Chargers,2010,0,12,14,-2
13,6-6,6,6,Los Angeles Chargers,2010,0,14,11,3
12,6-5,6,5,Los Angeles Chargers,2010,0,11,14,-3
11,5-5,5,5,Los Angeles Chargers,2010,0,14,16,-2
10,4-5,4,5,Los Angeles Chargers,2010,0,16,16,0
9,4-5,4,5,Los Angeles Chargers,2010,0,16,22,-6
8,3-5,3,5,Los Angeles Chargers,2010,0,22,24,-2
7,2-5,2,5,Los Angeles Chargers,2010,0,24,24,0
6,2-4,2,4,Los Angeles Chargers,2010,0,24,21,3
5,2-3,2,3,Los Angeles Chargers,2010,0,21,12,9
4,2-2,2,2,Los Angeles Chargers,2010,0,12,18,-6
3,1-2,1,2,Los Angeles Chargers,2010,0,18,13,5
2,1-1,1,1,Los Angeles Chargers,2010,0,13,12,1
1,0-1,0,1,Los Angeles Chargers,2010,0,12,8,4
0,13-3,13,3,Los Angeles Chargers,2010,0,8,0,8
17,8-8,8,8,Los Angeles Chargers,2011,0,16,19,-3
16,7-8,7,8,Los Angeles Chargers,2011,0,19,14,5
15,7-7,7,7,Los Angeles Chargers,2011,0,14,18,-4
14,6-7,6,7,Los Angeles Chargers,2011,0,18,21,-3
13,5-7,5,7,Los Angeles Chargers,2011,0,21,22,-1
12,4-7,4,7,Los Angeles Chargers,2011,0,22,21,1
11,4-6,4,6,Los Angeles Chargers,2011,0,21,18,3
10,4-5,4,5,Los Angeles Chargers,2011,0,18,17,1
9,4-4,4,4,Los Angeles Chargers,2011,0,17,15,2
8,4-3,4,3,Los Angeles Chargers,2011,0,15,9,6
7,4-2,4,2,Los Angeles Chargers,2011,0,9,7,2
6,4-1,4,1,Los Angeles Chargers,2011,0,7,7,0
5,4-1,4,1,Los Angeles Chargers,2011,0,7,7,0
4,3-1,3,1,Los Angeles Chargers,2011,0,7,9,-2
3,2-1,2,1,Los Angeles Chargers,2011,0,9,12,-3
2,1-1,1,1,Los Angeles Chargers,2011,0,12,9,3
1,1-0,1,0,Los Angeles Chargers,2011,0,9,10,-1
0,9-7,9,7,Los Angeles Chargers,2011,0,10,0,10
17,9-7,9,7,Los Angeles Chargers,2013,0,12,12,0
16,8-7,8,7,Los Angeles Chargers,2013,0,12,15,-3
15,7-7,7,7,Los Angeles Chargers,2013,0,15,17,-2
14,6-7,6,7,Los Angeles Chargers,2013,0,17,16,1
13,5-7,5,7,Los Angeles Chargers,2013,0,16,15,1
12,5-6,5,6,Los Angeles Chargers,2013,0,15,18,-3
11,4-6,4,6,Los Angeles Chargers,2013,0,18,17,1
10,4-5,4,5,Los Angeles Chargers,2013,0,17,15,2
9,4-4,4,4,Los Angeles Chargers,2013,0,15,11,4
8,4-3,4,3,Los Angeles Chargers,2013,0,11,12,-1
7,4-3,4,3,Los Angeles Chargers,2013,0,12,15,-3
6,3-3,3,3,Los Angeles Chargers,2013,0,15,20,-5
5,2-3,2,3,Los Angeles Chargers,2013,0,20,17,3
4,2-2,2,2,Los Angeles Chargers,2013,0,17,19,-2
3,1-2,1,2,Los Angeles Chargers,2013,0,19,16,3
2,1-1,1,1,Los Angeles Chargers,2013,0,16,26,-10
1,0-1,0,1,Los Angeles Chargers,2013,0,26,24,2
0,7-9,7,9,Los Angeles Chargers,2013,0,24,0,24
17,9-7,9,7,Los Angeles Chargers,2014,0,16,11,5
16,9-6,9,6,Los Angeles Chargers,2014,0,11,14,-3
15,8-6,8,6,Los Angeles Chargers,2014,0,14,11,3
14,8-5,8,5,Los Angeles Chargers,2014,0,11,9,2
13,8-4,8,4,Los Angeles Chargers,2014,0,9,15,-6
12,7-4,7,4,Los Angeles Chargers,2014,0,15,16,-1
11,6-4,6,4,Los Angeles Chargers,2014,0,16,15,1
10,5-4,5,4,Los Angeles Chargers,2014,0,15,17,-2
9,5-4,5,4,Los Angeles Chargers,2014,0,17,8,9
8,5-3,5,3,Los Angeles Chargers,2014,0,8,7,1
7,5-2,5,2,Los Angeles Chargers,2014,0,7,2,5
6,5-1,5,1,Los Angeles Chargers,2014,0,2,3,-1
5,4-1,4,1,Los Angeles Chargers,2014,0,3,5,-2
4,3-1,3,1,Los Angeles Chargers,2014,0,5,6,-1
3,2-1,2,1,Los Angeles Chargers,2014,0,6,10,-4
2,1-1,1,1,Los Angeles Chargers,2014,0,10,16,-6
1,0-1,0,1,Los Angeles Chargers,2014,0,16,11,5
0,9-7,9,7,Los Angeles Chargers,2014,0,11,0,11
17,4-12,4,12,Los Angeles Chargers,2015,0,28,28,0
16,4-11,4,11,Los Angeles Chargers,2015,0,28,27,1
15,4-10,4,10,Los Angeles Chargers,2015,0,27,28,-1
14,3-10,3,10,Los Angeles Chargers,2015,0,28,31,-3
13,3-9,3,9,Los Angeles Chargers,2015,0,31,27,4
12,3-8,3,8,Los Angeles Chargers,2015,0,27,28,-1
11,2-8,2,8,Los Angeles Chargers,2015,0,28,28,0
10,2-7,2,7,Los Angeles Chargers,2015,0,28,22,6
9,2-7,2,7,Los Angeles Chargers,2015,0,22,19,3
8,2-6,2,6,Los Angeles Chargers,2015,0,19,21,-2
7,2-5,2,5,Los Angeles Chargers,2015,0,21,13,8
6,2-4,2,4,Los Angeles Chargers,2015,0,13,14,-1
5,2-3,2,3,Los Angeles Chargers,2015,0,14,17,-3
4,2-2,2,2,Los Angeles Chargers,2015,0,17,18,-1
3,1-2,1,2,Los Angeles Chargers,2015,0,18,13,5
2,1-1,1,1,Los Angeles Chargers,2015,0,13,10,3
1,1-0,1,0,Los Angeles Chargers,2015,0,10,13,-3
0,9-7,9,7,Los Angeles Chargers,2015,0,13,0,13
17,5-11,5,11,Arizona Cardinals,2006,0,28,27,1
16,5-10,5,10,Arizona Cardinals,2006,0,27,27,0
15,4-10,4,10,Arizona Cardinals,2006,0,27,26,1
14,4-9,4,9,Arizona Cardinals,2006,0,26,29,-3
13,3-9,3,9,Arizona Cardinals,2006,0,29,31,-2
12,2-9,2,9,Arizona Cardinals,2006,0,31,30,1
11,2-8,2,8,Arizona Cardinals,2006,0,30,32,-2
10,1-8,1,8,Arizona Cardinals,2006,0,32,32,0
9,1-7,1,7,Arizona Cardinals,2006,0,32,32,0
8,1-7,1,7,Arizona Cardinals,2006,0,32,32,0
7,1-6,1,6,Arizona Cardinals,2006,0,32,29,3
6,1-5,1,5,Arizona Cardinals,2006,0,29,27,2
5,1-4,1,4,Arizona Cardinals,2006,0,27,26,1
4,1-3,1,3,Arizona Cardinals,2006,0,26,22,4
3,1-2,1,2,Arizona Cardinals,2006,0,22,19,3
2,1-1,1,1,Arizona Cardinals,2006,0,19,19,0
1,1-0,1,0,Arizona Cardinals,2006,0,19,21,-2
0,5-11,5,11,Arizona Cardinals,2006,0,21,0,21
17,8-8,8,8,Arizona Cardinals,2007,0,17,19,-2
16,7-8,7,8,Arizona Cardinals,2007,0,19,20,-1
15,6-8,6,8,Arizona Cardinals,2007,0,20,18,2
14,6-7,6,7,Arizona Cardinals,2007,0,18,14,4
13,6-6,6,6,Arizona Cardinals,2007,0,14,19,-5
12,5-6,5,6,Arizona Cardinals,2007,0,19,16,3
11,5-5,5,5,Arizona Cardinals,2007,0,16,19,-3
10,4-5,4,5,Arizona Cardinals,2007,0,19,21,-2
9,3-5,3,5,Arizona Cardinals,2007,0,21,21,0
8,3-4,3,4,Arizona Cardinals,2007,0,21,20,1
7,3-4,3,4,Arizona Cardinals,2007,0,20,18,2
6,3-3,3,3,Arizona Cardinals,2007,0,18,13,5
5,3-2,3,2,Arizona Cardinals,2007,0,13,15,-2
4,2-2,2,2,Arizona Cardinals,2007,0,15,22,-7
3,1-2,1,2,Arizona Cardinals,2007,0,22,21,1
2,1-1,1,1,Arizona Cardinals,2007,0,21,23,-2
1,0-1,0,1,Arizona Cardinals,2007,0,23,23,0
0,5-11,5,11,Arizona Cardinals,2007,0,23,0,23
17,7-9,7,9,Los Angeles Chargers,2012,0,22,21,1
16,6-9,6,9,Los Angeles Chargers,2012,0,21,24,-3
15,5-9,5,9,Los Angeles Chargers,2012,0,24,23,1
14,5-8,5,8,Los Angeles Chargers,2012,0,23,25,-2
13,4-8,4,8,Los Angeles Chargers,2012,0,25,22,3
12,4-7,4,7,Los Angeles Chargers,2012,0,22,21,1
11,4-6,4,6,Los Angeles Chargers,2012,0,21,20,1
10,4-5,4,5,Los Angeles Chargers,2012,0,20,17,3
9,4-4,4,4,Los Angeles Chargers,2012,0,17,20,-3
8,3-4,3,4,Los Angeles Chargers,2012,0,20,17,3
7,3-3,3,3,Los Angeles Chargers,2012,0,17,16,1
6,3-3,3,3,Los Angeles Chargers,2012,0,16,14,2
5,3-2,3,2,Los Angeles Chargers,2012,0,14,11,3
4,3-1,3,1,Los Angeles Chargers,2012,0,11,13,-2
3,2-1,2,1,Los Angeles Chargers,2012,0,13,11,2
2,2-0,2,0,Los Angeles Chargers,2012,0,11,14,-3
1,1-0,1,0,Los Angeles Chargers,2012,0,14,15,-1
0,8-8,8,8,Los Angeles Chargers,2012,0,15,0,15
17,9-7,9,7,Arizona Cardinals,2008,0,13,19,-6
16,8-7,8,7,Arizona Cardinals,2008,0,19,15,4
15,8-6,8,6,Arizona Cardinals,2008,0,15,9,6
14,8-5,8,5,Arizona Cardinals,2008,0,9,12,-3
13,7-5,7,5,Arizona Cardinals,2008,0,12,11,1
12,7-4,7,4,Arizona Cardinals,2008,0,11,7,4
11,7-3,7,3,Arizona Cardinals,2008,0,7,11,-4
10,6-3,6,3,Arizona Cardinals,2008,0,11,8,3
9,5-3,5,3,Arizona Cardinals,2008,0,8,13,-5
8,4-3,4,3,Arizona Cardinals,2008,0,13,8,5
7,4-2,4,2,Arizona Cardinals,2008,0,8,9,-1
6,4-2,4,2,Arizona Cardinals,2008,0,9,14,-5
5,3-2,3,2,Arizona Cardinals,2008,0,14,20,-6
4,2-2,2,2,Arizona Cardinals,2008,0,20,18,2
3,2-1,2,1,Arizona Cardinals,2008,0,18,14,4
2,2-0,2,0,Arizona Cardinals,2008,0,14,21,-7
1,1-0,1,0,Arizona Cardinals,2008,0,21,21,0
0,8-8,8,8,Arizona Cardinals,2008,0,21,0,21
17,10-6,10,6,Arizona Cardinals,2009,0,8,6,2
16,10-5,10,5,Arizona Cardinals,2009,0,6,6,0
15,9-5,9,5,Arizona Cardinals,2009,0,6,8,-2
14,8-5,8,5,Arizona Cardinals,2009,0,8,6,2
13,8-4,8,4,Arizona Cardinals,2009,0,6,8,-2
12,7-4,7,4,Arizona Cardinals,2009,0,8,5,3
11,7-3,7,3,Arizona Cardinals,2009,0,5,7,-2
10,6-3,6,3,Arizona Cardinals,2009,0,7,10,-3
9,5-3,5,3,Arizona Cardinals,2009,0,10,13,-3
8,4-3,4,3,Arizona Cardinals,2009,0,13,10,3
7,4-2,4,2,Arizona Cardinals,2009,0,10,16,-6
6,3-2,3,2,Arizona Cardinals,2009,0,16,19,-3
5,2-2,2,2,Arizona Cardinals,2009,0,19,19,0
4,1-2,1,2,Arizona Cardinals,2009,0,19,19,0
3,1-2,1,2,Arizona Cardinals,2009,0,19,18,1
2,1-1,1,1,Arizona Cardinals,2009,0,18,17,1
1,0-1,0,1,Arizona Cardinals,2009,0,17,13,4
0,9-7,9,7,Arizona Cardinals,2009,0,13,0,13
17,5-11,5,11,Arizona Cardinals,2012,0,27,26,1
16,5-10,5,10,Arizona Cardinals,2012,0,26,27,-1
15,5-9,5,9,Arizona Cardinals,2012,0,27,29,-2
14,4-9,4,9,Arizona Cardinals,2012,0,29,27,2
13,4-8,4,8,Arizona Cardinals,2012,0,27,25,2
12,4-7,4,7,Arizona Cardinals,2012,0,25,25,0
11,4-6,4,6,Arizona Cardinals,2012,0,25,22,3
10,4-5,4,5,Arizona Cardinals,2012,0,22,20,2
9,4-5,4,5,Arizona Cardinals,2012,0,20,16,4
8,4-4,4,4,Arizona Cardinals,2012,0,16,14,2
7,4-3,4,3,Arizona Cardinals,2012,0,14,11,3
6,4-2,4,2,Arizona Cardinals,2012,0,11,9,2
5,4-1,4,1,Arizona Cardinals,2012,0,9,5,4
4,4-0,4,0,Arizona Cardinals,2012,0,5,5,0
3,3-0,3,0,Arizona Cardinals,2012,0,5,14,-9
2,2-0,2,0,Arizona Cardinals,2012,0,14,20,-6
1,1-0,1,0,Arizona Cardinals,2012,0,20,23,-3
0,8-8,8,8,Arizona Cardinals,2012,0,23,0,23
17,10-6,10,6,Arizona Cardinals,2013,0,9,9,0
16,10-5,10,5,Arizona Cardinals,2013,0,9,8,1
15,9-5,9,5,Arizona Cardinals,2013,0,8,10,-2
14,8-5,8,5,Arizona Cardinals,2013,0,10,13,-3
13,7-5,7,5,Arizona Cardinals,2013,0,13,9,4
12,7-4,7,4,Arizona Cardinals,2013,0,9,13,-4
11,6-4,6,4,Arizona Cardinals,2013,0,13,16,-3
10,5-4,5,4,Arizona Cardinals,2013,0,16,17,-1
9,4-4,4,4,Arizona Cardinals,2013,0,17,17,0
8,4-4,4,4,Arizona Cardinals,2013,0,17,24,-7
7,3-4,3,4,Arizona Cardinals,2013,0,24,21,3
6,3-3,3,3,Arizona Cardinals,2013,0,21,19,2
5,3-2,3,2,Arizona Cardinals,2013,0,19,19,0
4,2-2,2,2,Arizona Cardinals,2013,0,19,22,-3
3,1-2,1,2,Arizona Cardinals,2013,0,22,21,1
2,1-1,1,1,Arizona Cardinals,2013,0,21,25,-4
1,0-1,0,1,Arizona Cardinals,2013,0,25,26,-1
0,5-11,5,11,Arizona Cardinals,2013,0,26,0,26
17,8-8,8,8,Arizona Cardinals,2011,0,18,20,-2
16,7-8,7,8,Arizona Cardinals,2011,0,20,17,3
15,7-7,7,7,Arizona Cardinals,2011,0,17,19,-2
14,6-7,6,7,Arizona Cardinals,2011,0,19,18,1
13,5-7,5,7,Arizona Cardinals,2011,0,18,25,-7
12,4-7,4,7,Arizona Cardinals,2011,0,25,27,-2
11,3-7,3,7,Arizona Cardinals,2011,0,27,23,4
10,3-6,3,6,Arizona Cardinals,2011,0,23,29,-6
9,2-6,2,6,Arizona Cardinals,2011,0,29,30,-1
8,1-6,1,6,Arizona Cardinals,2011,0,30,29,1
7,1-5,1,5,Arizona Cardinals,2011,0,29,26,3
6,1-4,1,4,Arizona Cardinals,2011,0,26,28,-2
5,1-4,1,4,Arizona Cardinals,2011,0,28,23,5
4,1-3,1,3,Arizona Cardinals,2011,0,23,23,0
3,1-2,1,2,Arizona Cardinals,2011,0,23,19,4
2,1-1,1,1,Arizona Cardinals,2011,0,19,16,3
1,1-0,1,0,Arizona Cardinals,2011,0,16,21,-5
0,5-11,5,11,Arizona Cardinals,2011,0,21,0,21
17,5-11,5,11,Arizona Cardinals,2010,0,28,29,-1
16,5-10,5,10,Arizona Cardinals,2010,0,29,29,0
15,4-10,4,10,Arizona Cardinals,2010,0,29,27,2
14,4-9,4,9,Arizona Cardinals,2010,0,27,29,-2
13,3-9,3,9,Arizona Cardinals,2010,0,29,29,0
12,3-8,3,8,Arizona Cardinals,2010,0,29,29,0
11,3-7,3,7,Arizona Cardinals,2010,0,29,27,2
10,3-6,3,6,Arizona Cardinals,2010,0,27,25,2
9,3-5,3,5,Arizona Cardinals,2010,0,25,24,1
8,3-4,3,4,Arizona Cardinals,2010,0,24,21,3
7,3-3,3,3,Arizona Cardinals,2010,0,21,18,3
6,3-2,3,2,Arizona Cardinals,2010,0,18,24,-6
5,3-2,3,2,Arizona Cardinals,2010,0,24,25,-1
4,2-2,2,2,Arizona Cardinals,2010,0,25,22,3
3,2-1,2,1,Arizona Cardinals,2010,0,22,24,-2
2,1-1,1,1,Arizona Cardinals,2010,0,24,19,5
1,1-0,1,0,Arizona Cardinals,2010,0,19,20,-1
0,10-6,10,6,Arizona Cardinals,2010,0,20,0,20
17,13-3,13,3,Arizona Cardinals,2015,0,4,1,3
16,13-2,13,2,Arizona Cardinals,2015,0,1,2,-1
15,12-2,12,2,Arizona Cardinals,2015,0,2,2,0
14,11-2,11,2,Arizona Cardinals,2015,0,2,2,0
13,10-2,10,2,Arizona Cardinals,2015,0,2,4,-2
12,9-2,9,2,Arizona Cardinals,2015,0,4,4,0
11,8-2,8,2,Arizona Cardinals,2015,0,4,3,1
10,7-2,7,2,Arizona Cardinals,2015,0,3,6,-3
9,6-2,6,2,Arizona Cardinals,2015,0,6,6,0
8,6-2,6,2,Arizona Cardinals,2015,0,6,6,0
7,5-2,5,2,Arizona Cardinals,2015,0,6,4,2
6,4-2,4,2,Arizona Cardinals,2015,0,4,6,-2
5,4-1,4,1,Arizona Cardinals,2015,0,6,4,2
4,3-1,3,1,Arizona Cardinals,2015,0,4,2,2
3,3-0,3,0,Arizona Cardinals,2015,0,2,3,-1
2,2-0,2,0,Arizona Cardinals,2015,0,3,6,-3
1,1-0,1,0,Arizona Cardinals,2015,0,6,10,-4
0,11-5,11,5,Arizona Cardinals,2015,0,10,0,10
17,11-5,11,5,Arizona Cardinals,2014,0,10,9,1
16,11-4,11,4,Arizona Cardinals,2014,0,9,5,4
15,11-3,11,3,Arizona Cardinals,2014,0,5,5,0
14,10-3,10,3,Arizona Cardinals,2014,0,5,7,-2
13,9-3,9,3,Arizona Cardinals,2014,0,7,4,3
12,9-2,9,2,Arizona Cardinals,2014,0,4,2,2
11,9-1,9,1,Arizona Cardinals,2014,0,2,2,0
10,8-1,8,1,Arizona Cardinals,2014,0,2,2,0
9,7-1,7,1,Arizona Cardinals,2014,0,2,2,0
8,6-1,6,1,Arizona Cardinals,2014,0,2,5,-3
7,5-1,5,1,Arizona Cardinals,2014,0,5,6,-1
6,4-1,4,1,Arizona Cardinals,2014,0,6,10,-4
5,3-1,3,1,Arizona Cardinals,2014,0,10,4,6
4,3-0,3,0,Arizona Cardinals,2014,0,4,5,-1
3,3-0,3,0,Arizona Cardinals,2014,0,5,9,-4
2,2-0,2,0,Arizona Cardinals,2014,0,9,14,-5
1,1-0,1,0,Arizona Cardinals,2014,0,14,14,0
0,10-6,10,6,Arizona Cardinals,2014,0,14,0,14
17,13-3,13,3,Atlanta Falcons,2012,0,2,2,0
16,13-2,13,2,Atlanta Falcons,2012,0,2,5,-3
15,12-2,12,2,Atlanta Falcons,2012,0,5,5,0
14,11-2,11,2,Atlanta Falcons,2012,0,5,2,3
13,11-1,11,1,Atlanta Falcons,2012,0,2,2,0
12,10-1,10,1,Atlanta Falcons,2012,0,2,2,0
11,9-1,9,1,Atlanta Falcons,2012,0,2,2,0
10,8-1,8,1,Atlanta Falcons,2012,0,2,1,1
9,8-0,8,0,Atlanta Falcons,2012,0,1,1,0
8,7-0,7,0,Atlanta Falcons,2012,0,1,1,0
7,6-0,6,0,Atlanta Falcons,2012,0,1,1,0
6,6-0,6,0,Atlanta Falcons,2012,0,1,2,-1
5,5-0,5,0,Atlanta Falcons,2012,0,2,2,0
4,4-0,4,0,Atlanta Falcons,2012,0,2,2,0
3,3-0,3,0,Atlanta Falcons,2012,0,2,3,-1
2,2-0,2,0,Atlanta Falcons,2012,0,3,6,-3
1,1-0,1,0,Atlanta Falcons,2012,0,6,10,-4
0,10-6,10,6,Atlanta Falcons,2012,0,10,0,10
17,11-5,11,5,Atlanta Falcons,2008,0,7,7,0
16,10-5,10,5,Atlanta Falcons,2008,0,7,8,-1
15,9-5,9,5,Atlanta Falcons,2008,0,8,11,-3
14,8-5,8,5,Atlanta Falcons,2008,0,11,9,2
13,8-4,8,4,Atlanta Falcons,2008,0,9,10,-1
12,7-4,7,4,Atlanta Falcons,2008,0,10,14,-4
11,6-4,6,4,Atlanta Falcons,2008,0,14,8,6
10,6-3,6,3,Atlanta Falcons,2008,0,8,10,-2
9,5-3,5,3,Atlanta Falcons,2008,0,10,16,-6
8,4-3,4,3,Atlanta Falcons,2008,0,16,14,2
7,4-2,4,2,Atlanta Falcons,2008,0,14,15,-1
6,4-2,4,2,Atlanta Falcons,2008,0,15,20,-5
5,3-2,3,2,Atlanta Falcons,2008,0,20,24,-4
4,2-2,2,2,Atlanta Falcons,2008,0,24,24,0
3,2-1,2,1,Atlanta Falcons,2008,0,24,26,-2
2,1-1,1,1,Atlanta Falcons,2008,0,26,25,1
1,1-0,1,0,Atlanta Falcons,2008,0,25,32,-7
0,4-12,4,12,Atlanta Falcons,2008,0,32,0,32
17,13-3,13,3,Atlanta Falcons,2010,0,2,2,0
16,12-3,12,3,Atlanta Falcons,2010,0,2,2,0
15,12-2,12,2,Atlanta Falcons,2010,0,2,2,0
14,11-2,11,2,Atlanta Falcons,2010,0,2,1,1
13,10-2,10,2,Atlanta Falcons,2010,0,1,1,0
12,9-2,9,2,Atlanta Falcons,2010,0,1,1,0
11,8-2,8,2,Atlanta Falcons,2010,0,1,1,0
10,7-2,7,2,Atlanta Falcons,2010,0,1,3,-2
9,6-2,6,2,Atlanta Falcons,2010,0,3,6,-3
8,5-2,5,2,Atlanta Falcons,2010,0,6,5,1
7,5-2,5,2,Atlanta Falcons,2010,0,5,7,-2
6,4-2,4,2,Atlanta Falcons,2010,0,7,4,3
5,4-1,4,1,Atlanta Falcons,2010,0,4,5,-1
4,3-1,3,1,Atlanta Falcons,2010,0,5,5,0
3,2-1,2,1,Atlanta Falcons,2010,0,5,10,-5
2,1-1,1,1,Atlanta Falcons,2010,0,10,13,-3
1,0-1,0,1,Atlanta Falcons,2010,0,13,7,6
0,9-7,9,7,Atlanta Falcons,2010,0,7,0,7
17,9-7,9,7,Atlanta Falcons,2009,0,15,16,-1
16,8-7,8,7,Atlanta Falcons,2009,0,16,17,-1
15,7-7,7,7,Atlanta Falcons,2009,0,17,18,-1
14,6-7,6,7,Atlanta Falcons,2009,0,18,18,0
13,6-6,6,6,Atlanta Falcons,2009,0,18,14,4
12,6-5,6,5,Atlanta Falcons,2009,0,14,16,-2
11,5-5,5,5,Atlanta Falcons,2009,0,16,14,2
10,5-4,5,4,Atlanta Falcons,2009,0,14,9,5
9,5-3,5,3,Atlanta Falcons,2009,0,9,11,-2
8,4-3,4,3,Atlanta Falcons,2009,0,11,11,0
7,4-2,4,2,Atlanta Falcons,2009,0,11,7,4
6,4-1,4,1,Atlanta Falcons,2009,0,7,8,-1
5,3-1,3,1,Atlanta Falcons,2009,0,8,9,-1
4,2-1,2,1,Atlanta Falcons,2009,0,9,8,1
3,2-1,2,1,Atlanta Falcons,2009,0,8,4,4
2,2-0,2,0,Atlanta Falcons,2009,0,4,7,-3
1,1-0,1,0,Atlanta Falcons,2009,0,7,8,-1
0,11-5,11,5,Atlanta Falcons,2009,0,8,0,8
17,10-6,10,6,Atlanta Falcons,2011,0,7,8,-1
16,9-6,9,6,Atlanta Falcons,2011,0,8,8,0
15,9-5,9,5,Atlanta Falcons,2011,0,8,8,0
14,8-5,8,5,Atlanta Falcons,2011,0,8,8,0
13,7-5,7,5,Atlanta Falcons,2011,0,8,9,-1
12,7-4,7,4,Atlanta Falcons,2011,0,9,11,-2
11,6-4,6,4,Atlanta Falcons,2011,0,11,13,-2
10,5-4,5,4,Atlanta Falcons,2011,0,13,13,0
9,5-3,5,3,Atlanta Falcons,2011,0,13,12,1
8,4-3,4,3,Atlanta Falcons,2011,0,12,14,-2
7,4-3,4,3,Atlanta Falcons,2011,0,14,19,-5
6,3-3,3,3,Atlanta Falcons,2011,0,19,19,0
5,2-3,2,3,Atlanta Falcons,2011,0,19,19,0
4,2-2,2,2,Atlanta Falcons,2011,0,19,19,0
3,1-2,1,2,Atlanta Falcons,2011,0,19,8,11
2,1-1,1,1,Atlanta Falcons,2011,0,8,11,-3
1,0-1,0,1,Atlanta Falcons,2011,0,11,6,5
0,13-3,13,3,Atlanta Falcons,2011,0,6,0,6
17,4-12,4,12,Atlanta Falcons,2013,0,26,27,-1
16,4-11,4,11,Atlanta Falcons,2013,0,27,28,-1
15,4-10,4,10,Atlanta Falcons,2013,0,28,30,-2
14,3-10,3,10,Atlanta Falcons,2013,0,30,29,1
13,3-9,3,9,Atlanta Falcons,2013,0,29,30,-1
12,2-9,2,9,Atlanta Falcons,2013,0,30,30,0
11,2-8,2,8,Atlanta Falcons,2013,0,30,29,1
10,2-7,2,7,Atlanta Falcons,2013,0,29,26,3
9,2-6,2,6,Atlanta Falcons,2013,0,26,23,3
8,2-5,2,5,Atlanta Falcons,2013,0,23,20,3
7,2-4,2,4,Atlanta Falcons,2013,0,20,23,-3
6,1-4,1,4,Atlanta Falcons,2013,0,23,22,1
5,1-4,1,4,Atlanta Falcons,2013,0,22,16,6
4,1-3,1,3,Atlanta Falcons,2013,0,16,14,2
3,1-2,1,2,Atlanta Falcons,2013,0,14,6,8
2,1-1,1,1,Atlanta Falcons,2013,0,6,4,2
1,0-1,0,1,Atlanta Falcons,2013,0,4,2,2
0,13-3,13,3,Atlanta Falcons,2013,0,2,0,2
17,7-9,7,9,Atlanta Falcons,2006,0,22,21,1
16,7-8,7,8,Atlanta Falcons,2006,0,21,18,3
15,7-7,7,7,Atlanta Falcons,2006,0,18,12,6
14,7-6,7,6,Atlanta Falcons,2006,0,12,14,-2
13,6-6,6,6,Atlanta Falcons,2006,0,14,18,-4
12,5-6,5,6,Atlanta Falcons,2006,0,18,16,2
11,5-5,5,5,Atlanta Falcons,2006,0,16,15,1
10,5-4,5,4,Atlanta Falcons,2006,0,15,9,6
9,5-3,5,3,Atlanta Falcons,2006,0,9,7,2
8,5-2,5,2,Atlanta Falcons,2006,0,7,9,-2
7,4-2,4,2,Atlanta Falcons,2006,0,9,16,-7
6,3-2,3,2,Atlanta Falcons,2006,0,16,10,6
5,3-1,3,1,Atlanta Falcons,2006,0,10,10,0
4,3-1,3,1,Atlanta Falcons,2006,0,10,9,1
3,2-1,2,1,Atlanta Falcons,2006,0,9,5,4
2,2-0,2,0,Atlanta Falcons,2006,0,5,7,-2
1,1-0,1,0,Atlanta Falcons,2006,0,7,17,-10
0,8-8,8,8,Atlanta Falcons,2006,0,17,0,17
17,4-12,4,12,Atlanta Falcons,2007,0,31,31,0
16,3-12,3,12,Atlanta Falcons,2007,0,31,31,0
15,3-11,3,11,Atlanta Falcons,2007,0,31,30,1
14,3-10,3,10,Atlanta Falcons,2007,0,30,31,-1
13,3-9,3,9,Atlanta Falcons,2007,0,31,30,1
12,3-8,3,8,Atlanta Falcons,2007,0,30,27,3
11,3-7,3,7,Atlanta Falcons,2007,0,27,26,1
10,3-6,3,6,Atlanta Falcons,2007,0,26,28,-2
9,2-6,2,6,Atlanta Falcons,2007,0,28,29,-1
8,1-6,1,6,Atlanta Falcons,2007,0,29,29,0
7,1-6,1,6,Atlanta Falcons,2007,0,29,29,0
6,1-5,1,5,Atlanta Falcons,2007,0,29,29,0
5,1-4,1,4,Atlanta Falcons,2007,0,29,28,1
4,1-3,1,3,Atlanta Falcons,2007,0,28,32,-4
3,0-3,0,3,Atlanta Falcons,2007,0,32,32,0
2,0-2,0,2,Atlanta Falcons,2007,0,32,31,1
1,0-1,0,1,Atlanta Falcons,2007,0,31,31,0
0,7-9,7,9,Atlanta Falcons,2007,0,31,0,31
17,6-10,6,10,Atlanta Falcons,2014,0,25,20,5
16,6-9,6,9,Atlanta Falcons,2014,0,20,24,-4
15,5-9,5,9,Atlanta Falcons,2014,0,24,21,3
14,5-8,5,8,Atlanta Falcons,2014,0,21,22,-1
13,5-7,5,7,Atlanta Falcons,2014,0,22,22,0
12,4-7,4,7,Atlanta Falcons,2014,0,22,21,1
11,4-6,4,6,Atlanta Falcons,2014,0,21,23,-2
10,3-6,3,6,Atlanta Falcons,2014,0,23,27,-4
9,2-6,2,6,Atlanta Falcons,2014,0,27,26,1
8,2-6,2,6,Atlanta Falcons,2014,0,26,25,1
7,2-5,2,5,Atlanta Falcons,2014,0,25,24,1
6,2-4,2,4,Atlanta Falcons,2014,0,24,21,3
5,2-3,2,3,Atlanta Falcons,2014,0,21,17,4
4,2-2,2,2,Atlanta Falcons,2014,0,17,9,8
3,2-1,2,1,Atlanta Falcons,2014,0,9,17,-8
2,1-1,1,1,Atlanta Falcons,2014,0,17,9,8
1,1-0,1,0,Atlanta Falcons,2014,0,9,17,-8
0,4-12,4,12,Atlanta Falcons,2014,0,17,0,17
17,8-8,8,8,Atlanta Falcons,2015,0,15,15,0
16,8-7,8,7,Atlanta Falcons,2015,0,15,16,-1
15,7-7,7,7,Atlanta Falcons,2015,0,16,27,-11
14,6-7,6,7,Atlanta Falcons,2015,0,27,15,12
13,6-6,6,6,Atlanta Falcons,2015,0,15,15,0
12,6-5,6,5,Atlanta Falcons,2015,0,15,11,4
11,6-4,6,4,Atlanta Falcons,2015,0,11,8,3
10,6-3,6,3,Atlanta Falcons,2015,0,8,12,-4
9,6-3,6,3,Atlanta Falcons,2015,0,12,7,5
8,6-2,6,2,Atlanta Falcons,2015,0,7,7,0
7,6-1,6,1,Atlanta Falcons,2015,0,7,7,0
6,5-1,5,1,Atlanta Falcons,2015,0,7,3,4
5,5-0,5,0,Atlanta Falcons,2015,0,3,6,-3
4,4-0,4,0,Atlanta Falcons,2015,0,6,6,0
3,3-0,3,0,Atlanta Falcons,2015,0,6,11,-5
2,2-0,2,0,Atlanta Falcons,2015,0,11,17,-6
1,1-0,1,0,Atlanta Falcons,2015,0,17,23,-6
0,6-10,6,10,Atlanta Falcons,2015,0,23,0,23
17,13-3,13,3,Baltimore Ravens,2006,0,2,2,0
16,12-3,12,3,Baltimore Ravens,2006,0,2,2,0
15,11-3,11,3,Baltimore Ravens,2006,0,2,2,0
14,10-3,10,3,Baltimore Ravens,2006,0,2,6,-4
13,9-3,9,3,Baltimore Ravens,2006,0,6,3,3
12,9-2,9,2,Baltimore Ravens,2006,0,3,4,-1
11,8-2,8,2,Baltimore Ravens,2006,0,4,5,-1
10,7-2,7,2,Baltimore Ravens,2006,0,5,7,-2
9,6-2,6,2,Baltimore Ravens,2006,0,7,8,-1
8,5-2,5,2,Baltimore Ravens,2006,0,8,13,-5
7,4-2,4,2,Baltimore Ravens,2006,0,13,10,3
6,4-2,4,2,Baltimore Ravens,2006,0,10,6,4
5,4-1,4,1,Baltimore Ravens,2006,0,6,3,3
4,4-0,4,0,Baltimore Ravens,2006,0,3,6,-3
3,3-0,3,0,Baltimore Ravens,2006,0,6,8,-2
2,2-0,2,0,Baltimore Ravens,2006,0,8,6,2
1,1-0,1,0,Baltimore Ravens,2006,0,6,18,-12
0,6-10,6,10,Baltimore Ravens,2006,0,18,0,18
17,5-11,5,11,Baltimore Ravens,2007,0,25,26,-1
16,4-11,4,11,Baltimore Ravens,2007,0,26,27,-1
15,4-10,4,10,Baltimore Ravens,2007,0,27,25,2
14,4-9,4,9,Baltimore Ravens,2007,0,25,24,1
13,4-8,4,8,Baltimore Ravens,2007,0,24,25,-1
12,4-7,4,7,Baltimore Ravens,2007,0,25,24,1
11,4-6,4,6,Baltimore Ravens,2007,0,24,24,0
10,4-5,4,5,Baltimore Ravens,2007,0,24,17,7
9,4-4,4,4,Baltimore Ravens,2007,0,17,14,3
8,4-3,4,3,Baltimore Ravens,2007,0,14,14,0
7,4-3,4,3,Baltimore Ravens,2007,0,14,7,7
6,4-2,4,2,Baltimore Ravens,2007,0,7,9,-2
5,3-2,3,2,Baltimore Ravens,2007,0,9,11,-2
4,2-2,2,2,Baltimore Ravens,2007,0,11,5,6
3,2-1,2,1,Baltimore Ravens,2007,0,5,7,-2
2,1-1,1,1,Baltimore Ravens,2007,0,7,7,0
1,0-1,0,1,Baltimore Ravens,2007,0,7,5,2
0,13-3,13,3,Baltimore Ravens,2007,0,5,0,5
17,9-7,9,7,Baltimore Ravens,2009,0,11,11,0
16,8-7,8,7,Baltimore Ravens,2009,0,11,11,0
15,8-6,8,6,Baltimore Ravens,2009,0,11,12,-1
14,7-6,7,6,Baltimore Ravens,2009,0,12,16,-4
13,6-6,6,6,Baltimore Ravens,2009,0,16,13,3
12,6-5,6,5,Baltimore Ravens,2009,0,13,15,-2
11,5-5,5,5,Baltimore Ravens,2009,0,15,11,4
10,5-4,5,4,Baltimore Ravens,2009,0,11,14,-3
9,4-4,4,4,Baltimore Ravens,2009,0,14,10,4
8,4-3,4,3,Baltimore Ravens,2009,0,10,14,-4
7,3-3,3,3,Baltimore Ravens,2009,0,14,11,3
6,3-3,3,3,Baltimore Ravens,2009,0,11,11,0
5,3-2,3,2,Baltimore Ravens,2009,0,11,7,4
4,3-1,3,1,Baltimore Ravens,2009,0,7,1,6
3,3-0,3,0,Baltimore Ravens,2009,0,1,1,0
2,2-0,2,0,Baltimore Ravens,2009,0,1,10,-9
1,1-0,1,0,Baltimore Ravens,2009,0,10,10,0
0,11-5,11,5,Baltimore Ravens,2009,0,10,0,10
17,11-5,11,5,Baltimore Ravens,2008,0,6,6,0
16,10-5,10,5,Baltimore Ravens,2008,0,6,7,-1
15,9-5,9,5,Baltimore Ravens,2008,0,7,7,0
14,9-4,9,4,Baltimore Ravens,2008,0,7,10,-3
13,8-4,8,4,Baltimore Ravens,2008,0,10,13,-3
12,7-4,7,4,Baltimore Ravens,2008,0,13,13,0
11,6-4,6,4,Baltimore Ravens,2008,0,13,12,1
10,6-3,6,3,Baltimore Ravens,2008,0,12,13,-1
9,5-3,5,3,Baltimore Ravens,2008,0,13,14,-1
8,4-3,4,3,Baltimore Ravens,2008,0,14,20,-6
7,3-3,3,3,Baltimore Ravens,2008,0,20,23,-3
6,2-3,2,3,Baltimore Ravens,2008,0,23,15,8
5,2-2,2,2,Baltimore Ravens,2008,0,15,14,1
4,2-1,2,1,Baltimore Ravens,2008,0,14,17,-3
3,2-0,2,0,Baltimore Ravens,2008,0,17,20,-3
2,1-0,1,0,Baltimore Ravens,2008,0,20,22,-2
1,1-0,1,0,Baltimore Ravens,2008,0,22,24,-2
0,5-11,5,11,Baltimore Ravens,2008,0,24,0,24
17,12-4,12,4,Baltimore Ravens,2010,0,4,3,1
16,11-4,11,4,Baltimore Ravens,2010,0,3,4,-1
15,10-4,10,4,Baltimore Ravens,2010,0,4,5,-1
14,9-4,9,4,Baltimore Ravens,2010,0,5,4,1
13,8-4,8,4,Baltimore Ravens,2010,0,4,4,0
12,8-3,8,3,Baltimore Ravens,2010,0,4,3,1
11,7-3,7,3,Baltimore Ravens,2010,0,3,4,-1
10,6-3,6,3,Baltimore Ravens,2010,0,4,1,3
9,6-2,6,2,Baltimore Ravens,2010,0,1,2,-1
8,5-2,5,2,Baltimore Ravens,2010,0,2,4,-2
7,5-2,5,2,Baltimore Ravens,2010,0,4,4,0
6,4-2,4,2,Baltimore Ravens,2010,0,4,2,2
5,4-1,4,1,Baltimore Ravens,2010,0,2,6,-4
4,3-1,3,1,Baltimore Ravens,2010,0,6,8,-2
3,2-1,2,1,Baltimore Ravens,2010,0,8,8,0
2,1-1,1,1,Baltimore Ravens,2010,0,8,3,5
1,1-0,1,0,Baltimore Ravens,2010,0,3,6,-3
0,9-7,9,7,Baltimore Ravens,2010,0,6,0,6
17,10-6,10,6,Baltimore Ravens,2014,0,11,12,-1
16,9-6,9,6,Baltimore Ravens,2014,0,12,12,0
15,9-5,9,5,Baltimore Ravens,2014,0,12,12,0
14,8-5,8,5,Baltimore Ravens,2014,0,12,13,-1
13,7-5,7,5,Baltimore Ravens,2014,0,13,11,2
12,7-4,7,4,Baltimore Ravens,2014,0,11,14,-3
11,6-4,6,4,Baltimore Ravens,2014,0,14,13,1
10,6-4,6,4,Baltimore Ravens,2014,0,13,14,-1
9,5-4,5,4,Baltimore Ravens,2014,0,14,13,1
8,5-3,5,3,Baltimore Ravens,2014,0,13,9,4
7,5-2,5,2,Baltimore Ravens,2014,0,9,12,-3
6,4-2,4,2,Baltimore Ravens,2014,0,12,12,0
5,3-2,3,2,Baltimore Ravens,2014,0,12,7,5
4,3-1,3,1,Baltimore Ravens,2014,0,7,13,-6
3,2-1,2,1,Baltimore Ravens,2014,0,13,13,0
2,1-1,1,1,Baltimore Ravens,2014,0,13,20,-7
1,0-1,0,1,Baltimore Ravens,2014,0,20,12,8
0,8-8,8,8,Baltimore Ravens,2014,0,12,0,12
17,12-4,12,4,Baltimore Ravens,2011,0,5,5,0
16,11-4,11,4,Baltimore Ravens,2011,0,5,5,0
15,10-4,10,4,Baltimore Ravens,2011,0,5,2,3
14,10-3,10,3,Baltimore Ravens,2011,0,2,2,0
13,9-3,9,3,Baltimore Ravens,2011,0,2,2,0
12,8-3,8,3,Baltimore Ravens,2011,0,2,5,-3
11,7-3,7,3,Baltimore Ravens,2011,0,5,6,-1
10,6-3,6,3,Baltimore Ravens,2011,0,6,3,3
9,6-2,6,2,Baltimore Ravens,2011,0,3,4,-1
8,5-2,5,2,Baltimore Ravens,2011,0,4,6,-2
7,4-2,4,2,Baltimore Ravens,2011,0,6,3,3
6,4-1,4,1,Baltimore Ravens,2011,0,3,5,-2
5,3-1,3,1,Baltimore Ravens,2011,0,5,5,0
4,3-1,3,1,Baltimore Ravens,2011,0,5,5,0
3,2-1,2,1,Baltimore Ravens,2011,0,5,7,-2
2,1-1,1,1,Baltimore Ravens,2011,0,7,4,3
1,1-0,1,0,Baltimore Ravens,2011,0,4,8,-4
0,12-4,12,4,Baltimore Ravens,2011,0,8,0,8
17,8-8,8,8,Baltimore Ravens,2013,0,16,14,2
16,8-7,8,7,Baltimore Ravens,2013,0,14,12,2
15,8-6,8,6,Baltimore Ravens,2013,0,12,14,-2
14,7-6,7,6,Baltimore Ravens,2013,0,14,14,0
13,6-6,6,6,Baltimore Ravens,2013,0,14,18,-4
12,5-6,5,6,Baltimore Ravens,2013,0,18,20,-2
11,4-6,4,6,Baltimore Ravens,2013,0,20,18,2
10,4-5,4,5,Baltimore Ravens,2013,0,18,21,-3
9,3-5,3,5,Baltimore Ravens,2013,0,21,15,6
8,3-4,3,4,Baltimore Ravens,2013,0,15,14,1
7,3-4,3,4,Baltimore Ravens,2013,0,14,12,2
6,3-3,3,3,Baltimore Ravens,2013,0,12,9,3
5,3-2,3,2,Baltimore Ravens,2013,0,9,14,-5
4,2-2,2,2,Baltimore Ravens,2013,0,14,11,3
3,2-1,2,1,Baltimore Ravens,2013,0,11,11,0
2,1-1,1,1,Baltimore Ravens,2013,0,11,11,0
1,0-1,0,1,Baltimore Ravens,2013,0,11,8,3
0,10-6,10,6,Baltimore Ravens,2013,0,8,0,8
17,10-6,10,6,Baltimore Ravens,2012,0,10,10,0
16,10-5,10,5,Baltimore Ravens,2012,0,10,11,-1
15,9-5,9,5,Baltimore Ravens,2012,0,11,8,3
14,9-4,9,4,Baltimore Ravens,2012,0,8,6,2
13,9-3,9,3,Baltimore Ravens,2012,0,6,4,2
12,9-2,9,2,Baltimore Ravens,2012,0,4,5,-1
11,8-2,8,2,Baltimore Ravens,2012,0,5,5,0
10,7-2,7,2,Baltimore Ravens,2012,0,5,7,-2
9,6-2,6,2,Baltimore Ravens,2012,0,7,7,0
8,5-2,5,2,Baltimore Ravens,2012,0,7,6,1
7,5-2,5,2,Baltimore Ravens,2012,0,6,4,2
6,5-1,5,1,Baltimore Ravens,2012,0,4,4,0
5,4-1,4,1,Baltimore Ravens,2012,0,4,3,1
4,3-1,3,1,Baltimore Ravens,2012,0,3,3,0
3,2-1,2,1,Baltimore Ravens,2012,0,3,6,-3
2,1-1,1,1,Baltimore Ravens,2012,0,6,3,3
1,1-0,1,0,Baltimore Ravens,2012,0,3,6,-3
0,12-4,12,4,Baltimore Ravens,2012,0,6,0,6
17,5-11,5,11,Baltimore Ravens,2015,0,26,24,2
16,5-10,5,10,Baltimore Ravens,2015,0,24,28,-4
15,4-10,4,10,Baltimore Ravens,2015,0,28,29,-1
14,4-9,4,9,Baltimore Ravens,2015,0,29,30,-1
13,4-8,4,8,Baltimore Ravens,2015,0,30,25,5
12,4-7,4,7,Baltimore Ravens,2015,0,25,30,-5
11,3-7,3,7,Baltimore Ravens,2015,0,30,29,1
10,2-7,2,7,Baltimore Ravens,2015,0,29,24,5
9,2-6,2,6,Baltimore Ravens,2015,0,24,27,-3
8,2-6,2,6,Baltimore Ravens,2015,0,27,26,1
7,1-6,1,6,Baltimore Ravens,2015,0,26,28,-2
6,1-5,1,5,Baltimore Ravens,2015,0,28,23,5
5,1-4,1,4,Baltimore Ravens,2015,0,23,19,4
4,1-3,1,3,Baltimore Ravens,2015,0,19,22,-3
3,0-3,0,3,Baltimore Ravens,2015,0,22,17,5
2,0-2,0,2,Baltimore Ravens,2015,0,17,12,5
1,0-1,0,1,Baltimore Ravens,2015,0,12,8,4
0,10-6,10,6,Baltimore Ravens,2015,0,8,0,8
17,7-9,7,9,Buffalo Bills,2006,0,21,16,5
16,7-8,7,8,Buffalo Bills,2006,0,16,16,0
15,7-7,7,7,Buffalo Bills,2006,0,16,19,-3
14,6-7,6,7,Buffalo Bills,2006,0,19,21,-2
13,5-7,5,7,Buffalo Bills,2006,0,21,19,2
12,5-6,5,6,Buffalo Bills,2006,0,19,23,-4
11,4-6,4,6,Buffalo Bills,2006,0,23,27,-4
10,3-6,3,6,Buffalo Bills,2006,0,27,21,6
9,3-5,3,5,Buffalo Bills,2006,0,21,27,-6
8,2-5,2,5,Buffalo Bills,2006,0,27,26,1
7,2-5,2,5,Buffalo Bills,2006,0,26,23,3
6,2-4,2,4,Buffalo Bills,2006,0,23,23,0
5,2-3,2,3,Buffalo Bills,2006,0,23,21,2
4,2-2,2,2,Buffalo Bills,2006,0,21,23,-2
3,1-2,1,2,Buffalo Bills,2006,0,23,20,3
2,1-1,1,1,Buffalo Bills,2006,0,20,26,-6
1,0-1,0,1,Buffalo Bills,2006,0,26,30,-4
0,5-11,5,11,Buffalo Bills,2006,0,30,0,30
17,7-9,7,9,Buffalo Bills,2007,0,19,16,3
16,7-8,7,8,Buffalo Bills,2007,0,16,17,-1
15,7-7,7,7,Buffalo Bills,2007,0,17,14,3
14,7-6,7,6,Buffalo Bills,2007,0,14,15,-1
13,6-6,6,6,Buffalo Bills,2007,0,15,22,-7
12,5-6,5,6,Buffalo Bills,2007,0,22,19,3
11,5-5,5,5,Buffalo Bills,2007,0,19,15,4
10,5-4,5,4,Buffalo Bills,2007,0,15,18,-3
9,4-4,4,4,Buffalo Bills,2007,0,18,22,-4
8,3-4,3,4,Buffalo Bills,2007,0,22,25,-3
7,2-4,2,4,Buffalo Bills,2007,0,25,28,-3
6,1-4,1,4,Buffalo Bills,2007,0,28,26,2
5,1-4,1,4,Buffalo Bills,2007,0,26,30,-4
4,1-3,1,3,Buffalo Bills,2007,0,30,29,1
3,0-3,0,3,Buffalo Bills,2007,0,29,29,0
2,0-2,0,2,Buffalo Bills,2007,0,29,26,3
1,0-1,0,1,Buffalo Bills,2007,0,26,21,5
0,7-9,7,9,Buffalo Bills,2007,0,21,0,21
17,7-9,7,9,Buffalo Bills,2008,0,23,22,1
16,7-8,7,8,Buffalo Bills,2008,0,22,22,0
15,6-8,6,8,Buffalo Bills,2008,0,22,22,0
14,6-7,6,7,Buffalo Bills,2008,0,22,21,1
13,6-6,6,6,Buffalo Bills,2008,0,21,18,3
12,6-5,6,5,Buffalo Bills,2008,0,18,18,0
11,5-5,5,5,Buffalo Bills,2008,0,18,17,1
10,5-4,5,4,Buffalo Bills,2008,0,17,14,3
9,5-3,5,3,Buffalo Bills,2008,0,14,6,8
8,5-2,5,2,Buffalo Bills,2008,0,6,4,2
7,5-1,5,1,Buffalo Bills,2008,0,4,4,0
6,4-1,4,1,Buffalo Bills,2008,0,4,8,-4
5,4-1,4,1,Buffalo Bills,2008,0,8,4,4
4,4-0,4,0,Buffalo Bills,2008,0,4,6,-2
3,3-0,3,0,Buffalo Bills,2008,0,6,10,-4
2,2-0,2,0,Buffalo Bills,2008,0,10,13,-3
1,1-0,1,0,Buffalo Bills,2008,0,13,18,-5
0,7-9,7,9,Buffalo Bills,2008,0,18,0,18
17,6-10,6,10,Buffalo Bills,2009,0,24,25,-1
16,5-10,5,10,Buffalo Bills,2009,0,25,26,-1
15,5-9,5,9,Buffalo Bills,2009,0,26,25,1
14,5-8,5,8,Buffalo Bills,2009,0,25,26,-1
13,4-8,4,8,Buffalo Bills,2009,0,26,24,2
12,4-7,4,7,Buffalo Bills,2009,0,24,27,-3
11,3-7,3,7,Buffalo Bills,2009,0,27,26,1
10,3-6,3,6,Buffalo Bills,2009,0,26,24,2
9,3-5,3,5,Buffalo Bills,2009,0,24,22,2
8,3-5,3,5,Buffalo Bills,2009,0,22,22,0
7,3-4,3,4,Buffalo Bills,2009,0,22,24,-2
6,2-4,2,4,Buffalo Bills,2009,0,24,25,-1
5,1-4,1,4,Buffalo Bills,2009,0,25,23,2
4,1-3,1,3,Buffalo Bills,2009,0,23,21,2
3,1-2,1,2,Buffalo Bills,2009,0,21,21,0
2,1-1,1,1,Buffalo Bills,2009,0,21,21,0
1,0-1,0,1,Buffalo Bills,2009,0,21,21,0
0,7-9,7,9,Buffalo Bills,2009,0,21,0,21
17,4-12,4,12,Buffalo Bills,2010,0,30,28,2
16,4-11,4,11,Buffalo Bills,2010,0,28,27,1
15,4-10,4,10,Buffalo Bills,2010,0,27,28,-1
14,3-10,3,10,Buffalo Bills,2010,0,28,27,1
13,2-10,2,10,Buffalo Bills,2010,0,27,27,0
12,2-9,2,9,Buffalo Bills,2010,0,27,28,-1
11,2-8,2,8,Buffalo Bills,2010,0,28,30,-2
10,1-8,1,8,Buffalo Bills,2010,0,30,32,-2
9,0-8,0,8,Buffalo Bills,2010,0,32,32,0
8,0-7,0,7,Buffalo Bills,2010,0,32,32,0
7,0-6,0,6,Buffalo Bills,2010,0,32,32,0
6,0-5,0,5,Buffalo Bills,2010,0,32,32,0
5,0-5,0,5,Buffalo Bills,2010,0,32,32,0
4,0-4,0,4,Buffalo Bills,2010,0,32,32,0
3,0-3,0,3,Buffalo Bills,2010,0,32,32,0
2,0-2,0,2,Buffalo Bills,2010,0,32,30,2
1,0-1,0,1,Buffalo Bills,2010,0,30,31,-1
0,6-10,6,10,Buffalo Bills,2010,0,31,0,31
17,6-10,6,10,Buffalo Bills,2011,0,25,25,0
16,6-9,6,9,Buffalo Bills,2011,0,25,26,-1
15,5-9,5,9,Buffalo Bills,2011,0,26,22,4
14,5-8,5,8,Buffalo Bills,2011,0,22,20,2
13,5-7,5,7,Buffalo Bills,2011,0,20,19,1
12,5-6,5,6,Buffalo Bills,2011,0,19,19,0
11,5-5,5,5,Buffalo Bills,2011,0,19,17,2
10,5-4,5,4,Buffalo Bills,2011,0,17,14,3
9,5-3,5,3,Buffalo Bills,2011,0,14,7,7
8,5-2,5,2,Buffalo Bills,2011,0,7,7,0
7,4-2,4,2,Buffalo Bills,2011,0,7,10,-3
6,4-2,4,2,Buffalo Bills,2011,0,10,6,4
5,4-1,4,1,Buffalo Bills,2011,0,6,9,-3
4,3-1,3,1,Buffalo Bills,2011,0,9,6,3
3,3-0,3,0,Buffalo Bills,2011,0,6,16,-10
2,2-0,2,0,Buffalo Bills,2011,0,16,27,-11
1,1-0,1,0,Buffalo Bills,2011,0,27,30,-3
0,4-12,4,12,Buffalo Bills,2011,0,30,0,30
17,6-10,6,10,Buffalo Bills,2012,0,23,25,-2
16,5-10,5,10,Buffalo Bills,2012,0,25,25,0
15,5-9,5,9,Buffalo Bills,2012,0,25,24,1
14,5-8,5,8,Buffalo Bills,2012,0,24,23,1
13,5-7,5,7,Buffalo Bills,2012,0,23,24,-1
12,4-7,4,7,Buffalo Bills,2012,0,24,24,0
11,4-6,4,6,Buffalo Bills,2012,0,24,27,-3
10,3-6,3,6,Buffalo Bills,2012,0,27,28,-1
9,3-5,3,5,Buffalo Bills,2012,0,28,28,0
8,3-4,3,4,Buffalo Bills,2012,0,28,27,1
7,3-4,3,4,Buffalo Bills,2012,0,27,25,2
6,3-3,3,3,Buffalo Bills,2012,0,25,27,-2
5,2-3,2,3,Buffalo Bills,2012,0,27,21,6
4,2-2,2,2,Buffalo Bills,2012,0,21,19,2
3,2-1,2,1,Buffalo Bills,2012,0,19,22,-3
2,1-1,1,1,Buffalo Bills,2012,0,22,24,-2
1,0-1,0,1,Buffalo Bills,2012,0,24,19,5
0,6-10,6,10,Buffalo Bills,2012,0,19,0,19
17,9-7,9,7,Buffalo Bills,2014,0,17,17,0
16,8-7,8,7,Buffalo Bills,2014,0,17,15,2
15,8-6,8,6,Buffalo Bills,2014,0,15,17,-2
14,7-6,7,6,Buffalo Bills,2014,0,17,17,0
13,7-5,7,5,Buffalo Bills,2014,0,17,18,-1
12,6-5,6,5,Buffalo Bills,2014,0,18,19,-1
11,5-5,5,5,Buffalo Bills,2014,0,19,18,1
10,5-4,5,4,Buffalo Bills,2014,0,18,18,0
9,5-3,5,3,Buffalo Bills,2014,0,18,16,2
8,5-3,5,3,Buffalo Bills,2014,0,16,16,0
7,4-3,4,3,Buffalo Bills,2014,0,16,21,-5
6,3-3,3,3,Buffalo Bills,2014,0,21,18,3
5,3-2,3,2,Buffalo Bills,2014,0,18,23,-5
4,2-2,2,2,Buffalo Bills,2014,0,23,19,4
3,2-1,2,1,Buffalo Bills,2014,0,19,12,7
2,2-0,2,0,Buffalo Bills,2014,0,12,23,-11
1,1-0,1,0,Buffalo Bills,2014,0,23,29,-6
0,6-10,6,10,Buffalo Bills,2014,0,29,0,29
17,8-8,8,8,Buffalo Bills,2015,0,14,16,-2
16,7-8,7,8,Buffalo Bills,2015,0,16,18,-2
15,6-8,6,8,Buffalo Bills,2015,0,18,16,2
14,6-7,6,7,Buffalo Bills,2015,0,16,12,4
13,6-6,6,6,Buffalo Bills,2015,0,12,19,-7
12,5-6,5,6,Buffalo Bills,2015,0,19,14,5
11,5-5,5,5,Buffalo Bills,2015,0,14,12,2
10,5-4,5,4,Buffalo Bills,2015,0,12,17,-5
9,4-4,4,4,Buffalo Bills,2015,0,17,16,1
8,3-4,3,4,Buffalo Bills,2015,0,16,19,-3
7,3-4,3,4,Buffalo Bills,2015,0,19,17,2
6,3-3,3,3,Buffalo Bills,2015,0,17,10,7
5,3-2,3,2,Buffalo Bills,2015,0,10,12,-2
4,2-2,2,2,Buffalo Bills,2015,0,12,10,2
3,2-1,2,1,Buffalo Bills,2015,0,10,8,2
2,1-1,1,1,Buffalo Bills,2015,0,8,9,-1
1,1-0,1,0,Buffalo Bills,2015,0,9,18,-9
0,9-7,9,7,Buffalo Bills,2015,0,18,0,18
17,8-8,8,8,Carolina Panthers,2006,0,20,22,-2
16,7-8,7,8,Carolina Panthers,2006,0,22,25,-3
15,6-8,6,8,Carolina Panthers,2006,0,25,22,3
14,6-7,6,7,Carolina Panthers,2006,0,22,18,4
13,6-6,6,6,Carolina Panthers,2006,0,18,12,6
12,6-5,6,5,Carolina Panthers,2006,0,12,8,4
11,6-4,6,4,Carolina Panthers,2006,0,8,12,-4
10,5-4,5,4,Carolina Panthers,2006,0,12,14,-2
9,4-4,4,4,Carolina Panthers,2006,0,14,15,-1
8,4-4,4,4,Carolina Panthers,2006,0,15,10,5
7,4-3,4,3,Carolina Panthers,2006,0,10,8,2
6,4-2,4,2,Carolina Panthers,2006,0,8,12,-4
5,3-2,3,2,Carolina Panthers,2006,0,12,14,-2
4,2-2,2,2,Carolina Panthers,2006,0,14,18,-4
3,1-2,1,2,Carolina Panthers,2006,0,18,16,2
2,0-2,0,2,Carolina Panthers,2006,0,16,12,4
1,0-1,0,1,Carolina Panthers,2006,0,12,2,10
0,11-5,11,5,Carolina Panthers,2006,0,2,0,2
17,7-9,7,9,Carolina Panthers,2007,0,23,24,-1
16,6-9,6,9,Carolina Panthers,2007,0,24,21,3
15,6-8,6,8,Carolina Panthers,2007,0,21,24,-3
14,5-8,5,8,Carolina Panthers,2007,0,24,23,1
13,5-7,5,7,Carolina Panthers,2007,0,23,26,-3
12,4-7,4,7,Carolina Panthers,2007,0,26,25,1
11,4-6,4,6,Carolina Panthers,2007,0,25,23,2
10,4-5,4,5,Carolina Panthers,2007,0,23,19,4
9,4-4,4,4,Carolina Panthers,2007,0,19,18,1
8,4-3,4,3,Carolina Panthers,2007,0,18,12,6
7,4-2,4,2,Carolina Panthers,2007,0,12,13,-1
6,4-2,4,2,Carolina Panthers,2007,0,13,17,-4
5,3-2,3,2,Carolina Panthers,2007,0,17,14,3
4,2-2,2,2,Carolina Panthers,2007,0,14,12,2
3,2-1,2,1,Carolina Panthers,2007,0,12,16,-4
2,1-1,1,1,Carolina Panthers,2007,0,16,12,4
1,1-0,1,0,Carolina Panthers,2007,0,12,15,-3
0,8-8,8,8,Carolina Panthers,2007,0,15,0,15
17,12-4,12,4,Carolina Panthers,2008,0,4,3,1
16,11-4,11,4,Carolina Panthers,2008,0,3,3,0
15,11-3,11,3,Carolina Panthers,2008,0,3,4,-1
14,10-3,10,3,Carolina Panthers,2008,0,4,5,-1
13,9-3,9,3,Carolina Panthers,2008,0,5,7,-2
12,8-3,8,3,Carolina Panthers,2008,0,7,3,4
11,8-2,8,2,Carolina Panthers,2008,0,3,3,0
10,7-2,7,2,Carolina Panthers,2008,0,3,4,-1
9,6-2,6,2,Carolina Panthers,2008,0,4,3,1
8,6-2,6,2,Carolina Panthers,2008,0,3,7,-4
7,5-2,5,2,Carolina Panthers,2008,0,7,10,-3
6,4-2,4,2,Carolina Panthers,2008,0,10,6,4
5,4-1,4,1,Carolina Panthers,2008,0,6,7,-1
4,3-1,3,1,Carolina Panthers,2008,0,7,10,-3
3,2-1,2,1,Carolina Panthers,2008,0,10,8,2
2,2-0,2,0,Carolina Panthers,2008,0,8,12,-4
1,1-0,1,0,Carolina Panthers,2008,0,12,17,-5
0,7-9,7,9,Carolina Panthers,2008,0,17,0,17
17,6-10,6,10,Buffalo Bills,2013,0,25,23,2
16,6-9,6,9,Buffalo Bills,2013,0,23,25,-2
15,5-9,5,9,Buffalo Bills,2013,0,25,26,-1
14,4-9,4,9,Buffalo Bills,2013,0,26,24,2
13,4-8,4,8,Buffalo Bills,2013,0,24,24,0
12,4-7,4,7,Buffalo Bills,2013,0,24,25,-1
11,4-7,4,7,Buffalo Bills,2013,0,25,26,-1
10,3-7,3,7,Buffalo Bills,2013,0,26,23,3
9,3-6,3,6,Buffalo Bills,2013,0,23,20,3
8,3-5,3,5,Buffalo Bills,2013,0,20,21,-1
7,3-4,3,4,Buffalo Bills,2013,0,21,25,-4
6,2-4,2,4,Buffalo Bills,2013,0,25,23,2
5,2-3,2,3,Buffalo Bills,2013,0,23,23,0
4,2-2,2,2,Buffalo Bills,2013,0,23,24,-1
3,1-2,1,2,Buffalo Bills,2013,0,24,26,-2
2,1-1,1,1,Buffalo Bills,2013,0,26,29,-3
1,0-1,0,1,Buffalo Bills,2013,0,29,30,-1
0,6-10,6,10,Buffalo Bills,2013,0,30,0,30
17,8-8,8,8,Carolina Panthers,2009,0,18,19,-1
16,7-8,7,8,Carolina Panthers,2009,0,19,21,-2
15,6-8,6,8,Carolina Panthers,2009,0,21,22,-1
14,5-8,5,8,Carolina Panthers,2009,0,22,20,2
13,5-7,5,7,Carolina Panthers,2009,0,20,22,-2
12,4-7,4,7,Carolina Panthers,2009,0,22,21,1
11,4-6,4,6,Carolina Panthers,2009,0,21,20,1
10,4-5,4,5,Carolina Panthers,2009,0,20,21,-1
9,3-5,3,5,Carolina Panthers,2009,0,21,23,-2
8,3-4,3,4,Carolina Panthers,2009,0,23,24,-1
7,2-4,2,4,Carolina Panthers,2009,0,24,22,2
6,2-3,2,3,Carolina Panthers,2009,0,22,23,-1
5,1-3,1,3,Carolina Panthers,2009,0,23,26,-3
4,0-3,0,3,Carolina Panthers,2009,0,26,25,1
3,0-3,0,3,Carolina Panthers,2009,0,25,25,0
2,0-2,0,2,Carolina Panthers,2009,0,25,22,3
1,0-1,0,1,Carolina Panthers,2009,0,22,14,8
0,12-4,12,4,Carolina Panthers,2009,0,14,0,14
17,2-14,2,14,Carolina Panthers,2010,0,32,32,0
16,2-13,2,13,Carolina Panthers,2010,0,32,32,0
15,2-12,2,12,Carolina Panthers,2010,0,32,32,0
14,1-12,1,12,Carolina Panthers,2010,0,32,32,0
13,1-11,1,11,Carolina Panthers,2010,0,32,32,0
12,1-10,1,10,Carolina Panthers,2010,0,32,32,0
11,1-9,1,9,Carolina Panthers,2010,0,32,32,0
10,1-8,1,8,Carolina Panthers,2010,0,32,31,1
9,1-7,1,7,Carolina Panthers,2010,0,31,31,0
8,1-6,1,6,Carolina Panthers,2010,0,31,29,2
7,1-5,1,5,Carolina Panthers,2010,0,29,31,-2
6,0-5,0,5,Carolina Panthers,2010,0,31,31,0
5,0-5,0,5,Carolina Panthers,2010,0,31,30,1
4,0-4,0,4,Carolina Panthers,2010,0,30,29,1
3,0-3,0,3,Carolina Panthers,2010,0,29,28,1
2,0-2,0,2,Carolina Panthers,2010,0,28,26,2
1,0-1,0,1,Carolina Panthers,2010,0,26,23,3
0,8-8,8,8,Carolina Panthers,2010,0,23,0,23
17,6-10,6,10,Carolina Panthers,2011,0,23,21,2
16,6-9,6,9,Carolina Panthers,2011,0,21,24,-3
15,5-9,5,9,Carolina Panthers,2011,0,24,24,0
14,4-9,4,9,Carolina Panthers,2011,0,24,25,-1
13,4-8,4,8,Carolina Panthers,2011,0,25,28,-3
12,3-8,3,8,Carolina Panthers,2011,0,28,30,-2
11,2-8,2,8,Carolina Panthers,2011,0,30,31,-1
10,2-7,2,7,Carolina Panthers,2011,0,31,26,5
9,2-6,2,6,Carolina Panthers,2011,0,26,25,1
8,2-6,2,6,Carolina Panthers,2011,0,25,23,2
7,2-5,2,5,Carolina Panthers,2011,0,23,25,-2
6,1-5,1,5,Carolina Panthers,2011,0,25,24,1
5,1-4,1,4,Carolina Panthers,2011,0,24,24,0
4,1-3,1,3,Carolina Panthers,2011,0,24,22,2
3,1-2,1,2,Carolina Panthers,2011,0,22,27,-5
2,0-2,0,2,Carolina Panthers,2011,0,27,29,-2
1,0-1,0,1,Carolina Panthers,2011,0,29,31,-2
0,2-14,2,14,Carolina Panthers,2011,0,31,0,31
17,7-9,7,9,Carolina Panthers,2012,0,18,20,-2
16,6-9,6,9,Carolina Panthers,2012,0,20,23,-3
15,5-9,5,9,Carolina Panthers,2012,0,23,26,-3
14,4-9,4,9,Carolina Panthers,2012,0,26,28,-2
13,3-9,3,9,Carolina Panthers,2012,0,28,28,0
12,3-8,3,8,Carolina Panthers,2012,0,28,29,-1
11,2-8,2,8,Carolina Panthers,2012,0,29,29,0
10,2-7,2,7,Carolina Panthers,2012,0,29,29,0
9,2-6,2,6,Carolina Panthers,2012,0,29,30,-1
8,1-6,1,6,Carolina Panthers,2012,0,30,29,1
7,1-5,1,5,Carolina Panthers,2012,0,29,28,1
6,1-4,1,4,Carolina Panthers,2012,0,28,26,2
5,1-4,1,4,Carolina Panthers,2012,0,26,24,2
4,1-3,1,3,Carolina Panthers,2012,0,24,23,1
3,1-2,1,2,Carolina Panthers,2012,0,23,19,4
2,1-1,1,1,Carolina Panthers,2012,0,19,23,-4
1,0-1,0,1,Carolina Panthers,2012,0,23,22,1
0,6-10,6,10,Carolina Panthers,2012,0,22,0,22
17,12-4,12,4,Carolina Panthers,2013,0,3,3,0
16,11-4,11,4,Carolina Panthers,2013,0,3,4,-1
15,10-4,10,4,Carolina Panthers,2013,0,4,6,-2
14,9-4,9,4,Carolina Panthers,2013,0,6,3,3
13,9-3,9,3,Carolina Panthers,2013,0,3,5,-2
12,8-3,8,3,Carolina Panthers,2013,0,5,5,0
11,7-3,7,3,Carolina Panthers,2013,0,5,6,-1
10,6-3,6,3,Carolina Panthers,2013,0,6,12,-6
9,5-3,5,3,Carolina Panthers,2013,0,12,12,0
8,4-3,4,3,Carolina Panthers,2013,0,12,18,-6
7,3-3,3,3,Carolina Panthers,2013,0,18,24,-6
6,2-3,2,3,Carolina Panthers,2013,0,24,26,-2
5,1-3,1,3,Carolina Panthers,2013,0,26,21,5
4,1-2,1,2,Carolina Panthers,2013,0,21,21,0
3,1-2,1,2,Carolina Panthers,2013,0,21,27,-6
2,0-2,0,2,Carolina Panthers,2013,0,27,24,3
1,0-1,0,1,Carolina Panthers,2013,0,24,23,1
0,7-9,7,9,Carolina Panthers,2013,0,23,0,23
17,7-8,7,8,Carolina Panthers,2014,0,15,19,-4
16,6-8,6,8,Carolina Panthers,2014,0,19,22,-3
15,5-8,5,8,Carolina Panthers,2014,0,22,24,-2
14,4-8,4,8,Carolina Panthers,2014,0,24,25,-1
13,3-8,3,8,Carolina Panthers,2014,0,25,25,0
12,3-7,3,7,Carolina Panthers,2014,0,25,25,0
11,3-7,3,7,Carolina Panthers,2014,0,25,22,3
10,3-6,3,6,Carolina Panthers,2014,0,22,22,0
9,3-5,3,5,Carolina Panthers,2014,0,22,20,2
8,3-4,3,4,Carolina Panthers,2014,0,20,17,3
7,3-3,3,3,Carolina Panthers,2014,0,17,14,3
6,3-2,3,2,Carolina Panthers,2014,0,14,15,-1
5,3-2,3,2,Carolina Panthers,2014,0,15,20,-5
4,2-2,2,2,Carolina Panthers,2014,0,20,10,10
3,2-1,2,1,Carolina Panthers,2014,0,10,6,4
2,2-0,2,0,Carolina Panthers,2014,0,6,11,-5
1,1-0,1,0,Carolina Panthers,2014,0,11,15,-4
0,12-4,12,4,Carolina Panthers,2014,0,15,0,15
17,15-1,15,1,Carolina Panthers,2015,0,1,2,-1
16,14-1,14,1,Carolina Panthers,2015,0,2,1,1
15,14-0,14,0,Carolina Panthers,2015,0,1,1,0
14,13-0,13,0,Carolina Panthers,2015,0,1,1,0
13,12-0,12,0,Carolina Panthers,2015,0,1,1,0
12,11-0,11,0,Carolina Panthers,2015,0,1,2,-1
11,10-0,10,0,Carolina Panthers,2015,0,2,2,0
10,9-0,9,0,Carolina Panthers,2015,0,2,3,-1
9,8-0,8,0,Carolina Panthers,2015,0,3,5,-2
8,7-0,7,0,Carolina Panthers,2015,0,5,5,0
7,6-0,6,0,Carolina Panthers,2015,0,5,6,-1
6,5-0,5,0,Carolina Panthers,2015,0,6,7,-1
5,4-0,4,0,Carolina Panthers,2015,0,7,8,-1
4,4-0,4,0,Carolina Panthers,2015,0,8,9,-1
3,3-0,3,0,Carolina Panthers,2015,0,9,14,-5
2,2-0,2,0,Carolina Panthers,2015,0,14,18,-4
1,1-0,1,0,Carolina Panthers,2015,0,18,19,-1
0,7-8,7,8,Carolina Panthers,2015,0,19,0,19
17,7-9,7,9,Chicago Bears,2007,0,20,20,0
16,6-9,6,9,Chicago Bears,2007,0,20,24,-4
15,5-9,5,9,Chicago Bears,2007,0,24,23,1
14,5-8,5,8,Chicago Bears,2007,0,23,16,7
13,5-7,5,7,Chicago Bears,2007,0,16,16,0
12,5-6,5,6,Chicago Bears,2007,0,16,22,-6
11,4-6,4,6,Chicago Bears,2007,0,22,21,1
10,4-5,4,5,Chicago Bears,2007,0,21,24,-3
9,3-5,3,5,Chicago Bears,2007,0,24,23,1
8,3-5,3,5,Chicago Bears,2007,0,23,18,5
7,3-4,3,4,Chicago Bears,2007,0,18,23,-5
6,2-4,2,4,Chicago Bears,2007,0,23,15,8
5,2-3,2,3,Chicago Bears,2007,0,15,20,-5
4,1-3,1,3,Chicago Bears,2007,0,20,13,7
3,1-2,1,2,Chicago Bears,2007,0,13,6,7
2,1-1,1,1,Chicago Bears,2007,0,6,4,2
1,0-1,0,1,Chicago Bears,2007,0,4,4,0
0,13-3,13,3,Chicago Bears,2007,0,4,0,4
17,13-3,13,3,Chicago Bears,2006,0,5,3,2
16,13-2,13,2,Chicago Bears,2006,0,3,4,-1
15,12-2,12,2,Chicago Bears,2006,0,4,4,0
14,11-2,11,2,Chicago Bears,2006,0,4,4,0
13,10-2,10,2,Chicago Bears,2006,0,4,5,-1
12,9-2,9,2,Chicago Bears,2006,0,5,3,2
11,9-1,9,1,Chicago Bears,2006,0,3,2,1
10,8-1,8,1,Chicago Bears,2006,0,2,3,-1
9,7-1,7,1,Chicago Bears,2006,0,3,1,2
8,7-0,7,0,Chicago Bears,2006,0,1,1,0
7,6-0,6,0,Chicago Bears,2006,0,1,1,0
6,6-0,6,0,Chicago Bears,2006,0,1,1,0
5,5-0,5,0,Chicago Bears,2006,0,1,1,0
4,4-0,4,0,Chicago Bears,2006,0,1,4,-3
3,3-0,3,0,Chicago Bears,2006,0,4,6,-2
2,2-0,2,0,Chicago Bears,2006,0,6,8,-2
1,1-0,1,0,Chicago Bears,2006,0,8,13,-5
0,11-5,11,5,Chicago Bears,2006,0,13,0,13
17,7-9,7,9,Chicago Bears,2009,0,22,23,-1
16,6-9,6,9,Chicago Bears,2009,0,23,25,-2
15,5-9,5,9,Chicago Bears,2009,0,25,23,2
14,5-8,5,8,Chicago Bears,2009,0,23,24,-1
13,5-7,5,7,Chicago Bears,2009,0,24,23,1
12,4-7,4,7,Chicago Bears,2009,0,23,23,0
11,4-6,4,6,Chicago Bears,2009,0,23,23,0
10,4-5,4,5,Chicago Bears,2009,0,23,19,4
9,4-4,4,4,Chicago Bears,2009,0,19,17,2
8,4-3,4,3,Chicago Bears,2009,0,17,18,-1
7,3-3,3,3,Chicago Bears,2009,0,18,10,8
6,3-2,3,2,Chicago Bears,2009,0,10,12,-2
5,3-1,3,1,Chicago Bears,2009,0,12,14,-2
4,3-1,3,1,Chicago Bears,2009,0,14,14,0
3,2-1,2,1,Chicago Bears,2009,0,14,14,0
2,1-1,1,1,Chicago Bears,2009,0,14,15,-1
1,0-1,0,1,Chicago Bears,2009,0,15,11,4
0,9-7,9,7,Chicago Bears,2009,0,11,0,11
17,11-5,11,5,Chicago Bears,2010,0,6,6,0
16,11-4,11,4,Chicago Bears,2010,0,6,8,-2
15,10-4,10,4,Chicago Bears,2010,0,8,8,0
14,9-4,9,4,Chicago Bears,2010,0,8,8,0
13,9-3,9,3,Chicago Bears,2010,0,8,7,1
12,8-3,8,3,Chicago Bears,2010,0,7,12,-5
11,7-3,7,3,Chicago Bears,2010,0,12,17,-5
10,6-3,6,3,Chicago Bears,2010,0,17,19,-2
9,5-3,5,3,Chicago Bears,2010,0,19,17,2
8,4-3,4,3,Chicago Bears,2010,0,17,15,2
7,4-3,4,3,Chicago Bears,2010,0,15,12,3
6,4-2,4,2,Chicago Bears,2010,0,12,7,5
5,4-1,4,1,Chicago Bears,2010,0,7,11,-4
4,3-1,3,1,Chicago Bears,2010,0,11,6,5
3,3-0,3,0,Chicago Bears,2010,0,6,12,-6
2,2-0,2,0,Chicago Bears,2010,0,12,22,-10
1,1-0,1,0,Chicago Bears,2010,0,22,21,1
0,7-9,7,9,Chicago Bears,2010,0,21,0,21
17,8-8,8,8,Chicago Bears,2011,0,20,22,-2
16,7-8,7,8,Chicago Bears,2011,0,22,21,1
15,7-7,7,7,Chicago Bears,2011,0,21,17,4
14,7-6,7,6,Chicago Bears,2011,0,17,17,0
13,7-5,7,5,Chicago Bears,2011,0,17,12,5
12,7-4,7,4,Chicago Bears,2011,0,12,7,5
11,7-3,7,3,Chicago Bears,2011,0,7,5,2
10,6-3,6,3,Chicago Bears,2011,0,5,9,-4
9,5-3,5,3,Chicago Bears,2011,0,9,10,-1
8,4-3,4,3,Chicago Bears,2011,0,10,10,0
7,4-3,4,3,Chicago Bears,2011,0,10,14,-4
6,3-3,3,3,Chicago Bears,2011,0,14,18,-4
5,2-3,2,3,Chicago Bears,2011,0,18,18,0
4,2-2,2,2,Chicago Bears,2011,0,18,18,0
3,1-2,1,2,Chicago Bears,2011,0,18,10,8
2,1-1,1,1,Chicago Bears,2011,0,10,7,3
1,1-0,1,0,Chicago Bears,2011,0,7,13,-6
0,11-5,11,5,Chicago Bears,2011,0,13,0,13
17,10-6,10,6,Chicago Bears,2012,0,13,13,0
16,9-6,9,6,Chicago Bears,2012,0,13,14,-1
15,8-6,8,6,Chicago Bears,2012,0,14,11,3
14,8-5,8,5,Chicago Bears,2012,0,11,8,3
13,8-4,8,4,Chicago Bears,2012,0,8,6,2
12,8-3,8,3,Chicago Bears,2012,0,6,6,0
11,7-3,7,3,Chicago Bears,2012,0,6,3,3
10,7-2,7,2,Chicago Bears,2012,0,3,3,0
9,7-1,7,1,Chicago Bears,2012,0,3,5,-2
8,6-1,6,1,Chicago Bears,2012,0,5,5,0
7,5-1,5,1,Chicago Bears,2012,0,5,6,-1
6,4-1,4,1,Chicago Bears,2012,0,6,6,0
5,4-1,4,1,Chicago Bears,2012,0,6,9,-3
4,3-1,3,1,Chicago Bears,2012,0,9,11,-2
3,2-1,2,1,Chicago Bears,2012,0,11,12,-1
2,1-1,1,1,Chicago Bears,2012,0,12,8,4
1,1-0,1,0,Chicago Bears,2012,0,8,9,-1
0,8-8,8,8,Chicago Bears,2012,0,9,0,9
17,9-7,9,7,Chicago Bears,2008,0,15,13,2
16,9-6,9,6,Chicago Bears,2008,0,13,16,-3
15,8-6,8,6,Chicago Bears,2008,0,16,19,-3
14,7-6,7,6,Chicago Bears,2008,0,19,19,0
13,6-6,6,6,Chicago Bears,2008,0,19,15,4
12,6-5,6,5,Chicago Bears,2008,0,15,19,-4
11,5-5,5,5,Chicago Bears,2008,0,19,14,5
10,5-4,5,4,Chicago Bears,2008,0,14,9,5
9,5-3,5,3,Chicago Bears,2008,0,9,12,-3
8,4-3,4,3,Chicago Bears,2008,0,12,13,-1
7,4-3,4,3,Chicago Bears,2008,0,13,20,-7
6,3-3,3,3,Chicago Bears,2008,0,20,10,10
5,3-2,3,2,Chicago Bears,2008,0,10,18,-8
4,2-2,2,2,Chicago Bears,2008,0,18,20,-2
3,1-2,1,2,Chicago Bears,2008,0,20,15,5
2,1-1,1,1,Chicago Bears,2008,0,15,15,0
1,1-0,1,0,Chicago Bears,2008,0,15,25,-10
0,7-9,7,9,Chicago Bears,2008,0,25,0,25
17,8-8,8,8,Chicago Bears,2013,0,15,13,2
16,8-7,8,7,Chicago Bears,2013,0,13,13,0
15,8-6,8,6,Chicago Bears,2013,0,13,13,0
14,7-6,7,6,Chicago Bears,2013,0,13,15,-2
13,6-6,6,6,Chicago Bears,2013,0,15,14,1
12,6-5,6,5,Chicago Bears,2013,0,14,10,4
11,6-4,6,4,Chicago Bears,2013,0,10,11,-1
10,5-4,5,4,Chicago Bears,2013,0,11,9,2
9,5-3,5,3,Chicago Bears,2013,0,9,14,-5
8,4-3,4,3,Chicago Bears,2013,0,14,13,1
7,4-3,4,3,Chicago Bears,2013,0,13,10,3
6,4-2,4,2,Chicago Bears,2013,0,10,10,0
5,3-2,3,2,Chicago Bears,2013,0,10,9,1
4,3-1,3,1,Chicago Bears,2013,0,9,4,5
3,3-0,3,0,Chicago Bears,2013,0,4,9,-5
2,2-0,2,0,Chicago Bears,2013,0,9,9,0
1,1-0,1,0,Chicago Bears,2013,0,9,14,-5
0,10-6,10,6,Chicago Bears,2013,0,14,0,14
17,5-11,5,11,Chicago Bears,2014,0,26,26,0
16,5-10,5,10,Chicago Bears,2014,0,26,26,0
15,5-9,5,9,Chicago Bears,2014,0,26,25,1
14,5-8,5,8,Chicago Bears,2014,0,25,23,2
13,5-7,5,7,Chicago Bears,2014,0,23,19,4
12,5-6,5,6,Chicago Bears,2014,0,19,23,-4
11,4-6,4,6,Chicago Bears,2014,0,23,27,-4
10,3-6,3,6,Chicago Bears,2014,0,27,21,6
9,3-5,3,5,Chicago Bears,2014,0,21,23,-2
8,3-5,3,5,Chicago Bears,2014,0,23,19,4
7,3-4,3,4,Chicago Bears,2014,0,19,16,3
6,3-3,3,3,Chicago Bears,2014,0,16,22,-6
5,2-3,2,3,Chicago Bears,2014,0,22,15,7
4,2-2,2,2,Chicago Bears,2014,0,15,8,7
3,2-1,2,1,Chicago Bears,2014,0,8,11,-3
2,1-1,1,1,Chicago Bears,2014,0,11,18,-7
1,0-1,0,1,Chicago Bears,2014,0,18,10,8
0,8-8,8,8,Chicago Bears,2014,0,10,0,10
17,6-10,6,10,Chicago Bears,2015,0,25,25,0
16,6-9,6,9,Chicago Bears,2015,0,25,24,1
15,5-9,5,9,Chicago Bears,2015,0,24,19,5
14,5-8,5,8,Chicago Bears,2015,0,19,21,-2
13,5-7,5,7,Chicago Bears,2015,0,21,20,1
12,5-6,5,6,Chicago Bears,2015,0,20,19,1
11,4-6,4,6,Chicago Bears,2015,0,19,16,3
10,4-5,4,5,Chicago Bears,2015,0,16,21,-5
9,3-5,3,5,Chicago Bears,2015,0,21,28,-7
8,2-5,2,5,Chicago Bears,2015,0,28,25,3
7,2-4,2,4,Chicago Bears,2015,0,25,25,0
6,2-4,2,4,Chicago Bears,2015,0,25,24,1
5,2-3,2,3,Chicago Bears,2015,0,24,29,-5
4,1-3,1,3,Chicago Bears,2015,0,29,32,-3
3,0-3,0,3,Chicago Bears,2015,0,32,32,0
2,0-2,0,2,Chicago Bears,2015,0,32,27,5
1,0-1,0,1,Chicago Bears,2015,0,27,25,2
0,5-11,5,11,Chicago Bears,2015,0,25,0,25
17,8-8,8,8,Cincinnati Bengals,2006,0,14,12,2
16,8-7,8,7,Cincinnati Bengals,2006,0,12,8,4
15,8-6,8,6,Cincinnati Bengals,2006,0,8,5,3
14,8-5,8,5,Cincinnati Bengals,2006,0,5,8,-3
13,7-5,7,5,Cincinnati Bengals,2006,0,8,11,-3
12,6-5,6,5,Cincinnati Bengals,2006,0,11,12,-1
11,5-5,5,5,Cincinnati Bengals,2006,0,12,17,-5
10,4-5,4,5,Cincinnati Bengals,2006,0,17,13,4
9,4-4,4,4,Cincinnati Bengals,2006,0,13,10,3
8,4-3,4,3,Cincinnati Bengals,2006,0,10,7,3
7,4-2,4,2,Cincinnati Bengals,2006,0,7,12,-5
6,3-2,3,2,Cincinnati Bengals,2006,0,12,9,3
5,3-1,3,1,Cincinnati Bengals,2006,0,9,7,2
4,3-1,3,1,Cincinnati Bengals,2006,0,7,2,5
3,3-0,3,0,Cincinnati Bengals,2006,0,2,3,-1
2,2-0,2,0,Cincinnati Bengals,2006,0,3,4,-1
1,1-0,1,0,Cincinnati Bengals,2006,0,4,6,-2
0,11-5,11,5,Cincinnati Bengals,2006,0,6,0,6
17,4-11,4,11,Cincinnati Bengals,2008,0,27,29,-2
16,3-11,3,11,Cincinnati Bengals,2008,0,29,29,0
15,2-11,2,11,Cincinnati Bengals,2008,0,29,31,-2
14,1-11,1,11,Cincinnati Bengals,2008,0,31,31,0
13,1-10,1,10,Cincinnati Bengals,2008,0,31,30,1
12,1-9,1,9,Cincinnati Bengals,2008,0,30,29,1
11,1-8,1,8,Cincinnati Bengals,2008,0,29,30,-1
10,1-8,1,8,Cincinnati Bengals,2008,0,30,29,1
9,1-8,1,8,Cincinnati Bengals,2008,0,29,31,-2
8,0-8,0,8,Cincinnati Bengals,2008,0,31,31,0
7,0-7,0,7,Cincinnati Bengals,2008,0,31,31,0
6,0-6,0,6,Cincinnati Bengals,2008,0,31,30,1
5,0-5,0,5,Cincinnati Bengals,2008,0,30,30,0
4,0-4,0,4,Cincinnati Bengals,2008,0,30,28,2
3,0-3,0,3,Cincinnati Bengals,2008,0,28,28,0
2,0-2,0,2,Cincinnati Bengals,2008,0,28,26,2
1,0-1,0,1,Cincinnati Bengals,2008,0,26,23,3
0,7-9,7,9,Cincinnati Bengals,2008,0,23,0,23
17,10-6,10,6,Cincinnati Bengals,2009,0,9,7,2
16,10-5,10,5,Cincinnati Bengals,2009,0,7,7,0
15,9-5,9,5,Cincinnati Bengals,2009,0,7,7,0
14,9-4,9,4,Cincinnati Bengals,2009,0,7,5,2
13,9-3,9,3,Cincinnati Bengals,2009,0,5,5,0
12,8-3,8,3,Cincinnati Bengals,2009,0,5,7,-2
11,7-3,7,3,Cincinnati Bengals,2009,0,7,4,3
10,7-2,7,2,Cincinnati Bengals,2009,0,4,4,0
9,6-2,6,2,Cincinnati Bengals,2009,0,4,6,-2
8,5-2,5,2,Cincinnati Bengals,2009,0,6,6,0
7,5-2,5,2,Cincinnati Bengals,2009,0,6,9,-3
6,4-2,4,2,Cincinnati Bengals,2009,0,9,6,3
5,4-1,4,1,Cincinnati Bengals,2009,0,6,11,-5
4,3-1,3,1,Cincinnati Bengals,2009,0,11,11,0
3,2-1,2,1,Cincinnati Bengals,2009,0,11,24,-13
2,1-1,1,1,Cincinnati Bengals,2009,0,24,26,-2
1,0-1,0,1,Cincinnati Bengals,2009,0,26,24,2
0,4-11,4,11,Cincinnati Bengals,2009,0,24,0,24
17,4-12,4,12,Cincinnati Bengals,2010,0,31,30,1
16,4-11,4,11,Cincinnati Bengals,2010,0,30,30,0
15,3-11,3,11,Cincinnati Bengals,2010,0,30,31,-1
14,2-11,2,11,Cincinnati Bengals,2010,0,31,30,1
13,2-10,2,10,Cincinnati Bengals,2010,0,30,30,0
12,2-9,2,9,Cincinnati Bengals,2010,0,30,30,0
11,2-8,2,8,Cincinnati Bengals,2010,0,30,28,2
10,2-7,2,7,Cincinnati Bengals,2010,0,28,26,2
9,2-6,2,6,Cincinnati Bengals,2010,0,26,25,1
8,2-5,2,5,Cincinnati Bengals,2010,0,25,22,3
7,2-4,2,4,Cincinnati Bengals,2010,0,22,20,2
6,2-3,2,3,Cincinnati Bengals,2010,0,20,22,-2
5,2-3,2,3,Cincinnati Bengals,2010,0,22,18,4
4,2-2,2,2,Cincinnati Bengals,2010,0,18,12,6
3,2-1,2,1,Cincinnati Bengals,2010,0,12,11,1
2,1-1,1,1,Cincinnati Bengals,2010,0,11,17,-6
1,0-1,0,1,Cincinnati Bengals,2010,0,17,12,5
0,10-6,10,6,Cincinnati Bengals,2010,0,12,0,12
17,9-7,9,7,Cincinnati Bengals,2011,0,11,10,1
16,9-6,9,6,Cincinnati Bengals,2011,0,10,13,-3
15,8-6,8,6,Cincinnati Bengals,2011,0,13,15,-2
14,7-6,7,6,Cincinnati Bengals,2011,0,15,14,1
13,7-5,7,5,Cincinnati Bengals,2011,0,14,13,1
12,7-4,7,4,Cincinnati Bengals,2011,0,13,13,0
11,6-4,6,4,Cincinnati Bengals,2011,0,13,11,2
10,6-3,6,3,Cincinnati Bengals,2011,0,11,10,1
9,6-2,6,2,Cincinnati Bengals,2011,0,10,14,-4
8,5-2,5,2,Cincinnati Bengals,2011,0,14,16,-2
7,4-2,4,2,Cincinnati Bengals,2011,0,16,18,-2
6,4-2,4,2,Cincinnati Bengals,2011,0,18,20,-2
5,3-2,3,2,Cincinnati Bengals,2011,0,20,21,-1
4,2-2,2,2,Cincinnati Bengals,2011,0,21,27,-6
3,1-2,1,2,Cincinnati Bengals,2011,0,27,28,-1
2,1-1,1,1,Cincinnati Bengals,2011,0,28,30,-2
1,1-0,1,0,Cincinnati Bengals,2011,0,30,32,-2
0,4-12,4,12,Cincinnati Bengals,2011,0,32,0,32
17,7-9,7,9,Cincinnati Bengals,2007,0,22,23,-1
16,6-9,6,9,Cincinnati Bengals,2007,0,23,23,0
15,5-9,5,9,Cincinnati Bengals,2007,0,23,22,1
14,5-8,5,8,Cincinnati Bengals,2007,0,22,25,-3
13,4-8,4,8,Cincinnati Bengals,2007,0,25,23,2
12,4-7,4,7,Cincinnati Bengals,2007,0,23,26,-3
11,3-7,3,7,Cincinnati Bengals,2007,0,26,25,1
10,3-6,3,6,Cincinnati Bengals,2007,0,25,26,-1
9,2-6,2,6,Cincinnati Bengals,2007,0,26,25,1
8,2-5,2,5,Cincinnati Bengals,2007,0,25,23,2
7,2-4,2,4,Cincinnati Bengals,2007,0,23,27,-4
6,1-4,1,4,Cincinnati Bengals,2007,0,27,23,4
5,1-3,1,3,Cincinnati Bengals,2007,0,23,23,0
4,1-3,1,3,Cincinnati Bengals,2007,0,23,18,5
3,1-2,1,2,Cincinnati Bengals,2007,0,18,13,5
2,1-1,1,1,Cincinnati Bengals,2007,0,13,6,7
1,1-0,1,0,Cincinnati Bengals,2007,0,6,11,-5
0,8-8,8,8,Cincinnati Bengals,2007,0,11,0,11
17,10-6,10,6,Cincinnati Bengals,2012,0,11,11,0
16,9-6,9,6,Cincinnati Bengals,2012,0,11,13,-2
15,8-6,8,6,Cincinnati Bengals,2012,0,13,14,-1
14,7-6,7,6,Cincinnati Bengals,2012,0,14,11,3
13,7-5,7,5,Cincinnati Bengals,2012,0,11,11,0
12,6-5,6,5,Cincinnati Bengals,2012,0,11,17,-6
11,5-5,5,5,Cincinnati Bengals,2012,0,17,19,-2
10,4-5,4,5,Cincinnati Bengals,2012,0,19,23,-4
9,3-5,3,5,Cincinnati Bengals,2012,0,23,22,1
8,3-4,3,4,Cincinnati Bengals,2012,0,22,22,0
7,3-4,3,4,Cincinnati Bengals,2012,0,22,21,1
6,3-3,3,3,Cincinnati Bengals,2012,0,21,15,6
5,3-2,3,2,Cincinnati Bengals,2012,0,15,12,3
4,3-1,3,1,Cincinnati Bengals,2012,0,12,15,-3
3,2-1,2,1,Cincinnati Bengals,2012,0,15,16,-1
2,1-1,1,1,Cincinnati Bengals,2012,0,16,18,-2
1,0-1,0,1,Cincinnati Bengals,2012,0,18,16,2
0,9-7,9,7,Cincinnati Bengals,2012,0,16,0,16
17,11-5,11,5,Cincinnati Bengals,2013,0,7,7,0
16,10-5,10,5,Cincinnati Bengals,2013,0,7,9,-2
15,9-5,9,5,Cincinnati Bengals,2013,0,9,8,1
14,9-4,9,4,Cincinnati Bengals,2013,0,8,8,0
13,8-4,8,4,Cincinnati Bengals,2013,0,8,8,0
12,7-4,7,4,Cincinnati Bengals,2013,0,8,8,0
11,7-4,7,4,Cincinnati Bengals,2013,0,8,10,-2
10,6-4,6,4,Cincinnati Bengals,2013,0,10,8,2
9,6-3,6,3,Cincinnati Bengals,2013,0,8,7,1
8,6-2,6,2,Cincinnati Bengals,2013,0,7,7,0
7,5-2,5,2,Cincinnati Bengals,2013,0,7,8,-1
6,4-2,4,2,Cincinnati Bengals,2013,0,8,8,0
5,3-2,3,2,Cincinnati Bengals,2013,0,8,11,-3
4,2-2,2,2,Cincinnati Bengals,2013,0,11,6,5
3,2-1,2,1,Cincinnati Bengals,2013,0,6,10,-4
2,1-1,1,1,Cincinnati Bengals,2013,0,10,10,0
1,0-1,0,1,Cincinnati Bengals,2013,0,10,9,1
0,10-6,10,6,Cincinnati Bengals,2013,0,9,0,9
17,10-5,10,5,Cincinnati Bengals,2014,0,9,8,1
16,10-4,10,4,Cincinnati Bengals,2014,0,8,11,-3
15,9-4,9,4,Cincinnati Bengals,2014,0,11,13,-2
14,8-4,8,4,Cincinnati Bengals,2014,0,13,10,3
13,8-3,8,3,Cincinnati Bengals,2014,0,10,10,0
12,7-3,7,3,Cincinnati Bengals,2014,0,10,13,-3
11,6-3,6,3,Cincinnati Bengals,2014,0,13,16,-3
10,5-3,5,3,Cincinnati Bengals,2014,0,16,11,5
9,5-2,5,2,Cincinnati Bengals,2014,0,11,12,-1
8,4-2,4,2,Cincinnati Bengals,2014,0,12,13,-1
7,3-2,3,2,Cincinnati Bengals,2014,0,13,11,2
6,3-1,3,1,Cincinnati Bengals,2014,0,11,5,6
5,3-1,3,1,Cincinnati Bengals,2014,0,5,2,3
4,3-0,3,0,Cincinnati Bengals,2014,0,2,2,0
3,3-0,3,0,Cincinnati Bengals,2014,0,2,3,-1
2,2-0,2,0,Cincinnati Bengals,2014,0,3,5,-2
1,1-0,1,0,Cincinnati Bengals,2014,0,5,9,-4
0,11-5,11,5,Cincinnati Bengals,2014,0,9,0,9
17,12-4,12,4,Cincinnati Bengals,2015,0,6,6,0
16,11-4,11,4,Cincinnati Bengals,2015,0,6,5,1
15,11-3,11,3,Cincinnati Bengals,2015,0,5,4,1
14,10-3,10,3,Cincinnati Bengals,2015,0,4,3,1
13,10-2,10,2,Cincinnati Bengals,2015,0,3,5,-2
12,9-2,9,2,Cincinnati Bengals,2015,0,5,5,0
11,8-2,8,2,Cincinnati Bengals,2015,0,5,4,1
10,8-1,8,1,Cincinnati Bengals,2015,0,4,2,2
9,8-0,8,0,Cincinnati Bengals,2015,0,2,3,-1
8,7-0,7,0,Cincinnati Bengals,2015,0,3,3,0
7,6-0,6,0,Cincinnati Bengals,2015,0,3,5,-2
6,6-0,6,0,Cincinnati Bengals,2015,0,5,5,0
5,5-0,5,0,Cincinnati Bengals,2015,0,5,5,0
4,4-0,4,0,Cincinnati Bengals,2015,0,5,5,0
3,3-0,3,0,Cincinnati Bengals,2015,0,5,6,-1
2,2-0,2,0,Cincinnati Bengals,2015,0,6,8,-2
1,1-0,1,0,Cincinnati Bengals,2015,0,8,11,-3
0,10-5,10,5,Cincinnati Bengals,2015,0,11,0,11
17,10-6,10,6,Cleveland Browns,2007,0,13,11,2
16,9-6,9,6,Cleveland Browns,2007,0,11,7,4
15,9-5,9,5,Cleveland Browns,2007,0,7,10,-3
14,8-5,8,5,Cleveland Browns,2007,0,10,11,-1
13,7-5,7,5,Cleveland Browns,2007,0,11,7,4
12,7-4,7,4,Cleveland Browns,2007,0,7,8,-1
11,6-4,6,4,Cleveland Browns,2007,0,8,11,-3
10,5-4,5,4,Cleveland Browns,2007,0,11,9,2
9,5-3,5,3,Cleveland Browns,2007,0,9,13,-4
8,4-3,4,3,Cleveland Browns,2007,0,13,19,-6
7,3-3,3,3,Cleveland Browns,2007,0,19,19,0
6,3-3,3,3,Cleveland Browns,2007,0,19,24,-5
5,2-3,2,3,Cleveland Browns,2007,0,24,25,-1
4,2-2,2,2,Cleveland Browns,2007,0,25,27,-2
3,1-2,1,2,Cleveland Browns,2007,0,27,26,1
2,1-1,1,1,Cleveland Browns,2007,0,26,32,-6
1,0-1,0,1,Cleveland Browns,2007,0,32,32,0
0,4-12,4,12,Cleveland Browns,2007,0,32,0,32
17,4-12,4,12,Cleveland Browns,2008,0,29,28,1
16,4-11,4,11,Cleveland Browns,2008,0,28,26,2
15,4-10,4,10,Cleveland Browns,2008,0,26,26,0
14,4-9,4,9,Cleveland Browns,2008,0,26,26,0
13,4-8,4,8,Cleveland Browns,2008,0,26,25,1
12,4-7,4,7,Cleveland Browns,2008,0,25,24,1
11,4-6,4,6,Cleveland Browns,2008,0,24,24,0
10,3-6,3,6,Cleveland Browns,2008,0,24,24,0
9,3-5,3,5,Cleveland Browns,2008,0,24,22,2
8,3-4,3,4,Cleveland Browns,2008,0,22,24,-2
7,2-4,2,4,Cleveland Browns,2008,0,24,22,2
6,2-3,2,3,Cleveland Browns,2008,0,22,25,-3
5,1-3,1,3,Cleveland Browns,2008,0,25,25,0
4,1-3,1,3,Cleveland Browns,2008,0,25,26,-1
3,0-3,0,3,Cleveland Browns,2008,0,26,22,4
2,0-2,0,2,Cleveland Browns,2008,0,22,17,5
1,0-1,0,1,Cleveland Browns,2008,0,17,13,4
0,10-6,10,6,Cleveland Browns,2008,0,13,0,13
17,4-12,4,12,Cleveland Browns,2006,0,30,30,0
16,4-11,4,11,Cleveland Browns,2006,0,30,28,2
15,4-10,4,10,Cleveland Browns,2006,0,28,29,-1
14,4-9,4,9,Cleveland Browns,2006,0,29,26,3
13,4-8,4,8,Cleveland Browns,2006,0,26,29,-3
12,3-8,3,8,Cleveland Browns,2006,0,29,29,0
11,3-7,3,7,Cleveland Browns,2006,0,29,24,5
10,3-6,3,6,Cleveland Browns,2006,0,24,30,-6
9,2-6,2,6,Cleveland Browns,2006,0,30,26,4
8,2-5,2,5,Cleveland Browns,2006,0,26,30,-4
7,1-5,1,5,Cleveland Browns,2006,0,30,28,2
6,1-4,1,4,Cleveland Browns,2006,0,28,26,2
5,1-4,1,4,Cleveland Browns,2006,0,26,24,2
4,1-3,1,3,Cleveland Browns,2006,0,24,28,-4
3,0-3,0,3,Cleveland Browns,2006,0,28,28,0
2,0-2,0,2,Cleveland Browns,2006,0,28,28,0
1,0-1,0,1,Cleveland Browns,2006,0,28,27,1
0,6-10,6,10,Cleveland Browns,2006,0,27,0,27
17,5-11,5,11,Cleveland Browns,2009,0,25,27,-2
16,4-11,4,11,Cleveland Browns,2009,0,27,28,-1
15,3-11,3,11,Cleveland Browns,2009,0,28,29,-1
14,2-11,2,11,Cleveland Browns,2009,0,29,32,-3
13,1-11,1,11,Cleveland Browns,2009,0,32,32,0
12,1-10,1,10,Cleveland Browns,2009,0,32,32,0
11,1-9,1,9,Cleveland Browns,2009,0,32,32,0
10,1-8,1,8,Cleveland Browns,2009,0,32,32,0
9,1-7,1,7,Cleveland Browns,2009,0,32,31,1
8,1-7,1,7,Cleveland Browns,2009,0,31,30,1
7,1-6,1,6,Cleveland Browns,2009,0,30,29,1
6,1-5,1,5,Cleveland Browns,2009,0,29,28,1
5,1-4,1,4,Cleveland Browns,2009,0,28,29,-1
4,0-4,0,4,Cleveland Browns,2009,0,29,29,0
3,0-3,0,3,Cleveland Browns,2009,0,29,29,0
2,0-2,0,2,Cleveland Browns,2009,0,29,28,1
1,0-1,0,1,Cleveland Browns,2009,0,28,28,0
0,4-12,4,12,Cleveland Browns,2009,0,28,0,28
17,5-11,5,11,Cleveland Browns,2010,0,27,25,2
16,5-10,5,10,Cleveland Browns,2010,0,25,22,3
15,5-9,5,9,Cleveland Browns,2010,0,22,21,1
14,5-8,5,8,Cleveland Browns,2010,0,21,21,0
13,5-7,5,7,Cleveland Browns,2010,0,21,24,-3
12,4-7,4,7,Cleveland Browns,2010,0,24,23,1
11,3-7,3,7,Cleveland Browns,2010,0,23,22,1
10,3-6,3,6,Cleveland Browns,2010,0,22,23,-1
9,3-5,3,5,Cleveland Browns,2010,0,23,26,-3
8,2-5,2,5,Cleveland Browns,2010,0,26,28,-2
7,2-5,2,5,Cleveland Browns,2010,0,28,30,-2
6,1-5,1,5,Cleveland Browns,2010,0,30,29,1
5,1-4,1,4,Cleveland Browns,2010,0,29,27,2
4,1-3,1,3,Cleveland Browns,2010,0,27,30,-3
3,0-3,0,3,Cleveland Browns,2010,0,30,30,0
2,0-2,0,2,Cleveland Browns,2010,0,30,32,-2
1,0-1,0,1,Cleveland Browns,2010,0,32,29,3
0,5-11,5,11,Cleveland Browns,2010,0,29,0,29
17,4-12,4,12,Cleveland Browns,2011,0,28,28,0
16,4-11,4,11,Cleveland Browns,2011,0,28,28,0
15,4-10,4,10,Cleveland Browns,2011,0,28,29,-1
14,4-9,4,9,Cleveland Browns,2011,0,29,28,1
13,4-8,4,8,Cleveland Browns,2011,0,28,27,1
12,4-7,4,7,Cleveland Browns,2011,0,27,24,3
11,4-6,4,6,Cleveland Browns,2011,0,24,28,-4
10,3-6,3,6,Cleveland Browns,2011,0,28,25,3
9,3-5,3,5,Cleveland Browns,2011,0,25,24,1
8,3-4,3,4,Cleveland Browns,2011,0,24,24,0
7,3-3,3,3,Cleveland Browns,2011,0,24,23,1
6,2-3,2,3,Cleveland Browns,2011,0,23,23,0
5,2-2,2,2,Cleveland Browns,2011,0,23,22,1
4,2-2,2,2,Cleveland Browns,2011,0,22,21,1
3,2-1,2,1,Cleveland Browns,2011,0,21,29,-8
2,1-1,1,1,Cleveland Browns,2011,0,29,32,-3
1,0-1,0,1,Cleveland Browns,2011,0,32,29,3
0,5-11,5,11,Cleveland Browns,2011,0,29,0,29
17,5-11,5,11,Cleveland Browns,2012,0,24,24,0
16,5-10,5,10,Cleveland Browns,2012,0,24,22,2
15,5-9,5,9,Cleveland Browns,2012,0,22,20,2
14,5-8,5,8,Cleveland Browns,2012,0,20,24,-4
13,4-8,4,8,Cleveland Browns,2012,0,24,27,-3
12,3-8,3,8,Cleveland Browns,2012,0,27,30,-3
11,2-8,2,8,Cleveland Browns,2012,0,30,30,0
10,2-7,2,7,Cleveland Browns,2012,0,30,30,0
9,2-7,2,7,Cleveland Browns,2012,0,30,29,1
8,2-6,2,6,Cleveland Browns,2012,0,29,30,-1
7,1-6,1,6,Cleveland Browns,2012,0,30,30,0
6,1-5,1,5,Cleveland Browns,2012,0,30,32,-2
5,0-5,0,5,Cleveland Browns,2012,0,32,32,0
4,0-4,0,4,Cleveland Browns,2012,0,32,32,0
3,0-3,0,3,Cleveland Browns,2012,0,32,32,0
2,0-2,0,2,Cleveland Browns,2012,0,32,31,1
1,0-1,0,1,Cleveland Browns,2012,0,31,31,0
0,4-12,4,12,Cleveland Browns,2012,0,31,0,31
17,4-12,4,12,Cleveland Browns,2013,0,28,28,0
16,4-11,4,11,Cleveland Browns,2013,0,28,27,1
15,4-10,4,10,Cleveland Browns,2013,0,27,25,2
14,4-9,4,9,Cleveland Browns,2013,0,25,27,-2
13,4-8,4,8,Cleveland Browns,2013,0,27,25,2
12,4-7,4,7,Cleveland Browns,2013,0,25,23,2
11,4-6,4,6,Cleveland Browns,2013,0,23,19,4
10,4-5,4,5,Cleveland Browns,2013,0,19,18,1
9,4-5,4,5,Cleveland Browns,2013,0,18,21,-3
8,3-5,3,5,Cleveland Browns,2013,0,21,22,-1
7,3-4,3,4,Cleveland Browns,2013,0,22,18,4
6,3-3,3,3,Cleveland Browns,2013,0,18,16,2
5,3-2,3,2,Cleveland Browns,2013,0,16,20,-4
4,2-2,2,2,Cleveland Browns,2013,0,20,25,-5
3,1-2,1,2,Cleveland Browns,2013,0,25,31,-6
2,0-2,0,2,Cleveland Browns,2013,0,31,30,1
1,0-1,0,1,Cleveland Browns,2013,0,30,28,2
0,5-11,5,11,Cleveland Browns,2013,0,28,0,28
17,7-9,7,9,Cleveland Browns,2014,0,23,21,2
16,7-8,7,8,Cleveland Browns,2014,0,21,21,0
15,7-7,7,7,Cleveland Browns,2014,0,21,19,2
14,7-6,7,6,Cleveland Browns,2014,0,19,18,1
13,7-5,7,5,Cleveland Browns,2014,0,18,16,2
12,7-4,7,4,Cleveland Browns,2014,0,16,17,-1
11,6-4,6,4,Cleveland Browns,2014,0,17,11,6
10,6-3,6,3,Cleveland Browns,2014,0,11,19,-8
9,5-3,5,3,Cleveland Browns,2014,0,19,19,0
8,4-3,4,3,Cleveland Browns,2014,0,19,20,-1
7,3-3,3,3,Cleveland Browns,2014,0,20,15,5
6,3-2,3,2,Cleveland Browns,2014,0,15,23,-8
5,2-2,2,2,Cleveland Browns,2014,0,23,25,-2
4,1-2,1,2,Cleveland Browns,2014,0,25,24,1
3,1-2,1,2,Cleveland Browns,2014,0,24,23,1
2,1-1,1,1,Cleveland Browns,2014,0,23,29,-6
1,0-1,0,1,Cleveland Browns,2014,0,29,30,-1
0,4-12,4,12,Cleveland Browns,2014,0,30,0,30
17,3-13,3,13,Cleveland Browns,2015,0,32,30,2
16,3-12,3,12,Cleveland Browns,2015,0,30,32,-2
15,3-11,3,11,Cleveland Browns,2015,0,32,32,0
14,3-10,3,10,Cleveland Browns,2015,0,32,32,0
13,2-10,2,10,Cleveland Browns,2015,0,32,32,0
12,2-9,2,9,Cleveland Browns,2015,0,32,32,0
11,2-8,2,8,Cleveland Browns,2015,0,32,32,0
10,2-8,2,8,Cleveland Browns,2015,0,32,28,4
9,2-7,2,7,Cleveland Browns,2015,0,28,23,5
8,2-6,2,6,Cleveland Browns,2015,0,23,24,-1
7,2-5,2,5,Cleveland Browns,2015,0,24,27,-3
6,2-4,2,4,Cleveland Browns,2015,0,27,20,7
5,2-3,2,3,Cleveland Browns,2015,0,20,25,-5
4,1-3,1,3,Cleveland Browns,2015,0,25,26,-1
3,1-2,1,2,Cleveland Browns,2015,0,26,21,5
2,1-1,1,1,Cleveland Browns,2015,0,21,28,-7
1,0-1,0,1,Cleveland Browns,2015,0,28,27,1
0,7-9,7,9,Cleveland Browns,2015,0,27,0,27
17,13-3,13,3,Dallas Cowboys,2007,0,3,3,0
16,13-2,13,2,Dallas Cowboys,2007,0,3,3,0
15,12-2,12,2,Dallas Cowboys,2007,0,3,2,1
14,12-1,12,1,Dallas Cowboys,2007,0,2,2,0
13,11-1,11,1,Dallas Cowboys,2007,0,2,2,0
12,10-1,10,1,Dallas Cowboys,2007,0,2,2,0
11,9-1,9,1,Dallas Cowboys,2007,0,2,2,0
10,8-1,8,1,Dallas Cowboys,2007,0,2,3,-1
9,7-1,7,1,Dallas Cowboys,2007,0,3,3,0
8,6-1,6,1,Dallas Cowboys,2007,0,3,3,0
7,6-1,6,1,Dallas Cowboys,2007,0,3,4,-1
6,5-1,5,1,Dallas Cowboys,2007,0,4,3,1
5,5-0,5,0,Dallas Cowboys,2007,0,3,3,0
4,4-0,4,0,Dallas Cowboys,2007,0,3,3,0
3,3-0,3,0,Dallas Cowboys,2007,0,3,3,0
2,2-0,2,0,Dallas Cowboys,2007,0,3,5,-2
1,1-0,1,0,Dallas Cowboys,2007,0,5,8,-3
0,9-7,9,7,Dallas Cowboys,2007,0,8,0,8
17,9-7,9,7,Dallas Cowboys,2008,0,14,10,4
16,9-6,9,6,Dallas Cowboys,2008,0,10,6,4
15,9-5,9,5,Dallas Cowboys,2008,0,6,8,-2
14,8-5,8,5,Dallas Cowboys,2008,0,8,8,0
13,8-4,8,4,Dallas Cowboys,2008,0,8,9,-1
12,7-4,7,4,Dallas Cowboys,2008,0,9,11,-2
11,6-4,6,4,Dallas Cowboys,2008,0,11,16,-5
10,5-4,5,4,Dallas Cowboys,2008,0,16,19,-3
9,5-4,5,4,Dallas Cowboys,2008,0,19,8,11
8,5-3,5,3,Dallas Cowboys,2008,0,8,15,-7
7,4-3,4,3,Dallas Cowboys,2008,0,15,6,9
6,4-2,4,2,Dallas Cowboys,2008,0,6,4,2
5,4-1,4,1,Dallas Cowboys,2008,0,4,3,1
4,3-1,3,1,Dallas Cowboys,2008,0,3,1,2
3,3-0,3,0,Dallas Cowboys,2008,0,1,1,0
2,2-0,2,0,Dallas Cowboys,2008,0,1,1,0
1,1-0,1,0,Dallas Cowboys,2008,0,1,3,-2
0,13-3,13,3,Dallas Cowboys,2008,0,3,0,3
17,9-7,9,7,Dallas Cowboys,2006,0,11,9,2
16,9-6,9,6,Dallas Cowboys,2006,0,9,7,2
15,9-5,9,5,Dallas Cowboys,2006,0,7,7,0
14,8-5,8,5,Dallas Cowboys,2006,0,7,3,4
13,8-4,8,4,Dallas Cowboys,2006,0,3,6,-3
12,7-4,7,4,Dallas Cowboys,2006,0,6,6,0
11,6-4,6,4,Dallas Cowboys,2006,0,6,10,-4
10,5-4,5,4,Dallas Cowboys,2006,0,10,15,-5
9,4-4,4,4,Dallas Cowboys,2006,0,15,11,4
8,4-3,4,3,Dallas Cowboys,2006,0,11,17,-6
7,3-3,3,3,Dallas Cowboys,2006,0,17,15,2
6,3-2,3,2,Dallas Cowboys,2006,0,15,15,0
5,2-2,2,2,Dallas Cowboys,2006,0,15,11,4
4,2-1,2,1,Dallas Cowboys,2006,0,11,13,-2
3,1-1,1,1,Dallas Cowboys,2006,0,13,13,0
2,1-1,1,1,Dallas Cowboys,2006,0,13,15,-2
1,0-1,0,1,Dallas Cowboys,2006,0,15,8,7
0,9-7,9,7,Dallas Cowboys,2006,0,8,0,8
17,11-5,11,5,Dallas Cowboys,2009,0,4,9,-5
16,10-5,10,5,Dallas Cowboys,2009,0,9,10,-1
15,9-5,9,5,Dallas Cowboys,2009,0,10,11,-1
14,8-5,8,5,Dallas Cowboys,2009,0,11,10,1
13,8-4,8,4,Dallas Cowboys,2009,0,10,7,3
12,8-3,8,3,Dallas Cowboys,2009,0,7,8,-1
11,7-3,7,3,Dallas Cowboys,2009,0,8,10,-2
10,6-3,6,3,Dallas Cowboys,2009,0,10,8,2
9,6-2,6,2,Dallas Cowboys,2009,0,8,8,0
8,5-2,5,2,Dallas Cowboys,2009,0,8,9,-1
7,4-2,4,2,Dallas Cowboys,2009,0,9,19,-10
6,3-2,3,2,Dallas Cowboys,2009,0,19,17,2
5,3-2,3,2,Dallas Cowboys,2009,0,17,17,0
4,2-2,2,2,Dallas Cowboys,2009,0,17,17,0
3,2-1,2,1,Dallas Cowboys,2009,0,17,15,2
2,1-1,1,1,Dallas Cowboys,2009,0,15,13,2
1,1-0,1,0,Dallas Cowboys,2009,0,13,17,-4
0,9-7,9,7,Dallas Cowboys,2009,0,17,0,17
17,6-10,6,10,Dallas Cowboys,2010,0,18,22,-4
16,5-10,5,10,Dallas Cowboys,2010,0,22,18,4
15,5-9,5,9,Dallas Cowboys,2010,0,18,20,-2
14,4-9,4,9,Dallas Cowboys,2010,0,20,24,-4
13,4-8,4,8,Dallas Cowboys,2010,0,24,26,-2
12,3-8,3,8,Dallas Cowboys,2010,0,26,24,2
11,3-7,3,7,Dallas Cowboys,2010,0,24,29,-5
10,2-7,2,7,Dallas Cowboys,2010,0,29,30,-1
9,1-7,1,7,Dallas Cowboys,2010,0,30,29,1
8,1-6,1,6,Dallas Cowboys,2010,0,29,26,3
7,1-5,1,5,Dallas Cowboys,2010,0,26,26,0
6,1-4,1,4,Dallas Cowboys,2010,0,26,19,7
5,1-3,1,3,Dallas Cowboys,2010,0,19,14,5
4,1-2,1,2,Dallas Cowboys,2010,0,14,16,-2
3,1-2,1,2,Dallas Cowboys,2010,0,16,17,-1
2,0-2,0,2,Dallas Cowboys,2010,0,17,8,9
1,0-1,0,1,Dallas Cowboys,2010,0,8,4,4
0,11-5,11,5,Dallas Cowboys,2010,0,4,0,4
17,8-8,8,8,Dallas Cowboys,2011,0,13,11,2
16,8-7,8,7,Dallas Cowboys,2011,0,11,10,1
15,8-6,8,6,Dallas Cowboys,2011,0,10,14,-4
14,7-6,7,6,Dallas Cowboys,2011,0,14,9,5
13,7-5,7,5,Dallas Cowboys,2011,0,9,8,1
12,7-4,7,4,Dallas Cowboys,2011,0,8,9,-1
11,6-4,6,4,Dallas Cowboys,2011,0,9,12,-3
10,5-4,5,4,Dallas Cowboys,2011,0,12,15,-3
9,4-4,4,4,Dallas Cowboys,2011,0,15,21,-6
8,3-4,3,4,Dallas Cowboys,2011,0,21,18,3
7,3-3,3,3,Dallas Cowboys,2011,0,18,21,-3
6,2-3,2,3,Dallas Cowboys,2011,0,21,15,6
5,2-2,2,2,Dallas Cowboys,2011,0,15,17,-2
4,2-2,2,2,Dallas Cowboys,2011,0,17,11,6
3,2-1,2,1,Dallas Cowboys,2011,0,11,13,-2
2,1-1,1,1,Dallas Cowboys,2011,0,13,13,0
1,0-1,0,1,Dallas Cowboys,2011,0,13,14,-1
0,6-10,6,10,Dallas Cowboys,2011,0,14,0,14
17,8-8,8,8,Dallas Cowboys,2012,0,15,14,1
16,8-7,8,7,Dallas Cowboys,2012,0,14,10,4
15,8-6,8,6,Dallas Cowboys,2012,0,10,13,-3
14,7-6,7,6,Dallas Cowboys,2012,0,13,16,-3
13,6-6,6,6,Dallas Cowboys,2012,0,16,19,-3
12,5-6,5,6,Dallas Cowboys,2012,0,19,16,3
11,5-5,5,5,Dallas Cowboys,2012,0,16,15,1
10,4-5,4,5,Dallas Cowboys,2012,0,15,18,-3
9,3-5,3,5,Dallas Cowboys,2012,0,18,14,4
8,3-4,3,4,Dallas Cowboys,2012,0,14,15,-1
7,3-3,3,3,Dallas Cowboys,2012,0,15,18,-3
6,2-3,2,3,Dallas Cowboys,2012,0,18,13,5
5,2-2,2,2,Dallas Cowboys,2012,0,13,15,-2
4,2-2,2,2,Dallas Cowboys,2012,0,15,12,3
3,2-1,2,1,Dallas Cowboys,2012,0,12,15,-3
2,1-1,1,1,Dallas Cowboys,2012,0,15,10,5
1,1-0,1,0,Dallas Cowboys,2012,0,10,14,-4
0,8-8,8,8,Dallas Cowboys,2012,0,14,0,14
17,8-8,8,8,Dallas Cowboys,2013,0,17,15,2
16,8-7,8,7,Dallas Cowboys,2013,0,15,18,-3
15,7-7,7,7,Dallas Cowboys,2013,0,18,15,3
14,7-6,7,6,Dallas Cowboys,2013,0,15,11,4
13,7-5,7,5,Dallas Cowboys,2013,0,11,12,-1
12,6-5,6,5,Dallas Cowboys,2013,0,12,14,-2
11,5-5,5,5,Dallas Cowboys,2013,0,14,15,-1
10,5-5,5,5,Dallas Cowboys,2013,0,15,13,2
9,5-4,5,4,Dallas Cowboys,2013,0,13,13,0
8,4-4,4,4,Dallas Cowboys,2013,0,13,10,3
7,4-3,4,3,Dallas Cowboys,2013,0,10,13,-3
6,3-3,3,3,Dallas Cowboys,2013,0,13,15,-2
5,2-3,2,3,Dallas Cowboys,2013,0,15,18,-3
4,2-2,2,2,Dallas Cowboys,2013,0,18,15,3
3,2-1,2,1,Dallas Cowboys,2013,0,15,15,0
2,1-1,1,1,Dallas Cowboys,2013,0,15,13,2
1,1-0,1,0,Dallas Cowboys,2013,0,13,18,-5
0,8-8,8,8,Dallas Cowboys,2013,0,18,0,18
17,12-4,12,4,Dallas Cowboys,2014,0,5,4,1
16,11-4,11,4,Dallas Cowboys,2014,0,4,6,-2
15,10-4,10,4,Dallas Cowboys,2014,0,6,8,-2
14,9-4,9,4,Dallas Cowboys,2014,0,8,8,0
13,8-4,8,4,Dallas Cowboys,2014,0,8,5,3
12,8-3,8,3,Dallas Cowboys,2014,0,5,6,-1
11,7-3,7,3,Dallas Cowboys,2014,0,6,8,-2
10,7-3,7,3,Dallas Cowboys,2014,0,8,9,-1
9,6-3,6,3,Dallas Cowboys,2014,0,9,4,5
8,6-2,6,2,Dallas Cowboys,2014,0,4,2,2
7,6-1,6,1,Dallas Cowboys,2014,0,2,3,-1
6,5-1,5,1,Dallas Cowboys,2014,0,3,6,-3
5,4-1,4,1,Dallas Cowboys,2014,0,6,10,-4
4,3-1,3,1,Dallas Cowboys,2014,0,10,18,-8
3,2-1,2,1,Dallas Cowboys,2014,0,18,22,-4
2,1-1,1,1,Dallas Cowboys,2014,0,22,27,-5
1,0-1,0,1,Dallas Cowboys,2014,0,27,23,4
0,8-8,8,8,Dallas Cowboys,2014,0,23,0,23
17,4-12,4,12,Dallas Cowboys,2015,0,30,29,1
16,4-11,4,11,Dallas Cowboys,2015,0,29,29,0
15,4-10,4,10,Dallas Cowboys,2015,0,29,24,5
14,4-9,4,9,Dallas Cowboys,2015,0,24,23,1
13,4-8,4,8,Dallas Cowboys,2015,0,23,29,-6
12,3-8,3,8,Dallas Cowboys,2015,0,29,21,8
11,3-7,3,7,Dallas Cowboys,2015,0,21,27,-6
10,2-7,2,7,Dallas Cowboys,2015,0,27,23,4
9,2-6,2,6,Dallas Cowboys,2015,0,23,26,-3
8,2-5,2,5,Dallas Cowboys,2015,0,26,20,6
7,2-4,2,4,Dallas Cowboys,2015,0,20,16,4
6,2-3,2,3,Dallas Cowboys,2015,0,16,18,-2
5,2-3,2,3,Dallas Cowboys,2015,0,18,13,5
4,2-2,2,2,Dallas Cowboys,2015,0,13,11,2
3,2-1,2,1,Dallas Cowboys,2015,0,11,12,-1
2,2-0,2,0,Dallas Cowboys,2015,0,12,5,7
1,1-0,1,0,Dallas Cowboys,2015,0,5,6,-1
0,12-4,12,4,Dallas Cowboys,2015,0,6,0,6
17,9-7,9,7,Denver Broncos,2006,0,12,8,4
16,9-6,9,6,Denver Broncos,2006,0,8,10,-2
15,8-6,8,6,Denver Broncos,2006,0,10,17,-7
14,7-6,7,6,Denver Broncos,2006,0,17,13,4
13,7-5,7,5,Denver Broncos,2006,0,13,9,4
12,7-4,7,4,Denver Broncos,2006,0,9,7,2
11,7-3,7,3,Denver Broncos,2006,0,7,4,3
10,7-2,7,2,Denver Broncos,2006,0,4,2,2
9,6-2,6,2,Denver Broncos,2006,0,2,6,-4
8,5-2,5,2,Denver Broncos,2006,0,6,3,3
7,5-1,5,1,Denver Broncos,2006,0,3,4,-1
6,4-1,4,1,Denver Broncos,2006,0,4,3,1
5,3-1,3,1,Denver Broncos,2006,0,3,8,-5
4,2-1,2,1,Denver Broncos,2006,0,8,8,0
3,2-1,2,1,Denver Broncos,2006,0,8,12,-4
2,1-1,1,1,Denver Broncos,2006,0,12,13,-1
1,0-1,0,1,Denver Broncos,2006,0,13,5,8
0,13-3,13,3,Denver Broncos,2006,0,5,0,5
17,7-9,7,9,Denver Broncos,2007,0,21,22,-1
16,6-9,6,9,Denver Broncos,2007,0,22,19,3
15,6-8,6,8,Denver Broncos,2007,0,19,15,4
14,6-7,6,7,Denver Broncos,2007,0,15,20,-5
13,5-7,5,7,Denver Broncos,2007,0,20,17,3
12,5-6,5,6,Denver Broncos,2007,0,17,14,3
11,5-5,5,5,Denver Broncos,2007,0,14,18,-4
10,4-5,4,5,Denver Broncos,2007,0,18,25,-7
9,3-5,3,5,Denver Broncos,2007,0,25,16,9
8,3-4,3,4,Denver Broncos,2007,0,16,17,-1
7,3-3,3,3,Denver Broncos,2007,0,17,21,-4
6,2-3,2,3,Denver Broncos,2007,0,21,19,2
5,2-3,2,3,Denver Broncos,2007,0,19,10,9
4,2-2,2,2,Denver Broncos,2007,0,10,8,2
3,2-1,2,1,Denver Broncos,2007,0,8,8,0
2,2-0,2,0,Denver Broncos,2007,0,8,10,-2
1,1-0,1,0,Denver Broncos,2007,0,10,9,1
0,9-7,9,7,Denver Broncos,2007,0,9,0,9
17,8-8,8,8,Denver Broncos,2008,0,22,20,2
16,8-7,8,7,Denver Broncos,2008,0,20,17,3
15,8-6,8,6,Denver Broncos,2008,0,17,16,1
14,8-5,8,5,Denver Broncos,2008,0,16,14,2
13,7-5,7,5,Denver Broncos,2008,0,14,19,-5
12,6-5,6,5,Denver Broncos,2008,0,19,15,4
11,6-4,6,4,Denver Broncos,2008,0,15,19,-4
10,5-4,5,4,Denver Broncos,2008,0,19,22,-3
9,4-4,4,4,Denver Broncos,2008,0,22,15,7
8,4-3,4,3,Denver Broncos,2008,0,15,18,-3
7,4-3,4,3,Denver Broncos,2008,0,18,12,6
6,4-2,4,2,Denver Broncos,2008,0,12,7,5
5,4-1,4,1,Denver Broncos,2008,0,7,11,-4
4,3-1,3,1,Denver Broncos,2008,0,11,7,4
3,3-0,3,0,Denver Broncos,2008,0,7,11,-4
2,2-0,2,0,Denver Broncos,2008,0,11,19,-8
1,1-0,1,0,Denver Broncos,2008,0,19,22,-3
0,7-9,7,9,Denver Broncos,2008,0,22,0,22
17,4-12,4,12,Denver Broncos,2010,0,29,31,-2
16,4-11,4,11,Denver Broncos,2010,0,31,31,0
15,3-11,3,11,Denver Broncos,2010,0,31,30,1
14,3-10,3,10,Denver Broncos,2010,0,30,28,2
13,3-9,3,9,Denver Broncos,2010,0,28,28,0
12,3-8,3,8,Denver Broncos,2010,0,28,27,1
11,3-7,3,7,Denver Broncos,2010,0,27,26,1
10,3-6,3,6,Denver Broncos,2010,0,26,29,-3
9,2-6,2,6,Denver Broncos,2010,0,29,28,1
8,2-6,2,6,Denver Broncos,2010,0,28,27,1
7,2-5,2,5,Denver Broncos,2010,0,27,22,5
6,2-4,2,4,Denver Broncos,2010,0,22,23,-1
5,2-3,2,3,Denver Broncos,2010,0,23,21,2
4,2-2,2,2,Denver Broncos,2010,0,21,23,-2
3,1-2,1,2,Denver Broncos,2010,0,23,22,1
2,1-1,1,1,Denver Broncos,2010,0,22,25,-3
1,0-1,0,1,Denver Broncos,2010,0,25,22,3
0,8-8,8,8,Denver Broncos,2010,0,22,0,22
17,8-8,8,8,Denver Broncos,2009,0,17,13,4
16,8-7,8,7,Denver Broncos,2009,0,13,13,0
15,8-6,8,6,Denver Broncos,2009,0,13,10,3
14,8-5,8,5,Denver Broncos,2009,0,10,9,1
13,8-4,8,4,Denver Broncos,2009,0,9,10,-1
12,7-4,7,4,Denver Broncos,2009,0,10,13,-3
11,6-4,6,4,Denver Broncos,2009,0,13,9,4
10,6-3,6,3,Denver Broncos,2009,0,9,7,2
9,6-2,6,2,Denver Broncos,2009,0,7,4,3
8,6-1,6,1,Denver Broncos,2009,0,4,3,1
7,6-0,6,0,Denver Broncos,2009,0,3,4,-1
6,6-0,6,0,Denver Broncos,2009,0,4,5,-1
5,5-0,5,0,Denver Broncos,2009,0,5,8,-3
4,4-0,4,0,Denver Broncos,2009,0,8,13,-5
3,3-0,3,0,Denver Broncos,2009,0,13,20,-7
2,2-0,2,0,Denver Broncos,2009,0,20,24,-4
1,1-0,1,0,Denver Broncos,2009,0,24,27,-3
0,8-8,8,8,Denver Broncos,2009,0,27,0,27
17,8-8,8,8,Denver Broncos,2011,0,14,13,1
16,8-7,8,7,Denver Broncos,2011,0,13,11,2
15,8-6,8,6,Denver Broncos,2011,0,11,9,2
14,8-5,8,5,Denver Broncos,2011,0,9,10,-1
13,7-5,7,5,Denver Broncos,2011,0,10,16,-6
12,6-5,6,5,Denver Broncos,2011,0,16,17,-1
11,5-5,5,5,Denver Broncos,2011,0,17,19,-2
10,4-5,4,5,Denver Broncos,2011,0,19,23,-4
9,3-5,3,5,Denver Broncos,2011,0,23,28,-5
8,2-5,2,5,Denver Broncos,2011,0,28,27,1
7,2-4,2,4,Denver Broncos,2011,0,27,27,0
6,1-4,1,4,Denver Broncos,2011,0,27,27,0
5,1-4,1,4,Denver Broncos,2011,0,27,27,0
4,1-3,1,3,Denver Broncos,2011,0,27,26,1
3,1-2,1,2,Denver Broncos,2011,0,26,24,2
2,1-1,1,1,Denver Broncos,2011,0,24,28,-4
1,0-1,0,1,Denver Broncos,2011,0,28,27,1
0,4-12,4,12,Denver Broncos,2011,0,27,0,27
17,13-3,13,3,Denver Broncos,2012,0,1,1,0
16,12-3,12,3,Denver Broncos,2012,0,1,2,-1
15,11-3,11,3,Denver Broncos,2012,0,2,2,0
14,10-3,10,3,Denver Broncos,2012,0,2,5,-3
13,9-3,9,3,Denver Broncos,2012,0,5,7,-2
12,8-3,8,3,Denver Broncos,2012,0,7,7,0
11,7-3,7,3,Denver Broncos,2012,0,7,7,0
10,6-3,6,3,Denver Broncos,2012,0,7,8,-1
9,5-3,5,3,Denver Broncos,2012,0,8,9,-1
8,4-3,4,3,Denver Broncos,2012,0,9,12,-3
7,3-3,3,3,Denver Broncos,2012,0,12,12,0
6,3-3,3,3,Denver Broncos,2012,0,12,17,-5
5,2-3,2,3,Denver Broncos,2012,0,17,13,4
4,2-2,2,2,Denver Broncos,2012,0,13,14,-1
3,1-2,1,2,Denver Broncos,2012,0,14,10,4
2,1-1,1,1,Denver Broncos,2012,0,10,9,1
1,1-0,1,0,Denver Broncos,2012,0,9,13,-4
0,8-8,8,8,Denver Broncos,2012,0,13,0,13
17,13-3,13,3,Denver Broncos,2013,0,2,2,0
16,12-3,12,3,Denver Broncos,2013,0,2,2,0
15,11-3,11,3,Denver Broncos,2013,0,2,2,0
14,11-2,11,2,Denver Broncos,2013,0,2,2,0
13,10-2,10,2,Denver Broncos,2013,0,2,3,-1
12,9-2,9,2,Denver Broncos,2013,0,3,1,2
11,9-1,9,1,Denver Broncos,2013,0,1,2,-1
10,8-1,8,1,Denver Broncos,2013,0,2,3,-1
9,7-1,7,1,Denver Broncos,2013,0,3,2,1
8,7-1,7,1,Denver Broncos,2013,0,2,3,-1
7,6-1,6,1,Denver Broncos,2013,0,3,1,2
6,6-0,6,0,Denver Broncos,2013,0,1,1,0
5,5-0,5,0,Denver Broncos,2013,0,1,1,0
4,4-0,4,0,Denver Broncos,2013,0,1,2,-1
3,3-0,3,0,Denver Broncos,2013,0,2,2,0
2,2-0,2,0,Denver Broncos,2013,0,2,3,-1
1,1-0,1,0,Denver Broncos,2013,0,3,4,-1
0,13-3,13,3,Denver Broncos,2013,0,4,0,4
17,12-4,12,4,Denver Broncos,2014,0,4,5,-1
16,11-4,11,4,Denver Broncos,2014,0,5,2,3
15,11-3,11,3,Denver Broncos,2014,0,2,3,-1
14,10-3,10,3,Denver Broncos,2014,0,3,3,0
13,9-3,9,3,Denver Broncos,2014,0,3,3,0
12,8-3,8,3,Denver Broncos,2014,0,3,4,-1
11,7-3,7,3,Denver Broncos,2014,0,4,3,1
10,7-2,7,2,Denver Broncos,2014,0,3,3,0
9,6-2,6,2,Denver Broncos,2014,0,3,1,2
8,6-1,6,1,Denver Broncos,2014,0,1,1,0
7,5-1,5,1,Denver Broncos,2014,0,1,1,0
6,4-1,4,1,Denver Broncos,2014,0,1,2,-1
5,3-1,3,1,Denver Broncos,2014,0,2,3,-1
4,2-1,2,1,Denver Broncos,2014,0,3,3,0
3,2-1,2,1,Denver Broncos,2014,0,3,1,2
2,2-0,2,0,Denver Broncos,2014,0,1,2,-1
1,1-0,1,0,Denver Broncos,2014,0,2,2,0
0,13-3,13,3,Denver Broncos,2014,0,2,0,2
17,12-4,12,4,Denver Broncos,2015,0,2,4,-2
16,11-4,11,4,Denver Broncos,2015,0,4,8,-4
15,10-4,10,4,Denver Broncos,2015,0,8,5,3
14,10-3,10,3,Denver Broncos,2015,0,5,4,1
13,10-2,10,2,Denver Broncos,2015,0,4,3,1
12,9-2,9,2,Denver Broncos,2015,0,3,3,0
11,8-2,8,2,Denver Broncos,2015,0,3,7,-4
10,7-2,7,2,Denver Broncos,2015,0,7,4,3
9,7-1,7,1,Denver Broncos,2015,0,4,2,2
8,7-0,7,0,Denver Broncos,2015,0,2,4,-2
7,6-0,6,0,Denver Broncos,2015,0,4,3,1
6,6-0,6,0,Denver Broncos,2015,0,3,4,-1
5,5-0,5,0,Denver Broncos,2015,0,4,3,1
4,4-0,4,0,Denver Broncos,2015,0,3,4,-1
3,3-0,3,0,Denver Broncos,2015,0,4,5,-1
2,2-0,2,0,Denver Broncos,2015,0,5,4,1
1,1-0,1,0,Denver Broncos,2015,0,4,5,-1
0,12-4,12,4,Denver Broncos,2015,0,5,0,5
17,3-13,3,13,Detroit Lions,2006,0,31,32,-1
16,2-13,2,13,Detroit Lions,2006,0,32,32,0
15,2-12,2,12,Detroit Lions,2006,0,32,32,0
14,2-11,2,11,Detroit Lions,2006,0,32,32,0
13,2-10,2,10,Detroit Lions,2006,0,32,32,0
12,2-9,2,9,Detroit Lions,2006,0,32,31,1
11,2-8,2,8,Detroit Lions,2006,0,31,30,1
10,2-7,2,7,Detroit Lions,2006,0,30,26,4
9,2-6,2,6,Detroit Lions,2006,0,26,30,-4
8,1-6,1,6,Detroit Lions,2006,0,30,28,2
7,1-6,1,6,Detroit Lions,2006,0,28,25,3
6,1-5,1,5,Detroit Lions,2006,0,25,31,-6
5,0-5,0,5,Detroit Lions,2006,0,31,30,1
4,0-4,0,4,Detroit Lions,2006,0,30,29,1
3,0-3,0,3,Detroit Lions,2006,0,29,27,2
2,0-2,0,2,Detroit Lions,2006,0,27,25,2
1,0-1,0,1,Detroit Lions,2006,0,25,23,2
0,5-11,5,11,Detroit Lions,2006,0,23,0,23
17,7-9,7,9,Detroit Lions,2007,0,24,21,3
16,7-8,7,8,Detroit Lions,2007,0,21,22,-1
15,6-8,6,8,Detroit Lions,2007,0,22,20,2
14,6-7,6,7,Detroit Lions,2007,0,20,18,2
13,6-6,6,6,Detroit Lions,2007,0,18,14,4
12,6-5,6,5,Detroit Lions,2007,0,14,12,2
11,6-4,6,4,Detroit Lions,2007,0,12,10,2
10,6-3,6,3,Detroit Lions,2007,0,10,8,2
9,6-2,6,2,Detroit Lions,2007,0,8,10,-2
8,5-2,5,2,Detroit Lions,2007,0,10,11,-1
7,4-2,4,2,Detroit Lions,2007,0,11,15,-4
6,3-2,3,2,Detroit Lions,2007,0,15,18,-3
5,3-2,3,2,Detroit Lions,2007,0,18,12,6
4,3-1,3,1,Detroit Lions,2007,0,12,20,-8
3,2-1,2,1,Detroit Lions,2007,0,20,18,2
2,2-0,2,0,Detroit Lions,2007,0,18,21,-3
1,1-0,1,0,Detroit Lions,2007,0,21,25,-4
0,3-13,3,13,Detroit Lions,2007,0,25,0,25
17,0-16,0,16,Detroit Lions,2008,0,32,32,0
16,0-15,0,15,Detroit Lions,2008,0,32,32,0
15,0-14,0,14,Detroit Lions,2008,0,32,32,0
14,0-13,0,13,Detroit Lions,2008,0,32,32,0
13,0-12,0,12,Detroit Lions,2008,0,32,32,0
12,0-11,0,11,Detroit Lions,2008,0,32,32,0
11,0-10,0,10,Detroit Lions,2008,0,32,32,0
10,0-9,0,9,Detroit Lions,2008,0,32,32,0
9,0-8,0,8,Detroit Lions,2008,0,32,32,0
8,0-7,0,7,Detroit Lions,2008,0,32,32,0
7,0-6,0,6,Detroit Lions,2008,0,32,32,0
6,0-5,0,5,Detroit Lions,2008,0,32,31,1
5,0-4,0,4,Detroit Lions,2008,0,31,31,0
4,0-3,0,3,Detroit Lions,2008,0,31,30,1
3,0-3,0,3,Detroit Lions,2008,0,30,29,1
2,0-2,0,2,Detroit Lions,2008,0,29,31,-2
1,0-1,0,1,Detroit Lions,2008,0,31,26,5
0,7-9,7,9,Detroit Lions,2008,0,26,0,26
17,2-14,2,14,Detroit Lions,2009,0,31,31,0
16,2-13,2,13,Detroit Lions,2009,0,31,31,0
15,2-12,2,12,Detroit Lions,2009,0,31,30,1
14,2-11,2,11,Detroit Lions,2009,0,30,29,1
13,2-10,2,10,Detroit Lions,2009,0,29,29,0
12,2-9,2,9,Detroit Lions,2009,0,29,29,0
11,2-8,2,8,Detroit Lions,2009,0,29,31,-2
10,1-8,1,8,Detroit Lions,2009,0,31,29,2
9,1-7,1,7,Detroit Lions,2009,0,29,29,0
8,1-6,1,6,Detroit Lions,2009,0,29,26,3
7,1-5,1,5,Detroit Lions,2009,0,26,26,0
6,1-5,1,5,Detroit Lions,2009,0,26,26,0
5,1-4,1,4,Detroit Lions,2009,0,26,27,-1
4,1-3,1,3,Detroit Lions,2009,0,27,28,-1
3,1-2,1,2,Detroit Lions,2009,0,28,31,-3
2,0-2,0,2,Detroit Lions,2009,0,31,31,0
1,0-1,0,1,Detroit Lions,2009,0,31,32,-1
0,0-16,0,16,Detroit Lions,2009,0,32,0,32
17,6-10,6,10,Detroit Lions,2010,0,24,24,0
16,5-10,5,10,Detroit Lions,2010,0,24,28,-4
15,4-10,4,10,Detroit Lions,2010,0,28,29,-1
14,3-10,3,10,Detroit Lions,2010,0,29,31,-2
13,2-10,2,10,Detroit Lions,2010,0,31,31,0
12,2-9,2,9,Detroit Lions,2010,0,31,31,0
11,2-8,2,8,Detroit Lions,2010,0,31,31,0
10,2-7,2,7,Detroit Lions,2010,0,31,27,4
9,2-6,2,6,Detroit Lions,2010,0,27,27,0
8,2-5,2,5,Detroit Lions,2010,0,27,30,-3
7,1-5,1,5,Detroit Lions,2010,0,30,29,1
6,1-5,1,5,Detroit Lions,2010,0,29,28,1
5,1-4,1,4,Detroit Lions,2010,0,28,31,-3
4,0-4,0,4,Detroit Lions,2010,0,31,31,0
3,0-3,0,3,Detroit Lions,2010,0,31,29,2
2,0-2,0,2,Detroit Lions,2010,0,29,29,0
1,0-1,0,1,Detroit Lions,2010,0,29,28,1
0,2-14,2,14,Detroit Lions,2010,0,28,0,28
17,10-6,10,6,Detroit Lions,2011,0,8,7,1
16,10-5,10,5,Detroit Lions,2011,0,7,9,-2
15,9-5,9,5,Detroit Lions,2011,0,9,11,-2
14,8-5,8,5,Detroit Lions,2011,0,11,12,-1
13,7-5,7,5,Detroit Lions,2011,0,12,11,1
12,7-4,7,4,Detroit Lions,2011,0,11,10,1
11,7-3,7,3,Detroit Lions,2011,0,10,10,0
10,6-3,6,3,Detroit Lions,2011,0,10,7,3
9,6-2,6,2,Detroit Lions,2011,0,7,8,-1
8,6-2,6,2,Detroit Lions,2011,0,8,8,0
7,5-2,5,2,Detroit Lions,2011,0,8,6,2
6,5-1,5,1,Detroit Lions,2011,0,6,4,2
5,5-0,5,0,Detroit Lions,2011,0,4,4,0
4,4-0,4,0,Detroit Lions,2011,0,4,4,0
3,3-0,3,0,Detroit Lions,2011,0,4,11,-7
2,2-0,2,0,Detroit Lions,2011,0,11,12,-1
1,1-0,1,0,Detroit Lions,2011,0,12,16,-4
0,6-10,6,10,Detroit Lions,2011,0,16,0,16
17,11-5,11,5,Detroit Lions,2014,0,7,6,1
16,11-4,11,4,Detroit Lions,2014,0,6,8,-2
15,10-4,10,4,Detroit Lions,2014,0,8,9,-1
14,9-4,9,4,Detroit Lions,2014,0,9,11,-2
13,8-4,8,4,Detroit Lions,2014,0,11,13,-2
12,7-4,7,4,Detroit Lions,2014,0,13,7,6
11,7-3,7,3,Detroit Lions,2014,0,7,6,1
10,7-2,7,2,Detroit Lions,2014,0,6,6,0
9,6-2,6,2,Detroit Lions,2014,0,6,6,0
8,6-2,6,2,Detroit Lions,2014,0,6,10,-4
7,5-2,5,2,Detroit Lions,2014,0,10,13,-3
6,4-2,4,2,Detroit Lions,2014,0,13,14,-1
5,3-2,3,2,Detroit Lions,2014,0,14,8,6
4,3-1,3,1,Detroit Lions,2014,0,8,12,-4
3,2-1,2,1,Detroit Lions,2014,0,12,18,-6
2,1-1,1,1,Detroit Lions,2014,0,18,13,5
1,1-0,1,0,Detroit Lions,2014,0,13,18,-5
0,7-9,7,9,Detroit Lions,2014,0,18,0,18
17,4-12,4,12,Detroit Lions,2012,0,28,28,0
16,4-11,4,11,Detroit Lions,2012,0,28,28,0
15,4-10,4,10,Detroit Lions,2012,0,28,25,3
14,4-9,4,9,Detroit Lions,2012,0,25,21,4
13,4-8,4,8,Detroit Lions,2012,0,21,20,1
12,4-7,4,7,Detroit Lions,2012,0,20,19,1
11,4-6,4,6,Detroit Lions,2012,0,19,17,2
10,4-5,4,5,Detroit Lions,2012,0,17,14,3
9,4-4,4,4,Detroit Lions,2012,0,14,17,-3
8,3-4,3,4,Detroit Lions,2012,0,17,19,-2
7,2-4,2,4,Detroit Lions,2012,0,19,19,0
6,2-3,2,3,Detroit Lions,2012,0,19,20,-1
5,1-3,1,3,Detroit Lions,2012,0,20,20,0
4,1-3,1,3,Detroit Lions,2012,0,20,18,2
3,1-2,1,2,Detroit Lions,2012,0,18,13,5
2,1-1,1,1,Detroit Lions,2012,0,13,13,0
1,1-0,1,0,Detroit Lions,2012,0,13,12,1
0,10-6,10,6,Detroit Lions,2012,0,12,0,12
17,7-9,7,9,Detroit Lions,2013,0,21,20,1
16,7-8,7,8,Detroit Lions,2013,0,20,17,3
15,7-7,7,7,Detroit Lions,2013,0,17,12,5
14,7-6,7,6,Detroit Lions,2013,0,12,12,0
13,7-5,7,5,Detroit Lions,2013,0,12,13,-1
12,6-5,6,5,Detroit Lions,2013,0,13,11,2
11,6-4,6,4,Detroit Lions,2013,0,11,9,2
10,6-3,6,3,Detroit Lions,2013,0,9,10,-1
9,5-3,5,3,Detroit Lions,2013,0,10,10,0
8,5-3,5,3,Detroit Lions,2013,0,10,11,-1
7,4-3,4,3,Detroit Lions,2013,0,11,11,0
6,4-2,4,2,Detroit Lions,2013,0,11,12,-1
5,3-2,3,2,Detroit Lions,2013,0,12,10,2
4,3-1,3,1,Detroit Lions,2013,0,10,16,-6
3,2-1,2,1,Detroit Lions,2013,0,16,18,-2
2,1-1,1,1,Detroit Lions,2013,0,18,18,0
1,1-0,1,0,Detroit Lions,2013,0,18,21,-3
0,4-12,4,12,Detroit Lions,2013,0,21,0,21
17,7-9,7,9,Detroit Lions,2015,0,20,23,-3
16,6-9,6,9,Detroit Lions,2015,0,23,26,-3
15,5-9,5,9,Detroit Lions,2015,0,26,25,1
14,4-9,4,9,Detroit Lions,2015,0,25,22,3
13,4-8,4,8,Detroit Lions,2015,0,22,21,1
12,4-7,4,7,Detroit Lions,2015,0,21,24,-3
11,3-7,3,7,Detroit Lions,2015,0,24,30,-6
10,2-7,2,7,Detroit Lions,2015,0,30,32,-2
9,1-7,1,7,Detroit Lions,2015,0,32,30,2
8,1-7,1,7,Detroit Lions,2015,0,30,31,-1
7,1-6,1,6,Detroit Lions,2015,0,31,24,7
6,1-5,1,5,Detroit Lions,2015,0,24,31,-7
5,0-5,0,5,Detroit Lions,2015,0,31,26,5
4,0-4,0,4,Detroit Lions,2015,0,26,25,1
3,0-3,0,3,Detroit Lions,2015,0,25,24,1
2,0-2,0,2,Detroit Lions,2015,0,24,20,4
1,0-1,0,1,Detroit Lions,2015,0,20,12,8
0,11-5,11,5,Detroit Lions,2015,0,12,0,12
17,8-8,8,8,Green Bay Packers,2006,0,19,17,2
16,7-8,7,8,Green Bay Packers,2006,0,17,22,-5
15,6-8,6,8,Green Bay Packers,2006,0,22,23,-1
14,5-8,5,8,Green Bay Packers,2006,0,23,28,-5
13,4-8,4,8,Green Bay Packers,2006,0,28,26,2
12,4-7,4,7,Green Bay Packers,2006,0,26,22,4
11,4-6,4,6,Green Bay Packers,2006,0,22,20,2
10,4-5,4,5,Green Bay Packers,2006,0,20,22,-2
9,3-5,3,5,Green Bay Packers,2006,0,22,20,2
8,3-4,3,4,Green Bay Packers,2006,0,20,23,-3
7,2-4,2,4,Green Bay Packers,2006,0,23,31,-8
6,1-4,1,4,Green Bay Packers,2006,0,31,29,2
5,1-4,1,4,Green Bay Packers,2006,0,29,28,1
4,1-3,1,3,Green Bay Packers,2006,0,28,26,2
3,1-2,1,2,Green Bay Packers,2006,0,26,30,-4
2,0-2,0,2,Green Bay Packers,2006,0,30,32,-2
1,0-1,0,1,Green Bay Packers,2006,0,32,28,4
0,4-12,4,12,Green Bay Packers,2006,0,28,0,28
17,13-3,13,3,Green Bay Packers,2007,0,5,5,0
16,12-3,12,3,Green Bay Packers,2007,0,5,4,1
15,12-2,12,2,Green Bay Packers,2007,0,4,4,0
14,11-2,11,2,Green Bay Packers,2007,0,4,4,0
13,10-2,10,2,Green Bay Packers,2007,0,4,3,1
12,10-1,10,1,Green Bay Packers,2007,0,3,3,0
11,9-1,9,1,Green Bay Packers,2007,0,3,4,-1
10,8-1,8,1,Green Bay Packers,2007,0,4,5,-1
9,7-1,7,1,Green Bay Packers,2007,0,5,4,1
8,6-1,6,1,Green Bay Packers,2007,0,4,5,-1
7,5-1,5,1,Green Bay Packers,2007,0,5,6,-1
6,5-1,5,1,Green Bay Packers,2007,0,6,5,1
5,4-1,4,1,Green Bay Packers,2007,0,5,4,1
4,4-0,4,0,Green Bay Packers,2007,0,4,6,-2
3,3-0,3,0,Green Bay Packers,2007,0,6,12,-6
2,2-0,2,0,Green Bay Packers,2007,0,12,17,-5
1,1-0,1,0,Green Bay Packers,2007,0,17,24,-7
0,8-8,8,8,Green Bay Packers,2007,0,24,0,24
17,6-10,6,10,Green Bay Packers,2008,0,24,24,0
16,5-10,5,10,Green Bay Packers,2008,0,24,25,-1
15,5-9,5,9,Green Bay Packers,2008,0,25,23,2
14,5-8,5,8,Green Bay Packers,2008,0,23,20,3
13,5-7,5,7,Green Bay Packers,2008,0,20,20,0
12,5-6,5,6,Green Bay Packers,2008,0,20,16,4
11,5-5,5,5,Green Bay Packers,2008,0,16,21,-5
10,4-5,4,5,Green Bay Packers,2008,0,21,16,5
9,4-4,4,4,Green Bay Packers,2008,0,16,11,5
8,4-3,4,3,Green Bay Packers,2008,0,11,10,1
7,4-3,4,3,Green Bay Packers,2008,0,10,19,-9
6,3-3,3,3,Green Bay Packers,2008,0,19,21,-2
5,2-3,2,3,Green Bay Packers,2008,0,21,15,6
4,2-2,2,2,Green Bay Packers,2008,0,15,8,7
3,2-1,2,1,Green Bay Packers,2008,0,8,4,4
2,2-0,2,0,Green Bay Packers,2008,0,4,7,-3
1,1-0,1,0,Green Bay Packers,2008,0,7,10,-3
0,13-3,13,3,Green Bay Packers,2008,0,10,0,10
17,15-1,15,1,Green Bay Packers,2011,0,1,1,0
16,14-1,14,1,Green Bay Packers,2011,0,1,1,0
15,13-1,13,1,Green Bay Packers,2011,0,1,1,0
14,13-0,13,0,Green Bay Packers,2011,0,1,1,0
13,12-0,12,0,Green Bay Packers,2011,0,1,1,0
12,11-0,11,0,Green Bay Packers,2011,0,1,1,0
11,10-0,10,0,Green Bay Packers,2011,0,1,1,0
10,9-0,9,0,Green Bay Packers,2011,0,1,1,0
9,8-0,8,0,Green Bay Packers,2011,0,1,1,0
8,7-0,7,0,Green Bay Packers,2011,0,1,1,0
7,7-0,7,0,Green Bay Packers,2011,0,1,1,0
6,6-0,6,0,Green Bay Packers,2011,0,1,1,0
5,5-0,5,0,Green Bay Packers,2011,0,1,1,0
4,4-0,4,0,Green Bay Packers,2011,0,1,1,0
3,3-0,3,0,Green Bay Packers,2011,0,1,1,0
2,2-0,2,0,Green Bay Packers,2011,0,1,1,0
1,1-0,1,0,Green Bay Packers,2011,0,1,1,0
0,10-6,10,6,Green Bay Packers,2011,0,1,0,1
17,10-6,10,6,Green Bay Packers,2010,0,9,9,0
16,9-6,9,6,Green Bay Packers,2010,0,9,12,-3
15,8-6,8,6,Green Bay Packers,2010,0,12,10,2
14,8-5,8,5,Green Bay Packers,2010,0,10,7,3
13,8-4,8,4,Green Bay Packers,2010,0,7,8,-1
12,7-4,7,4,Green Bay Packers,2010,0,8,7,1
11,7-3,7,3,Green Bay Packers,2010,0,7,7,0
10,6-3,6,3,Green Bay Packers,2010,0,7,7,0
9,6-3,6,3,Green Bay Packers,2010,0,7,8,-1
8,5-3,5,3,Green Bay Packers,2010,0,8,10,-2
7,4-3,4,3,Green Bay Packers,2010,0,10,15,-5
6,3-3,3,3,Green Bay Packers,2010,0,15,8,7
5,3-2,3,2,Green Bay Packers,2010,0,8,3,5
4,3-1,3,1,Green Bay Packers,2010,0,3,4,-1
3,2-1,2,1,Green Bay Packers,2010,0,4,2,2
2,2-0,2,0,Green Bay Packers,2010,0,2,2,0
1,1-0,1,0,Green Bay Packers,2010,0,2,3,-1
0,11-5,11,5,Green Bay Packers,2010,0,3,0,3
17,11-5,11,5,Green Bay Packers,2009,0,6,8,-2
16,10-5,10,5,Green Bay Packers,2009,0,8,8,0
15,9-5,9,5,Green Bay Packers,2009,0,8,6,2
14,9-4,9,4,Green Bay Packers,2009,0,6,7,-1
13,8-4,8,4,Green Bay Packers,2009,0,7,11,-4
12,7-4,7,4,Green Bay Packers,2009,0,11,12,-1
11,6-4,6,4,Green Bay Packers,2009,0,12,15,-3
10,5-4,5,4,Green Bay Packers,2009,0,15,16,-1
9,4-4,4,4,Green Bay Packers,2009,0,16,12,4
8,4-3,4,3,Green Bay Packers,2009,0,12,13,-1
7,4-2,4,2,Green Bay Packers,2009,0,13,13,0
6,3-2,3,2,Green Bay Packers,2009,0,13,14,-1
5,2-2,2,2,Green Bay Packers,2009,0,14,13,1
4,2-2,2,2,Green Bay Packers,2009,0,13,10,3
3,2-1,2,1,Green Bay Packers,2009,0,10,12,-2
2,1-1,1,1,Green Bay Packers,2009,0,12,11,1
1,1-0,1,0,Green Bay Packers,2009,0,11,12,-1
0,6-10,6,10,Green Bay Packers,2009,0,12,0,12
17,11-5,11,5,Green Bay Packers,2012,0,6,4,2
16,11-4,11,4,Green Bay Packers,2012,0,4,6,-2
15,10-4,10,4,Green Bay Packers,2012,0,6,6,0
14,9-4,9,4,Green Bay Packers,2012,0,6,7,-1
13,8-4,8,4,Green Bay Packers,2012,0,7,9,-2
12,7-4,7,4,Green Bay Packers,2012,0,9,4,5
11,7-3,7,3,Green Bay Packers,2012,0,4,6,-2
10,6-3,6,3,Green Bay Packers,2012,0,6,6,0
9,6-3,6,3,Green Bay Packers,2012,0,6,6,0
8,5-3,5,3,Green Bay Packers,2012,0,6,7,-1
7,4-3,4,3,Green Bay Packers,2012,0,7,8,-1
6,3-3,3,3,Green Bay Packers,2012,0,8,12,-4
5,2-3,2,3,Green Bay Packers,2012,0,12,8,4
4,2-2,2,2,Green Bay Packers,2012,0,8,7,1
3,1-2,1,2,Green Bay Packers,2012,0,7,4,3
2,1-1,1,1,Green Bay Packers,2012,0,4,5,-1
1,0-1,0,1,Green Bay Packers,2012,0,5,1,4
0,15-1,15,1,Green Bay Packers,2012,0,1,0,1
17,8-7,8,7,Green Bay Packers,2013,0,13,17,-4
16,7-7,7,7,Green Bay Packers,2013,0,17,16,1
15,7-6,7,6,Green Bay Packers,2013,0,16,18,-2
14,6-6,6,6,Green Bay Packers,2013,0,18,19,-1
13,5-6,5,6,Green Bay Packers,2013,0,19,17,2
12,5-5,5,5,Green Bay Packers,2013,0,17,15,2
11,5-5,5,5,Green Bay Packers,2013,0,15,13,2
10,5-4,5,4,Green Bay Packers,2013,0,13,11,2
9,5-3,5,3,Green Bay Packers,2013,0,11,8,3
8,5-2,5,2,Green Bay Packers,2013,0,8,9,-1
7,4-2,4,2,Green Bay Packers,2013,0,9,9,0
6,3-2,3,2,Green Bay Packers,2013,0,9,11,-2
5,2-2,2,2,Green Bay Packers,2013,0,11,12,-1
4,1-2,1,2,Green Bay Packers,2013,0,12,12,0
3,1-2,1,2,Green Bay Packers,2013,0,12,5,7
2,1-1,1,1,Green Bay Packers,2013,0,5,7,-2
1,0-1,0,1,Green Bay Packers,2013,0,7,5,2
0,11-5,11,5,Green Bay Packers,2013,0,5,0,5
17,12-4,12,4,Green Bay Packers,2014,0,3,3,0
16,11-4,11,4,Green Bay Packers,2014,0,3,4,-1
15,10-4,10,4,Green Bay Packers,2014,0,4,1,3
14,10-3,10,3,Green Bay Packers,2014,0,1,1,0
13,9-3,9,3,Green Bay Packers,2014,0,1,2,-1
12,8-3,8,3,Green Bay Packers,2014,0,2,3,-1
11,7-3,7,3,Green Bay Packers,2014,0,3,5,-2
10,6-3,6,3,Green Bay Packers,2014,0,5,8,-3
9,5-3,5,3,Green Bay Packers,2014,0,8,7,1
8,5-3,5,3,Green Bay Packers,2014,0,7,6,1
7,5-2,5,2,Green Bay Packers,2014,0,6,9,-3
6,4-2,4,2,Green Bay Packers,2014,0,9,9,0
5,3-2,3,2,Green Bay Packers,2014,0,9,12,-3
4,2-2,2,2,Green Bay Packers,2014,0,12,17,-5
3,1-2,1,2,Green Bay Packers,2014,0,17,8,9
2,1-1,1,1,Green Bay Packers,2014,0,8,8,0
1,0-1,0,1,Green Bay Packers,2014,0,8,6,2
0,8-7,8,7,Green Bay Packers,2014,0,6,0,6
17,10-6,10,6,Green Bay Packers,2015,0,10,8,2
16,10-5,10,5,Green Bay Packers,2015,0,8,6,2
15,10-4,10,4,Green Bay Packers,2015,0,6,7,-1
14,9-4,9,4,Green Bay Packers,2015,0,7,7,0
13,8-4,8,4,Green Bay Packers,2015,0,7,8,-1
12,7-4,7,4,Green Bay Packers,2015,0,8,6,2
11,7-3,7,3,Green Bay Packers,2015,0,6,6,0
10,6-3,6,3,Green Bay Packers,2015,0,6,5,1
9,6-2,6,2,Green Bay Packers,2015,0,5,4,1
8,6-1,6,1,Green Bay Packers,2015,0,4,2,2
7,6-0,6,0,Green Bay Packers,2015,0,2,2,0
6,6-0,6,0,Green Bay Packers,2015,0,2,2,0
5,5-0,5,0,Green Bay Packers,2015,0,2,2,0
4,4-0,4,0,Green Bay Packers,2015,0,2,3,-1
3,3-0,3,0,Green Bay Packers,2015,0,3,2,1
2,2-0,2,0,Green Bay Packers,2015,0,2,2,0
1,1-0,1,0,Green Bay Packers,2015,0,2,3,-1
0,12-4,12,4,Green Bay Packers,2015,0,3,0,3
17,6-10,6,10,Houston Texans,2006,0,25,28,-3
16,5-10,5,10,Houston Texans,2006,0,28,29,-1
15,4-10,4,10,Houston Texans,2006,0,29,28,1
14,4-9,4,9,Houston Texans,2006,0,28,27,1
13,4-8,4,8,Houston Texans,2006,0,27,27,0
12,3-8,3,8,Houston Texans,2006,0,27,26,1
11,3-7,3,7,Houston Texans,2006,0,26,26,0
10,3-6,3,6,Houston Texans,2006,0,26,28,-2
9,2-6,2,6,Houston Texans,2006,0,28,25,3
8,2-5,2,5,Houston Texans,2006,0,25,22,3
7,2-4,2,4,Houston Texans,2006,0,22,30,-8
6,1-4,1,4,Houston Texans,2006,0,30,24,6
5,1-3,1,3,Houston Texans,2006,0,24,25,-1
4,1-3,1,3,Houston Texans,2006,0,25,31,-6
3,0-3,0,3,Houston Texans,2006,0,31,29,2
2,0-2,0,2,Houston Texans,2006,0,29,27,2
1,0-1,0,1,Houston Texans,2006,0,27,24,3
0,2-14,2,14,Houston Texans,2006,0,24,0,24
17,8-8,8,8,Houston Texans,2008,0,18,21,-3
16,7-8,7,8,Houston Texans,2008,0,21,18,3
15,7-7,7,7,Houston Texans,2008,0,18,20,-2
14,6-7,6,7,Houston Texans,2008,0,20,22,-2
13,5-7,5,7,Houston Texans,2008,0,22,23,-1
12,4-7,4,7,Houston Texans,2008,0,23,25,-2
11,3-7,3,7,Houston Texans,2008,0,25,25,0
10,3-6,3,6,Houston Texans,2008,0,25,25,0
9,3-5,3,5,Houston Texans,2008,0,25,25,0
8,3-4,3,4,Houston Texans,2008,0,25,23,2
7,2-4,2,4,Houston Texans,2008,0,23,26,-3
6,1-4,1,4,Houston Texans,2008,0,26,28,-2
5,0-4,0,4,Houston Texans,2008,0,28,27,1
4,0-3,0,3,Houston Texans,2008,0,27,27,0
3,0-2,0,2,Houston Texans,2008,0,27,24,3
2,0-1,0,1,Houston Texans,2008,0,24,24,0
1,0-1,0,1,Houston Texans,2008,0,24,20,4
0,8-8,8,8,Houston Texans,2008,0,20,0,20
17,9-7,9,7,Houston Texans,2009,0,14,15,-1
16,8-7,8,7,Houston Texans,2009,0,15,20,-5
15,7-7,7,7,Houston Texans,2009,0,20,20,0
14,6-7,6,7,Houston Texans,2009,0,20,22,-2
13,5-7,5,7,Houston Texans,2009,0,22,18,4
12,5-6,5,6,Houston Texans,2009,0,18,18,0
11,5-5,5,5,Houston Texans,2009,0,18,13,5
10,5-4,5,4,Houston Texans,2009,0,13,13,0
9,5-4,5,4,Houston Texans,2009,0,13,14,-1
8,5-3,5,3,Houston Texans,2009,0,14,17,-3
7,4-3,4,3,Houston Texans,2009,0,17,17,0
6,3-3,3,3,Houston Texans,2009,0,17,22,-5
5,2-3,2,3,Houston Texans,2009,0,22,20,2
4,2-2,2,2,Houston Texans,2009,0,20,20,0
3,1-2,1,2,Houston Texans,2009,0,20,17,3
2,1-1,1,1,Houston Texans,2009,0,17,23,-6
1,0-1,0,1,Houston Texans,2009,0,23,19,4
0,8-8,8,8,Houston Texans,2009,0,19,0,19
17,8-8,8,8,Houston Texans,2007,0,16,18,-2
16,7-8,7,8,Houston Texans,2007,0,18,15,3
15,7-7,7,7,Houston Texans,2007,0,15,19,-4
14,6-7,6,7,Houston Texans,2007,0,19,22,-3
13,5-7,5,7,Houston Texans,2007,0,22,21,1
12,5-6,5,6,Houston Texans,2007,0,21,17,4
11,5-5,5,5,Houston Texans,2007,0,17,22,-5
10,4-5,4,5,Houston Texans,2007,0,22,20,2
9,4-5,4,5,Houston Texans,2007,0,20,24,-4
8,3-5,3,5,Houston Texans,2007,0,24,21,3
7,3-4,3,4,Houston Texans,2007,0,21,20,1
6,3-3,3,3,Houston Texans,2007,0,20,16,4
5,3-2,3,2,Houston Texans,2007,0,16,17,-1
4,2-2,2,2,Houston Texans,2007,0,17,17,0
3,2-1,2,1,Houston Texans,2007,0,17,11,6
2,2-0,2,0,Houston Texans,2007,0,11,25,-14
1,1-0,1,0,Houston Texans,2007,0,25,29,-4
0,6-10,6,10,Houston Texans,2007,0,29,0,29
17,6-10,6,10,Houston Texans,2010,0,21,23,-2
16,5-10,5,10,Houston Texans,2010,0,23,21,2
15,5-9,5,9,Houston Texans,2010,0,21,19,2
14,5-8,5,8,Houston Texans,2010,0,19,19,0
13,5-7,5,7,Houston Texans,2010,0,19,17,2
12,5-6,5,6,Houston Texans,2010,0,17,20,-3
11,4-6,4,6,Houston Texans,2010,0,20,19,1
10,4-5,4,5,Houston Texans,2010,0,19,15,4
9,4-4,4,4,Houston Texans,2010,0,15,13,2
8,4-3,4,3,Houston Texans,2010,0,13,8,5
7,4-2,4,2,Houston Texans,2010,0,8,9,-1
6,4-2,4,2,Houston Texans,2010,0,9,13,-4
5,3-2,3,2,Houston Texans,2010,0,13,7,6
4,3-1,3,1,Houston Texans,2010,0,7,9,-2
3,2-1,2,1,Houston Texans,2010,0,9,3,6
2,2-0,2,0,Houston Texans,2010,0,3,7,-4
1,1-0,1,0,Houston Texans,2010,0,7,14,-7
0,9-7,9,7,Houston Texans,2010,0,14,0,14
17,10-6,10,6,Houston Texans,2011,0,10,9,1
16,10-5,10,5,Houston Texans,2011,0,9,7,2
15,10-4,10,4,Houston Texans,2011,0,7,7,0
14,10-3,10,3,Houston Texans,2011,0,7,7,0
13,9-3,9,3,Houston Texans,2011,0,7,7,0
12,8-3,8,3,Houston Texans,2011,0,7,8,-1
11,7-3,7,3,Houston Texans,2011,0,8,9,-1
10,7-3,7,3,Houston Texans,2011,0,9,8,1
9,6-3,6,3,Houston Texans,2011,0,8,11,-3
8,5-3,5,3,Houston Texans,2011,0,11,12,-1
7,4-3,4,3,Houston Texans,2011,0,12,17,-5
6,3-3,3,3,Houston Texans,2011,0,17,12,5
5,3-2,3,2,Houston Texans,2011,0,12,6,6
4,3-1,3,1,Houston Texans,2011,0,6,8,-2
3,2-1,2,1,Houston Texans,2011,0,8,5,3
2,2-0,2,0,Houston Texans,2011,0,5,10,-5
1,1-0,1,0,Houston Texans,2011,0,10,11,-1
0,6-10,6,10,Houston Texans,2011,0,11,0,11
17,12-4,12,4,Houston Texans,2012,0,9,7,2
16,12-3,12,3,Houston Texans,2012,0,7,3,4
15,12-2,12,2,Houston Texans,2012,0,3,3,0
14,11-2,11,2,Houston Texans,2012,0,3,1,2
13,11-1,11,1,Houston Texans,2012,0,1,1,0
12,10-1,10,1,Houston Texans,2012,0,1,1,0
11,9-1,9,1,Houston Texans,2012,0,1,1,0
10,8-1,8,1,Houston Texans,2012,0,1,2,-1
9,7-1,7,1,Houston Texans,2012,0,2,3,-1
8,6-1,6,1,Houston Texans,2012,0,3,3,0
7,6-1,6,1,Houston Texans,2012,0,3,2,1
6,5-1,5,1,Houston Texans,2012,0,2,1,1
5,5-0,5,0,Houston Texans,2012,0,1,1,0
4,4-0,4,0,Houston Texans,2012,0,1,1,0
3,3-0,3,0,Houston Texans,2012,0,1,2,-1
2,2-0,2,0,Houston Texans,2012,0,2,4,-2
1,1-0,1,0,Houston Texans,2012,0,4,5,-1
0,10-6,10,6,Houston Texans,2012,0,5,0,5
17,9-7,9,7,Houston Texans,2014,0,14,15,-1
16,8-7,8,7,Houston Texans,2014,0,15,18,-3
15,7-7,7,7,Houston Texans,2014,0,18,18,0
14,7-6,7,6,Houston Texans,2014,0,18,20,-2
13,6-6,6,6,Houston Texans,2014,0,20,20,0
12,5-6,5,6,Houston Texans,2014,0,20,18,2
11,5-5,5,5,Houston Texans,2014,0,18,20,-2
10,4-5,4,5,Houston Texans,2014,0,20,20,0
9,4-5,4,5,Houston Texans,2014,0,20,21,-1
8,4-4,4,4,Houston Texans,2014,0,21,23,-2
7,3-4,3,4,Houston Texans,2014,0,23,19,4
6,3-3,3,3,Houston Texans,2014,0,19,17,2
5,3-2,3,2,Houston Texans,2014,0,17,13,4
4,3-1,3,1,Houston Texans,2014,0,13,20,-7
3,2-1,2,1,Houston Texans,2014,0,20,14,6
2,2-0,2,0,Houston Texans,2014,0,14,22,-8
1,1-0,1,0,Houston Texans,2014,0,22,27,-5
0,2-14,2,14,Houston Texans,2014,0,27,0,27
17,2-14,2,14,Houston Texans,2013,0,32,32,0
16,2-13,2,13,Houston Texans,2013,0,32,32,0
15,2-12,2,12,Houston Texans,2013,0,32,32,0
14,2-11,2,11,Houston Texans,2013,0,32,32,0
13,2-10,2,10,Houston Texans,2013,0,32,32,0
12,2-9,2,9,Houston Texans,2013,0,32,29,3
11,2-8,2,8,Houston Texans,2013,0,29,28,1
10,2-7,2,7,Houston Texans,2013,0,28,28,0
9,2-6,2,6,Houston Texans,2013,0,28,28,0
8,2-5,2,5,Houston Texans,2013,0,28,26,2
7,2-5,2,5,Houston Texans,2013,0,26,22,4
6,2-4,2,4,Houston Texans,2013,0,22,17,5
5,2-3,2,3,Houston Texans,2013,0,17,15,2
4,2-2,2,2,Houston Texans,2013,0,15,13,2
3,2-1,2,1,Houston Texans,2013,0,13,4,9
2,2-0,2,0,Houston Texans,2013,0,4,6,-2
1,1-0,1,0,Houston Texans,2013,0,6,7,-1
0,12-4,12,4,Houston Texans,2013,0,7,0,7
17,9-7,9,7,Houston Texans,2015,0,13,14,-1
16,8-7,8,7,Houston Texans,2015,0,14,13,1
15,7-7,7,7,Houston Texans,2015,0,13,13,0
14,6-7,6,7,Houston Texans,2015,0,13,13,0
13,6-6,6,6,Houston Texans,2015,0,13,11,2
12,6-5,6,5,Houston Texans,2015,0,11,17,-6
11,5-5,5,5,Houston Texans,2015,0,17,22,-5
10,4-5,4,5,Houston Texans,2015,0,22,27,-5
9,3-5,3,5,Houston Texans,2015,0,27,25,2
8,3-5,3,5,Houston Texans,2015,0,25,29,-4
7,2-5,2,5,Houston Texans,2015,0,29,26,3
6,2-4,2,4,Houston Texans,2015,0,26,30,-4
5,1-4,1,4,Houston Texans,2015,0,30,28,2
4,1-3,1,3,Houston Texans,2015,0,28,21,7
3,1-2,1,2,Houston Texans,2015,0,21,25,-4
2,0-2,0,2,Houston Texans,2015,0,25,26,-1
1,0-1,0,1,Houston Texans,2015,0,26,20,6
0,9-7,9,7,Houston Texans,2015,0,20,0,20
17,13-3,13,3,Indianapolis Colts,2007,0,2,2,0
16,13-2,13,2,Indianapolis Colts,2007,0,2,2,0
15,12-2,12,2,Indianapolis Colts,2007,0,2,3,-1
14,11-2,11,2,Indianapolis Colts,2007,0,3,3,0
13,10-2,10,2,Indianapolis Colts,2007,0,3,4,-1
12,9-2,9,2,Indianapolis Colts,2007,0,4,4,0
11,8-2,8,2,Indianapolis Colts,2007,0,4,3,1
10,7-2,7,2,Indianapolis Colts,2007,0,3,2,1
9,7-1,7,1,Indianapolis Colts,2007,0,2,2,0
8,7-0,7,0,Indianapolis Colts,2007,0,2,2,0
7,6-0,6,0,Indianapolis Colts,2007,0,2,2,0
6,5-0,5,0,Indianapolis Colts,2007,0,2,2,0
5,5-0,5,0,Indianapolis Colts,2007,0,2,2,0
4,4-0,4,0,Indianapolis Colts,2007,0,2,2,0
3,3-0,3,0,Indianapolis Colts,2007,0,2,2,0
2,2-0,2,0,Indianapolis Colts,2007,0,2,2,0
1,1-0,1,0,Indianapolis Colts,2007,0,2,2,0
0,12-4,12,4,Indianapolis Colts,2007,0,2,0,2
17,12-4,12,4,Indianapolis Colts,2006,0,4,6,-2
16,11-4,11,4,Indianapolis Colts,2006,0,6,3,3
15,11-3,11,3,Indianapolis Colts,2006,0,3,6,-3
14,10-3,10,3,Indianapolis Colts,2006,0,6,2,4
13,10-2,10,2,Indianapolis Colts,2006,0,2,1,1
12,10-1,10,1,Indianapolis Colts,2006,0,1,2,-1
11,9-1,9,1,Indianapolis Colts,2006,0,2,1,1
10,9-0,9,0,Indianapolis Colts,2006,0,1,1,0
9,8-0,8,0,Indianapolis Colts,2006,0,1,2,-1
8,7-0,7,0,Indianapolis Colts,2006,0,2,2,0
7,6-0,6,0,Indianapolis Colts,2006,0,2,2,0
6,5-0,5,0,Indianapolis Colts,2006,0,2,2,0
5,5-0,5,0,Indianapolis Colts,2006,0,2,2,0
4,4-0,4,0,Indianapolis Colts,2006,0,2,1,1
3,3-0,3,0,Indianapolis Colts,2006,0,1,1,0
2,2-0,2,0,Indianapolis Colts,2006,0,1,2,-1
1,1-0,1,0,Indianapolis Colts,2006,0,2,4,-2
0,14-2,14,2,Indianapolis Colts,2006,0,4,0,4
17,14-2,14,2,Indianapolis Colts,2009,0,1,1,0
16,14-1,14,1,Indianapolis Colts,2009,0,1,1,0
15,14-0,14,0,Indianapolis Colts,2009,0,1,2,-1
14,13-0,13,0,Indianapolis Colts,2009,0,2,2,0
13,12-0,12,0,Indianapolis Colts,2009,0,2,2,0
12,11-0,11,0,Indianapolis Colts,2009,0,2,2,0
11,10-0,10,0,Indianapolis Colts,2009,0,2,2,0
10,9-0,9,0,Indianapolis Colts,2009,0,2,2,0
9,8-0,8,0,Indianapolis Colts,2009,0,2,2,0
8,7-0,7,0,Indianapolis Colts,2009,0,2,1,1
7,6-0,6,0,Indianapolis Colts,2009,0,1,1,0
6,5-0,5,0,Indianapolis Colts,2009,0,1,1,0
5,5-0,5,0,Indianapolis Colts,2009,0,1,1,0
4,4-0,4,0,Indianapolis Colts,2009,0,1,2,-1
3,3-0,3,0,Indianapolis Colts,2009,0,2,3,-1
2,2-0,2,0,Indianapolis Colts,2009,0,3,5,-2
1,1-0,1,0,Indianapolis Colts,2009,0,5,6,-1
0,12-4,12,4,Indianapolis Colts,2009,0,6,0,6
17,12-4,12,4,Indianapolis Colts,2008,0,5,5,0
16,11-4,11,4,Indianapolis Colts,2008,0,5,5,0
15,10-4,10,4,Indianapolis Colts,2008,0,5,5,0
14,9-4,9,4,Indianapolis Colts,2008,0,5,6,-1
13,8-4,8,4,Indianapolis Colts,2008,0,6,6,0
12,7-4,7,4,Indianapolis Colts,2008,0,6,8,-2
11,6-4,6,4,Indianapolis Colts,2008,0,8,10,-2
10,5-4,5,4,Indianapolis Colts,2008,0,10,15,-5
9,4-4,4,4,Indianapolis Colts,2008,0,15,18,-3
8,3-4,3,4,Indianapolis Colts,2008,0,18,16,2
7,3-3,3,3,Indianapolis Colts,2008,0,16,8,8
6,3-2,3,2,Indianapolis Colts,2008,0,8,11,-3
5,2-2,2,2,Indianapolis Colts,2008,0,11,17,-6
4,1-2,1,2,Indianapolis Colts,2008,0,17,12,5
3,1-2,1,2,Indianapolis Colts,2008,0,12,7,5
2,1-1,1,1,Indianapolis Colts,2008,0,7,8,-1
1,0-1,0,1,Indianapolis Colts,2008,0,8,4,4
0,13-3,13,3,Indianapolis Colts,2008,0,4,0,4
17,2-14,2,14,Indianapolis Colts,2011,0,32,31,1
16,2-13,2,13,Indianapolis Colts,2011,0,31,32,-1
15,1-13,1,13,Indianapolis Colts,2011,0,32,32,0
14,0-13,0,13,Indianapolis Colts,2011,0,32,32,0
13,0-12,0,12,Indianapolis Colts,2011,0,32,32,0
12,0-11,0,11,Indianapolis Colts,2011,0,32,32,0
11,0-10,0,10,Indianapolis Colts,2011,0,32,32,0
10,0-10,0,10,Indianapolis Colts,2011,0,32,32,0
9,0-9,0,9,Indianapolis Colts,2011,0,32,32,0
8,0-8,0,8,Indianapolis Colts,2011,0,32,32,0
7,0-7,0,7,Indianapolis Colts,2011,0,32,32,0
6,0-6,0,6,Indianapolis Colts,2011,0,32,32,0
5,0-5,0,5,Indianapolis Colts,2011,0,32,29,3
4,0-4,0,4,Indianapolis Colts,2011,0,29,30,-1
3,0-3,0,3,Indianapolis Colts,2011,0,30,30,0
2,0-2,0,2,Indianapolis Colts,2011,0,30,23,7
1,0-1,0,1,Indianapolis Colts,2011,0,23,9,14
0,10-6,10,6,Indianapolis Colts,2011,0,9,0,9
17,10-6,10,6,Indianapolis Colts,2010,0,10,10,0
16,9-6,9,6,Indianapolis Colts,2010,0,10,13,-3
15,8-6,8,6,Indianapolis Colts,2010,0,13,15,-2
14,7-6,7,6,Indianapolis Colts,2010,0,15,15,0
13,6-6,6,6,Indianapolis Colts,2010,0,15,14,1
12,6-5,6,5,Indianapolis Colts,2010,0,14,9,5
11,6-4,6,4,Indianapolis Colts,2010,0,9,10,-1
10,6-3,6,3,Indianapolis Colts,2010,0,10,10,0
9,5-3,5,3,Indianapolis Colts,2010,0,10,5,5
8,5-2,5,2,Indianapolis Colts,2010,0,5,6,-1
7,4-2,4,2,Indianapolis Colts,2010,0,6,5,1
6,4-2,4,2,Indianapolis Colts,2010,0,5,5,0
5,3-2,3,2,Indianapolis Colts,2010,0,5,9,-4
4,2-2,2,2,Indianapolis Colts,2010,0,9,3,6
3,2-1,2,1,Indianapolis Colts,2010,0,3,4,-1
2,1-1,1,1,Indianapolis Colts,2010,0,4,5,-1
1,0-1,0,1,Indianapolis Colts,2010,0,5,1,4
0,14-2,14,2,Indianapolis Colts,2010,0,1,0,1
17,11-5,11,5,Indianapolis Colts,2012,0,7,8,-1
16,10-5,10,5,Indianapolis Colts,2012,0,8,9,-1
15,9-5,9,5,Indianapolis Colts,2012,0,9,9,0
14,9-4,9,4,Indianapolis Colts,2012,0,9,9,0
13,8-4,8,4,Indianapolis Colts,2012,0,9,10,-1
12,7-4,7,4,Indianapolis Colts,2012,0,10,15,-5
11,6-4,6,4,Indianapolis Colts,2012,0,15,11,4
10,6-3,6,3,Indianapolis Colts,2012,0,11,11,0
9,5-3,5,3,Indianapolis Colts,2012,0,11,15,-4
8,4-3,4,3,Indianapolis Colts,2012,0,15,23,-8
7,3-3,3,3,Indianapolis Colts,2012,0,23,26,-3
6,2-3,2,3,Indianapolis Colts,2012,0,26,22,4
5,2-2,2,2,Indianapolis Colts,2012,0,22,31,-9
4,1-2,1,2,Indianapolis Colts,2012,0,31,31,0
3,1-2,1,2,Indianapolis Colts,2012,0,31,27,4
2,1-1,1,1,Indianapolis Colts,2012,0,27,32,-5
1,0-1,0,1,Indianapolis Colts,2012,0,32,32,0
0,2-14,2,14,Indianapolis Colts,2012,0,32,0,32
17,11-5,11,5,Indianapolis Colts,2013,0,8,8,0
16,10-5,10,5,Indianapolis Colts,2013,0,8,10,-2
15,9-5,9,5,Indianapolis Colts,2013,0,10,11,-1
14,8-5,8,5,Indianapolis Colts,2013,0,11,9,2
13,8-4,8,4,Indianapolis Colts,2013,0,9,10,-1
12,7-4,7,4,Indianapolis Colts,2013,0,10,7,3
11,7-3,7,3,Indianapolis Colts,2013,0,7,7,0
10,6-3,6,3,Indianapolis Colts,2013,0,7,2,5
9,6-2,6,2,Indianapolis Colts,2013,0,2,3,-1
8,5-2,5,2,Indianapolis Colts,2013,0,3,2,1
7,5-2,5,2,Indianapolis Colts,2013,0,2,6,-4
6,4-2,4,2,Indianapolis Colts,2013,0,6,4,2
5,4-1,4,1,Indianapolis Colts,2013,0,4,6,-2
4,3-1,3,1,Indianapolis Colts,2013,0,6,9,-3
3,2-1,2,1,Indianapolis Colts,2013,0,9,14,-5
2,1-1,1,1,Indianapolis Colts,2013,0,14,12,2
1,1-0,1,0,Indianapolis Colts,2013,0,12,11,1
0,11-5,11,5,Indianapolis Colts,2013,0,11,0,11
17,11-5,11,5,Indianapolis Colts,2014,0,8,10,-2
16,10-5,10,5,Indianapolis Colts,2014,0,10,7,3
15,10-4,10,4,Indianapolis Colts,2014,0,7,6,1
14,9-4,9,4,Indianapolis Colts,2014,0,6,6,0
13,8-4,8,4,Indianapolis Colts,2014,0,6,8,-2
12,7-4,7,4,Indianapolis Colts,2014,0,8,9,-1
11,6-4,6,4,Indianapolis Colts,2014,0,9,7,2
10,6-3,6,3,Indianapolis Colts,2014,0,7,5,2
9,6-3,6,3,Indianapolis Colts,2014,0,5,9,-4
8,5-3,5,3,Indianapolis Colts,2014,0,9,4,5
7,5-2,5,2,Indianapolis Colts,2014,0,4,8,-4
6,4-2,4,2,Indianapolis Colts,2014,0,8,8,0
5,3-2,3,2,Indianapolis Colts,2014,0,8,11,-3
4,2-2,2,2,Indianapolis Colts,2014,0,11,14,-3
3,1-2,1,2,Indianapolis Colts,2014,0,14,15,-1
2,0-2,0,2,Indianapolis Colts,2014,0,15,10,5
1,0-1,0,1,Indianapolis Colts,2014,0,10,8,2
0,11-5,11,5,Indianapolis Colts,2014,0,8,0,8
17,8-8,8,8,Indianapolis Colts,2015,0,17,18,-1
16,7-8,7,8,Indianapolis Colts,2015,0,18,21,-3
15,6-8,6,8,Indianapolis Colts,2015,0,21,20,1
14,6-7,6,7,Indianapolis Colts,2015,0,20,16,4
13,6-6,6,6,Indianapolis Colts,2015,0,16,14,2
12,6-5,6,5,Indianapolis Colts,2015,0,14,10,4
11,5-5,5,5,Indianapolis Colts,2015,0,10,17,-7
10,4-5,4,5,Indianapolis Colts,2015,0,17,14,3
9,4-5,4,5,Indianapolis Colts,2015,0,14,22,-8
8,3-5,3,5,Indianapolis Colts,2015,0,22,18,4
7,3-4,3,4,Indianapolis Colts,2015,0,18,11,7
6,3-3,3,3,Indianapolis Colts,2015,0,11,13,-2
5,3-2,3,2,Indianapolis Colts,2015,0,13,16,-3
4,2-2,2,2,Indianapolis Colts,2015,0,16,14,2
3,1-2,1,2,Indianapolis Colts,2015,0,14,18,-4
2,0-2,0,2,Indianapolis Colts,2015,0,18,11,7
1,0-1,0,1,Indianapolis Colts,2015,0,11,4,7
0,11-5,11,5,Indianapolis Colts,2015,0,4,0,4
17,8-8,8,8,Jacksonville Jaguars,2006,0,17,13,4
16,8-7,8,7,Jacksonville Jaguars,2006,0,13,12,1
15,8-6,8,6,Jacksonville Jaguars,2006,0,12,9,3
14,8-5,8,5,Jacksonville Jaguars,2006,0,9,10,-1
13,7-5,7,5,Jacksonville Jaguars,2006,0,10,13,-3
12,6-5,6,5,Jacksonville Jaguars,2006,0,13,9,4
11,6-4,6,4,Jacksonville Jaguars,2006,0,9,16,-7
10,5-4,5,4,Jacksonville Jaguars,2006,0,16,10,6
9,5-3,5,3,Jacksonville Jaguars,2006,0,10,12,-2
8,4-3,4,3,Jacksonville Jaguars,2006,0,12,16,-4
7,3-3,3,3,Jacksonville Jaguars,2006,0,16,13,3
6,3-2,3,2,Jacksonville Jaguars,2006,0,13,11,2
5,3-2,3,2,Jacksonville Jaguars,2006,0,11,12,-1
4,2-2,2,2,Jacksonville Jaguars,2006,0,12,7,5
3,2-1,2,1,Jacksonville Jaguars,2006,0,7,4,3
2,2-0,2,0,Jacksonville Jaguars,2006,0,4,5,-1
1,1-0,1,0,Jacksonville Jaguars,2006,0,5,11,-6
0,12-4,12,4,Jacksonville Jaguars,2006,0,11,0,11
17,5-11,5,11,Jacksonville Jaguars,2008,0,25,25,0
16,5-10,5,10,Jacksonville Jaguars,2008,0,25,23,2
15,5-9,5,9,Jacksonville Jaguars,2008,0,23,25,-2
14,4-9,4,9,Jacksonville Jaguars,2008,0,25,24,1
13,4-8,4,8,Jacksonville Jaguars,2008,0,24,24,0
12,4-7,4,7,Jacksonville Jaguars,2008,0,24,23,1
11,4-6,4,6,Jacksonville Jaguars,2008,0,23,22,1
10,4-5,4,5,Jacksonville Jaguars,2008,0,22,23,-1
9,3-5,3,5,Jacksonville Jaguars,2008,0,23,20,3
8,3-4,3,4,Jacksonville Jaguars,2008,0,20,12,8
7,3-3,3,3,Jacksonville Jaguars,2008,0,12,14,-2
6,3-3,3,3,Jacksonville Jaguars,2008,0,14,17,-3
5,2-3,2,3,Jacksonville Jaguars,2008,0,17,12,5
4,2-2,2,2,Jacksonville Jaguars,2008,0,12,14,-2
3,1-2,1,2,Jacksonville Jaguars,2008,0,14,18,-4
2,0-2,0,2,Jacksonville Jaguars,2008,0,18,10,8
1,0-1,0,1,Jacksonville Jaguars,2008,0,10,5,5
0,11-5,11,5,Jacksonville Jaguars,2008,0,5,0,5
17,7-9,7,9,Jacksonville Jaguars,2009,0,23,22,1
16,7-8,7,8,Jacksonville Jaguars,2009,0,22,18,4
15,7-7,7,7,Jacksonville Jaguars,2009,0,18,15,3
14,7-6,7,6,Jacksonville Jaguars,2009,0,15,13,2
13,7-5,7,5,Jacksonville Jaguars,2009,0,13,17,-4
12,6-5,6,5,Jacksonville Jaguars,2009,0,17,14,3
11,6-4,6,4,Jacksonville Jaguars,2009,0,14,17,-3
10,5-4,5,4,Jacksonville Jaguars,2009,0,17,22,-5
9,4-4,4,4,Jacksonville Jaguars,2009,0,22,21,1
8,3-4,3,4,Jacksonville Jaguars,2009,0,21,21,0
7,3-3,3,3,Jacksonville Jaguars,2009,0,21,21,0
6,3-3,3,3,Jacksonville Jaguars,2009,0,21,21,0
5,2-3,2,3,Jacksonville Jaguars,2009,0,21,18,3
4,2-2,2,2,Jacksonville Jaguars,2009,0,18,22,-4
3,1-2,1,2,Jacksonville Jaguars,2009,0,22,27,-5
2,0-2,0,2,Jacksonville Jaguars,2009,0,27,25,2
1,0-1,0,1,Jacksonville Jaguars,2009,0,25,25,0
0,5-11,5,11,Jacksonville Jaguars,2009,0,25,0,25
17,8-8,8,8,Jacksonville Jaguars,2010,0,16,15,1
16,8-7,8,7,Jacksonville Jaguars,2010,0,15,14,1
15,8-6,8,6,Jacksonville Jaguars,2010,0,14,11,3
14,8-5,8,5,Jacksonville Jaguars,2010,0,11,12,-1
13,7-5,7,5,Jacksonville Jaguars,2010,0,12,16,-4
12,6-5,6,5,Jacksonville Jaguars,2010,0,16,15,1
11,6-4,6,4,Jacksonville Jaguars,2010,0,15,18,-3
10,5-4,5,4,Jacksonville Jaguars,2010,0,18,20,-2
9,4-4,4,4,Jacksonville Jaguars,2010,0,20,19,1
8,4-4,4,4,Jacksonville Jaguars,2010,0,19,25,-6
7,3-4,3,4,Jacksonville Jaguars,2010,0,25,25,0
6,3-3,3,3,Jacksonville Jaguars,2010,0,25,18,7
5,3-2,3,2,Jacksonville Jaguars,2010,0,18,22,-4
4,2-2,2,2,Jacksonville Jaguars,2010,0,22,26,-4
3,1-2,1,2,Jacksonville Jaguars,2010,0,26,25,1
2,1-1,1,1,Jacksonville Jaguars,2010,0,25,24,1
1,1-0,1,0,Jacksonville Jaguars,2010,0,24,25,-1
0,7-9,7,9,Jacksonville Jaguars,2010,0,25,0,25
17,5-11,5,11,Jacksonville Jaguars,2011,0,27,27,0
16,4-11,4,11,Jacksonville Jaguars,2011,0,27,27,0
15,4-10,4,10,Jacksonville Jaguars,2011,0,27,26,1
14,4-9,4,9,Jacksonville Jaguars,2011,0,26,29,-3
13,3-9,3,9,Jacksonville Jaguars,2011,0,29,29,0
12,3-8,3,8,Jacksonville Jaguars,2011,0,29,28,1
11,3-7,3,7,Jacksonville Jaguars,2011,0,28,25,3
10,3-6,3,6,Jacksonville Jaguars,2011,0,25,27,-2
9,2-6,2,6,Jacksonville Jaguars,2011,0,27,26,1
8,2-6,2,6,Jacksonville Jaguars,2011,0,26,25,1
7,2-5,2,5,Jacksonville Jaguars,2011,0,25,29,-4
6,1-5,1,5,Jacksonville Jaguars,2011,0,29,29,0
5,1-4,1,4,Jacksonville Jaguars,2011,0,29,26,3
4,1-3,1,3,Jacksonville Jaguars,2011,0,26,25,1
3,1-2,1,2,Jacksonville Jaguars,2011,0,25,21,4
2,1-1,1,1,Jacksonville Jaguars,2011,0,21,15,6
1,1-0,1,0,Jacksonville Jaguars,2011,0,15,19,-4
0,8-8,8,8,Jacksonville Jaguars,2011,0,19,0,19
17,4-12,4,12,Jacksonville Jaguars,2013,0,29,29,0
16,4-11,4,11,Jacksonville Jaguars,2013,0,29,29,0
15,4-10,4,10,Jacksonville Jaguars,2013,0,29,29,0
14,4-9,4,9,Jacksonville Jaguars,2013,0,29,31,-2
13,3-9,3,9,Jacksonville Jaguars,2013,0,31,31,0
12,2-9,2,9,Jacksonville Jaguars,2013,0,31,32,-1
11,1-9,1,9,Jacksonville Jaguars,2013,0,32,32,0
10,1-8,1,8,Jacksonville Jaguars,2013,0,32,32,0
9,0-8,0,8,Jacksonville Jaguars,2013,0,32,32,0
8,0-8,0,8,Jacksonville Jaguars,2013,0,32,32,0
7,0-7,0,7,Jacksonville Jaguars,2013,0,32,32,0
6,0-6,0,6,Jacksonville Jaguars,2013,0,32,32,0
5,0-5,0,5,Jacksonville Jaguars,2013,0,32,32,0
4,0-4,0,4,Jacksonville Jaguars,2013,0,32,32,0
3,0-3,0,3,Jacksonville Jaguars,2013,0,32,32,0
2,0-2,0,2,Jacksonville Jaguars,2013,0,32,32,0
1,0-1,0,1,Jacksonville Jaguars,2013,0,32,29,3
0,2-14,2,14,Jacksonville Jaguars,2013,0,29,0,29
17,2-14,2,14,Jacksonville Jaguars,2012,0,31,31,0
16,2-13,2,13,Jacksonville Jaguars,2012,0,31,31,0
15,2-12,2,12,Jacksonville Jaguars,2012,0,31,31,0
14,2-11,2,11,Jacksonville Jaguars,2012,0,31,32,-1
13,2-10,2,10,Jacksonville Jaguars,2012,0,32,31,1
12,2-9,2,9,Jacksonville Jaguars,2012,0,31,31,0
11,1-9,1,9,Jacksonville Jaguars,2012,0,31,31,0
10,1-8,1,8,Jacksonville Jaguars,2012,0,31,31,0
9,1-7,1,7,Jacksonville Jaguars,2012,0,31,31,0
8,1-6,1,6,Jacksonville Jaguars,2012,0,31,31,0
7,1-5,1,5,Jacksonville Jaguars,2012,0,31,31,0
6,1-4,1,4,Jacksonville Jaguars,2012,0,31,31,0
5,1-4,1,4,Jacksonville Jaguars,2012,0,31,30,1
4,1-3,1,3,Jacksonville Jaguars,2012,0,30,30,0
3,1-2,1,2,Jacksonville Jaguars,2012,0,30,31,-1
2,0-2,0,2,Jacksonville Jaguars,2012,0,31,29,2
1,0-1,0,1,Jacksonville Jaguars,2012,0,29,29,0
0,5-11,5,11,Jacksonville Jaguars,2012,0,29,0,29
17,11-5,11,5,Jacksonville Jaguars,2007,0,4,4,0
16,11-4,11,4,Jacksonville Jaguars,2007,0,4,5,-1
15,10-4,10,4,Jacksonville Jaguars,2007,0,5,5,0
14,9-4,9,4,Jacksonville Jaguars,2007,0,5,6,-1
13,8-4,8,4,Jacksonville Jaguars,2007,0,6,5,1
12,8-3,8,3,Jacksonville Jaguars,2007,0,5,5,0
11,7-3,7,3,Jacksonville Jaguars,2007,0,5,6,-1
10,6-3,6,3,Jacksonville Jaguars,2007,0,6,10,-4
9,5-3,5,3,Jacksonville Jaguars,2007,0,10,8,2
8,5-2,5,2,Jacksonville Jaguars,2007,0,8,7,1
7,4-2,4,2,Jacksonville Jaguars,2007,0,7,5,2
6,4-1,4,1,Jacksonville Jaguars,2007,0,5,6,-1
5,3-1,3,1,Jacksonville Jaguars,2007,0,6,8,-2
4,2-1,2,1,Jacksonville Jaguars,2007,0,8,10,-2
3,2-1,2,1,Jacksonville Jaguars,2007,0,10,17,-7
2,1-1,1,1,Jacksonville Jaguars,2007,0,17,16,1
1,0-1,0,1,Jacksonville Jaguars,2007,0,16,12,4
0,8-8,8,8,Jacksonville Jaguars,2007,0,12,0,12
17,3-13,3,13,Jacksonville Jaguars,2014,0,30,30,0
16,3-12,3,12,Jacksonville Jaguars,2014,0,30,30,0
15,2-12,2,12,Jacksonville Jaguars,2014,0,30,31,-1
14,2-11,2,11,Jacksonville Jaguars,2014,0,31,31,0
13,2-10,2,10,Jacksonville Jaguars,2014,0,31,32,-1
12,1-10,1,10,Jacksonville Jaguars,2014,0,32,31,1
11,1-9,1,9,Jacksonville Jaguars,2014,0,31,31,0
10,1-9,1,9,Jacksonville Jaguars,2014,0,31,31,0
9,1-8,1,8,Jacksonville Jaguars,2014,0,31,31,0
8,1-7,1,7,Jacksonville Jaguars,2014,0,31,31,0
7,1-6,1,6,Jacksonville Jaguars,2014,0,31,32,-1
6,0-6,0,6,Jacksonville Jaguars,2014,0,32,31,1
5,0-5,0,5,Jacksonville Jaguars,2014,0,31,31,0
4,0-4,0,4,Jacksonville Jaguars,2014,0,31,32,-1
3,0-3,0,3,Jacksonville Jaguars,2014,0,32,31,1
2,0-2,0,2,Jacksonville Jaguars,2014,0,31,30,1
1,0-1,0,1,Jacksonville Jaguars,2014,0,30,31,-1
0,4-12,4,12,Jacksonville Jaguars,2014,0,31,0,31
17,5-11,5,11,Jacksonville Jaguars,2015,0,27,26,1
16,5-10,5,10,Jacksonville Jaguars,2015,0,26,20,6
15,5-9,5,9,Jacksonville Jaguars,2015,0,20,21,-1
14,5-8,5,8,Jacksonville Jaguars,2015,0,21,29,-8
13,4-8,4,8,Jacksonville Jaguars,2015,0,29,28,1
12,4-7,4,7,Jacksonville Jaguars,2015,0,28,27,1
11,4-6,4,6,Jacksonville Jaguars,2015,0,27,26,1
10,3-6,3,6,Jacksonville Jaguars,2015,0,26,31,-5
9,2-6,2,6,Jacksonville Jaguars,2015,0,31,29,2
8,2-5,2,5,Jacksonville Jaguars,2015,0,29,32,-3
7,2-5,2,5,Jacksonville Jaguars,2015,0,32,32,0
6,1-5,1,5,Jacksonville Jaguars,2015,0,32,32,0
5,1-4,1,4,Jacksonville Jaguars,2015,0,32,31,1
4,1-3,1,3,Jacksonville Jaguars,2015,0,31,29,2
3,1-2,1,2,Jacksonville Jaguars,2015,0,29,31,-2
2,1-1,1,1,Jacksonville Jaguars,2015,0,31,30,1
1,0-1,0,1,Jacksonville Jaguars,2015,0,30,31,-1
0,3-13,3,13,Jacksonville Jaguars,2015,0,31,0,31
17,9-7,9,7,Kansas City Chiefs,2006,0,10,14,-4
16,8-7,8,7,Kansas City Chiefs,2006,0,14,19,-5
15,7-7,7,7,Kansas City Chiefs,2006,0,19,15,4
14,7-6,7,6,Kansas City Chiefs,2006,0,15,12,3
13,7-5,7,5,Kansas City Chiefs,2006,0,12,7,5
12,7-4,7,4,Kansas City Chiefs,2006,0,7,10,-3
11,6-4,6,4,Kansas City Chiefs,2006,0,10,13,-3
10,5-4,5,4,Kansas City Chiefs,2006,0,13,11,2
9,5-3,5,3,Kansas City Chiefs,2006,0,11,14,-3
8,4-3,4,3,Kansas City Chiefs,2006,0,14,19,-5
7,3-3,3,3,Kansas City Chiefs,2006,0,19,20,-1
6,2-3,2,3,Kansas City Chiefs,2006,0,20,19,1
5,2-2,2,2,Kansas City Chiefs,2006,0,19,22,-3
4,1-2,1,2,Kansas City Chiefs,2006,0,22,24,-2
3,0-2,0,2,Kansas City Chiefs,2006,0,24,26,-2
2,0-2,0,2,Kansas City Chiefs,2006,0,26,22,4
1,0-1,0,1,Kansas City Chiefs,2006,0,22,20,2
0,10-6,10,6,Kansas City Chiefs,2006,0,20,0,20
17,4-12,4,12,Kansas City Chiefs,2007,0,28,28,0
16,4-11,4,11,Kansas City Chiefs,2007,0,28,26,2
15,4-10,4,10,Kansas City Chiefs,2007,0,26,27,-1
14,4-9,4,9,Kansas City Chiefs,2007,0,27,27,0
13,4-8,4,8,Kansas City Chiefs,2007,0,27,24,3
12,4-7,4,7,Kansas City Chiefs,2007,0,24,21,3
11,4-6,4,6,Kansas City Chiefs,2007,0,21,20,1
10,4-5,4,5,Kansas City Chiefs,2007,0,20,15,5
9,4-4,4,4,Kansas City Chiefs,2007,0,15,11,4
8,4-3,4,3,Kansas City Chiefs,2007,0,11,13,-2
7,4-3,4,3,Kansas City Chiefs,2007,0,13,16,-3
6,3-3,3,3,Kansas City Chiefs,2007,0,16,25,-9
5,2-3,2,3,Kansas City Chiefs,2007,0,25,21,4
4,2-2,2,2,Kansas City Chiefs,2007,0,21,28,-7
3,1-2,1,2,Kansas City Chiefs,2007,0,28,31,-3
2,0-2,0,2,Kansas City Chiefs,2007,0,31,30,1
1,0-1,0,1,Kansas City Chiefs,2007,0,30,26,4
0,9-7,9,7,Kansas City Chiefs,2007,0,26,0,26
17,7-9,7,9,Kansas City Chiefs,2011,0,22,23,-1
16,6-9,6,9,Kansas City Chiefs,2011,0,23,22,1
15,6-8,6,8,Kansas City Chiefs,2011,0,22,25,-3
14,5-8,5,8,Kansas City Chiefs,2011,0,25,23,2
13,5-7,5,7,Kansas City Chiefs,2011,0,23,21,2
12,4-7,4,7,Kansas City Chiefs,2011,0,21,22,-1
11,4-6,4,6,Kansas City Chiefs,2011,0,22,21,1
10,4-5,4,5,Kansas City Chiefs,2011,0,21,19,2
9,4-4,4,4,Kansas City Chiefs,2011,0,19,18,1
8,4-3,4,3,Kansas City Chiefs,2011,0,18,21,-3
7,3-3,3,3,Kansas City Chiefs,2011,0,21,24,-3
6,2-3,2,3,Kansas City Chiefs,2011,0,24,25,-1
5,2-3,2,3,Kansas City Chiefs,2011,0,25,28,-3
4,1-3,1,3,Kansas City Chiefs,2011,0,28,32,-4
3,0-3,0,3,Kansas City Chiefs,2011,0,32,31,1
2,0-2,0,2,Kansas City Chiefs,2011,0,31,21,10
1,0-1,0,1,Kansas City Chiefs,2011,0,21,18,3
0,10-6,10,6,Kansas City Chiefs,2011,0,18,0,18
17,10-6,10,6,Kansas City Chiefs,2010,0,11,11,0
16,10-5,10,5,Kansas City Chiefs,2010,0,11,11,0
15,9-5,9,5,Kansas City Chiefs,2010,0,11,14,-3
14,8-5,8,5,Kansas City Chiefs,2010,0,14,11,3
13,8-4,8,4,Kansas City Chiefs,2010,0,11,12,-1
12,7-4,7,4,Kansas City Chiefs,2010,0,12,13,-1
11,6-4,6,4,Kansas City Chiefs,2010,0,13,15,-2
10,5-4,5,4,Kansas City Chiefs,2010,0,15,14,1
9,5-3,5,3,Kansas City Chiefs,2010,0,14,11,3
8,5-2,5,2,Kansas City Chiefs,2010,0,11,12,-1
7,4-2,4,2,Kansas City Chiefs,2010,0,12,13,-1
6,3-2,3,2,Kansas City Chiefs,2010,0,13,10,3
5,3-1,3,1,Kansas City Chiefs,2010,0,10,10,0
4,3-0,3,0,Kansas City Chiefs,2010,0,10,15,-5
3,3-0,3,0,Kansas City Chiefs,2010,0,15,20,-5
2,2-0,2,0,Kansas City Chiefs,2010,0,20,23,-3
1,1-0,1,0,Kansas City Chiefs,2010,0,23,27,-4
0,4-12,4,12,Kansas City Chiefs,2010,0,27,0,27
17,2-14,2,14,Kansas City Chiefs,2008,0,30,30,0
16,2-13,2,13,Kansas City Chiefs,2008,0,30,28,2
15,2-12,2,12,Kansas City Chiefs,2008,0,28,27,1
14,2-11,2,11,Kansas City Chiefs,2008,0,27,27,0
13,2-10,2,10,Kansas City Chiefs,2008,0,27,31,-4
12,1-10,1,10,Kansas City Chiefs,2008,0,31,30,1
11,1-9,1,9,Kansas City Chiefs,2008,0,30,29,1
10,1-8,1,8,Kansas City Chiefs,2008,0,29,31,-2
9,1-7,1,7,Kansas City Chiefs,2008,0,31,30,1
8,1-6,1,6,Kansas City Chiefs,2008,0,30,30,0
7,1-5,1,5,Kansas City Chiefs,2008,0,30,30,0
6,1-4,1,4,Kansas City Chiefs,2008,0,30,29,1
5,1-4,1,4,Kansas City Chiefs,2008,0,29,29,0
4,1-3,1,3,Kansas City Chiefs,2008,0,29,31,-2
3,0-3,0,3,Kansas City Chiefs,2008,0,31,31,0
2,0-2,0,2,Kansas City Chiefs,2008,0,31,29,2
1,0-1,0,1,Kansas City Chiefs,2008,0,29,31,-2
0,4-12,4,12,Kansas City Chiefs,2008,0,31,0,31
17,4-12,4,12,Kansas City Chiefs,2009,0,28,30,-2
16,3-12,3,12,Kansas City Chiefs,2009,0,30,29,1
15,3-11,3,11,Kansas City Chiefs,2009,0,29,28,1
14,3-10,3,10,Kansas City Chiefs,2009,0,28,28,0
13,3-9,3,9,Kansas City Chiefs,2009,0,28,27,1
12,3-8,3,8,Kansas City Chiefs,2009,0,27,26,1
11,3-7,3,7,Kansas City Chiefs,2009,0,26,27,-1
10,2-7,2,7,Kansas City Chiefs,2009,0,27,28,-1
9,1-7,1,7,Kansas City Chiefs,2009,0,28,28,0
8,1-6,1,6,Kansas City Chiefs,2009,0,28,28,0
7,1-6,1,6,Kansas City Chiefs,2009,0,28,28,0
6,1-5,1,5,Kansas City Chiefs,2009,0,28,30,-2
5,0-5,0,5,Kansas City Chiefs,2009,0,30,30,0
4,0-4,0,4,Kansas City Chiefs,2009,0,30,30,0
3,0-3,0,3,Kansas City Chiefs,2009,0,30,30,0
2,0-2,0,2,Kansas City Chiefs,2009,0,30,30,0
1,0-1,0,1,Kansas City Chiefs,2009,0,30,29,1
0,2-14,2,14,Kansas City Chiefs,2009,0,29,0,29
17,2-14,2,14,Kansas City Chiefs,2012,0,32,32,0
16,2-13,2,13,Kansas City Chiefs,2012,0,32,32,0
15,2-12,2,12,Kansas City Chiefs,2012,0,32,32,0
14,2-11,2,11,Kansas City Chiefs,2012,0,32,31,1
13,2-10,2,10,Kansas City Chiefs,2012,0,31,32,-1
12,1-10,1,10,Kansas City Chiefs,2012,0,32,32,0
11,1-9,1,9,Kansas City Chiefs,2012,0,32,32,0
10,1-8,1,8,Kansas City Chiefs,2012,0,32,32,0
9,1-7,1,7,Kansas City Chiefs,2012,0,32,32,0
8,1-6,1,6,Kansas City Chiefs,2012,0,32,32,0
7,1-5,1,5,Kansas City Chiefs,2012,0,32,32,0
6,1-5,1,5,Kansas City Chiefs,2012,0,32,30,2
5,1-4,1,4,Kansas City Chiefs,2012,0,30,27,3
4,1-3,1,3,Kansas City Chiefs,2012,0,27,26,1
3,1-2,1,2,Kansas City Chiefs,2012,0,26,28,-2
2,0-2,0,2,Kansas City Chiefs,2012,0,28,19,9
1,0-1,0,1,Kansas City Chiefs,2012,0,19,17,2
0,7-9,7,9,Kansas City Chiefs,2012,0,17,0,17
17,11-5,11,5,Kansas City Chiefs,2013,0,10,10,0
16,11-4,11,4,Kansas City Chiefs,2013,0,10,6,4
15,11-3,11,3,Kansas City Chiefs,2013,0,6,7,-1
14,10-3,10,3,Kansas City Chiefs,2013,0,7,7,0
13,9-3,9,3,Kansas City Chiefs,2013,0,7,6,1
12,9-2,9,2,Kansas City Chiefs,2013,0,6,3,3
11,9-1,9,1,Kansas City Chiefs,2013,0,3,1,2
10,9-0,9,0,Kansas City Chiefs,2013,0,1,1,0
9,9-0,9,0,Kansas City Chiefs,2013,0,1,1,0
8,8-0,8,0,Kansas City Chiefs,2013,0,1,1,0
7,7-0,7,0,Kansas City Chiefs,2013,0,1,2,-1
6,6-0,6,0,Kansas City Chiefs,2013,0,2,3,-1
5,5-0,5,0,Kansas City Chiefs,2013,0,3,5,-2
4,4-0,4,0,Kansas City Chiefs,2013,0,5,8,-3
3,3-0,3,0,Kansas City Chiefs,2013,0,8,13,-5
2,2-0,2,0,Kansas City Chiefs,2013,0,13,20,-7
1,1-0,1,0,Kansas City Chiefs,2013,0,20,19,1
0,2-14,2,14,Kansas City Chiefs,2013,0,19,0,19
17,9-7,9,7,Kansas City Chiefs,2014,0,13,14,-1
16,8-7,8,7,Kansas City Chiefs,2014,0,14,13,1
15,8-6,8,6,Kansas City Chiefs,2014,0,13,14,-1
14,7-6,7,6,Kansas City Chiefs,2014,0,14,14,0
13,7-5,7,5,Kansas City Chiefs,2014,0,14,12,2
12,7-4,7,4,Kansas City Chiefs,2014,0,12,5,7
11,7-3,7,3,Kansas City Chiefs,2014,0,5,10,-5
10,6-3,6,3,Kansas City Chiefs,2014,0,10,12,-2
9,5-3,5,3,Kansas City Chiefs,2014,0,12,15,-3
8,4-3,4,3,Kansas City Chiefs,2014,0,15,14,1
7,3-3,3,3,Kansas City Chiefs,2014,0,14,18,-4
6,2-3,2,3,Kansas City Chiefs,2014,0,18,19,-1
5,2-3,2,3,Kansas City Chiefs,2014,0,19,14,5
4,2-2,2,2,Kansas City Chiefs,2014,0,14,22,-8
3,1-2,1,2,Kansas City Chiefs,2014,0,22,27,-5
2,0-2,0,2,Kansas City Chiefs,2014,0,27,25,2
1,0-1,0,1,Kansas City Chiefs,2014,0,25,16,9
0,11-5,11,5,Kansas City Chiefs,2014,0,16,0,16
17,11-5,11,5,Kansas City Chiefs,2015,0,8,7,1
16,10-5,10,5,Kansas City Chiefs,2015,0,7,9,-2
15,9-5,9,5,Kansas City Chiefs,2015,0,9,9,0
14,8-5,8,5,Kansas City Chiefs,2015,0,9,9,0
13,7-5,7,5,Kansas City Chiefs,2015,0,9,10,-1
12,6-5,6,5,Kansas City Chiefs,2015,0,10,13,-3
11,5-5,5,5,Kansas City Chiefs,2015,0,13,15,-2
10,4-5,4,5,Kansas City Chiefs,2015,0,15,19,-4
9,3-5,3,5,Kansas City Chiefs,2015,0,19,20,-1
8,3-5,3,5,Kansas City Chiefs,2015,0,20,22,-2
7,2-5,2,5,Kansas City Chiefs,2015,0,22,29,-7
6,1-5,1,5,Kansas City Chiefs,2015,0,29,19,10
5,1-4,1,4,Kansas City Chiefs,2015,0,19,18,1
4,1-3,1,3,Kansas City Chiefs,2015,0,18,12,6
3,1-2,1,2,Kansas City Chiefs,2015,0,12,10,2
2,1-1,1,1,Kansas City Chiefs,2015,0,10,7,3
1,1-0,1,0,Kansas City Chiefs,2015,0,7,14,-7
0,9-7,9,7,Kansas City Chiefs,2015,0,14,0,14
17,6-10,6,10,Miami Dolphins,2006,0,24,23,1
16,6-9,6,9,Miami Dolphins,2006,0,23,21,2
15,6-8,6,8,Miami Dolphins,2006,0,21,18,3
14,6-7,6,7,Miami Dolphins,2006,0,18,20,-2
13,5-7,5,7,Miami Dolphins,2006,0,20,16,4
12,5-6,5,6,Miami Dolphins,2006,0,16,19,-3
11,4-6,4,6,Miami Dolphins,2006,0,19,21,-2
10,3-6,3,6,Miami Dolphins,2006,0,21,25,-4
9,2-6,2,6,Miami Dolphins,2006,0,25,31,-6
8,1-6,1,6,Miami Dolphins,2006,0,31,29,2
7,1-6,1,6,Miami Dolphins,2006,0,29,27,2
6,1-5,1,5,Miami Dolphins,2006,0,27,25,2
5,1-4,1,4,Miami Dolphins,2006,0,25,23,2
4,1-3,1,3,Miami Dolphins,2006,0,23,21,2
3,1-2,1,2,Miami Dolphins,2006,0,21,21,0
2,0-2,0,2,Miami Dolphins,2006,0,21,16,5
1,0-1,0,1,Miami Dolphins,2006,0,16,9,7
0,9-7,9,7,Miami Dolphins,2006,0,9,0,9
17,1-15,1,15,Miami Dolphins,2007,0,32,32,0
16,1-14,1,14,Miami Dolphins,2007,0,32,32,0
15,1-13,1,13,Miami Dolphins,2007,0,32,32,0
14,0-13,0,13,Miami Dolphins,2007,0,32,32,0
13,0-12,0,12,Miami Dolphins,2007,0,32,32,0
12,0-11,0,11,Miami Dolphins,2007,0,32,32,0
11,0-10,0,10,Miami Dolphins,2007,0,32,32,0
10,0-9,0,9,Miami Dolphins,2007,0,32,32,0
9,0-8,0,8,Miami Dolphins,2007,0,32,32,0
8,0-8,0,8,Miami Dolphins,2007,0,32,32,0
7,0-7,0,7,Miami Dolphins,2007,0,32,32,0
6,0-6,0,6,Miami Dolphins,2007,0,32,32,0
5,0-5,0,5,Miami Dolphins,2007,0,32,31,1
4,0-4,0,4,Miami Dolphins,2007,0,31,31,0
3,0-3,0,3,Miami Dolphins,2007,0,31,28,3
2,0-2,0,2,Miami Dolphins,2007,0,28,27,1
1,0-1,0,1,Miami Dolphins,2007,0,27,20,7
0,6-10,6,10,Miami Dolphins,2007,0,20,0,20
17,11-5,11,5,Miami Dolphins,2008,0,8,9,-1
16,10-5,10,5,Miami Dolphins,2008,0,9,11,-2
15,9-5,9,5,Miami Dolphins,2008,0,11,12,-1
14,8-5,8,5,Miami Dolphins,2008,0,12,16,-4
13,7-5,7,5,Miami Dolphins,2008,0,16,14,2
12,6-5,6,5,Miami Dolphins,2008,0,14,12,2
11,6-4,6,4,Miami Dolphins,2008,0,12,15,-3
10,5-4,5,4,Miami Dolphins,2008,0,15,17,-2
9,4-4,4,4,Miami Dolphins,2008,0,17,24,-7
8,3-4,3,4,Miami Dolphins,2008,0,24,26,-2
7,2-4,2,4,Miami Dolphins,2008,0,26,24,2
6,2-3,2,3,Miami Dolphins,2008,0,24,23,1
5,2-2,2,2,Miami Dolphins,2008,0,23,26,-3
4,1-2,1,2,Miami Dolphins,2008,0,26,25,1
3,1-2,1,2,Miami Dolphins,2008,0,25,30,-5
2,0-2,0,2,Miami Dolphins,2008,0,30,28,2
1,0-1,0,1,Miami Dolphins,2008,0,28,30,-2
0,1-15,1,15,Miami Dolphins,2008,0,30,0,30
17,7-9,7,9,Miami Dolphins,2010,0,22,18,4
16,7-8,7,8,Miami Dolphins,2010,0,18,17,1
15,7-7,7,7,Miami Dolphins,2010,0,17,16,1
14,7-6,7,6,Miami Dolphins,2010,0,16,18,-2
13,6-6,6,6,Miami Dolphins,2010,0,18,15,3
12,6-5,6,5,Miami Dolphins,2010,0,15,19,-4
11,5-5,5,5,Miami Dolphins,2010,0,19,14,5
10,5-4,5,4,Miami Dolphins,2010,0,14,17,-3
9,4-4,4,4,Miami Dolphins,2010,0,17,15,2
8,4-3,4,3,Miami Dolphins,2010,0,15,16,-1
7,3-3,3,3,Miami Dolphins,2010,0,16,16,0
6,3-2,3,2,Miami Dolphins,2010,0,16,17,-1
5,2-2,2,2,Miami Dolphins,2010,0,17,13,4
4,2-2,2,2,Miami Dolphins,2010,0,13,11,2
3,2-1,2,1,Miami Dolphins,2010,0,11,7,4
2,2-0,2,0,Miami Dolphins,2010,0,7,15,-8
1,1-0,1,0,Miami Dolphins,2010,0,15,11,4
0,7-9,7,9,Miami Dolphins,2010,0,11,0,11
17,6-10,6,10,Miami Dolphins,2011,0,24,24,0
16,5-10,5,10,Miami Dolphins,2011,0,24,23,1
15,5-9,5,9,Miami Dolphins,2011,0,23,23,0
14,4-9,4,9,Miami Dolphins,2011,0,23,22,1
13,4-8,4,8,Miami Dolphins,2011,0,22,26,-4
12,3-8,3,8,Miami Dolphins,2011,0,26,25,1
11,3-7,3,7,Miami Dolphins,2011,0,25,29,-4
10,2-7,2,7,Miami Dolphins,2011,0,29,31,-2
9,1-7,1,7,Miami Dolphins,2011,0,31,31,0
8,0-7,0,7,Miami Dolphins,2011,0,31,31,0
7,0-6,0,6,Miami Dolphins,2011,0,31,30,1
6,0-5,0,5,Miami Dolphins,2011,0,30,30,0
5,0-4,0,4,Miami Dolphins,2011,0,30,31,-1
4,0-4,0,4,Miami Dolphins,2011,0,31,29,2
3,0-3,0,3,Miami Dolphins,2011,0,29,25,4
2,0-2,0,2,Miami Dolphins,2011,0,25,26,-1
1,0-1,0,1,Miami Dolphins,2011,0,26,24,2
0,7-9,7,9,Miami Dolphins,2011,0,24,0,24
17,7-9,7,9,Miami Dolphins,2009,0,21,20,1
16,7-8,7,8,Miami Dolphins,2009,0,20,16,4
15,7-7,7,7,Miami Dolphins,2009,0,16,13,3
14,7-6,7,6,Miami Dolphins,2009,0,13,14,-1
13,6-6,6,6,Miami Dolphins,2009,0,14,19,-5
12,5-6,5,6,Miami Dolphins,2009,0,19,17,2
11,5-5,5,5,Miami Dolphins,2009,0,17,18,-1
10,4-5,4,5,Miami Dolphins,2009,0,18,17,1
9,3-5,3,5,Miami Dolphins,2009,0,17,20,-3
8,3-4,3,4,Miami Dolphins,2009,0,20,19,1
7,2-4,2,4,Miami Dolphins,2009,0,19,20,-1
6,2-3,2,3,Miami Dolphins,2009,0,20,18,2
5,2-3,2,3,Miami Dolphins,2009,0,18,21,-3
4,1-3,1,3,Miami Dolphins,2009,0,21,24,-3
3,0-3,0,3,Miami Dolphins,2009,0,24,19,5
2,0-2,0,2,Miami Dolphins,2009,0,19,19,0
1,0-1,0,1,Miami Dolphins,2009,0,19,16,3
0,11-5,11,5,Miami Dolphins,2009,0,16,0,16
17,8-8,8,8,Miami Dolphins,2013,0,18,16,2
16,8-7,8,7,Miami Dolphins,2013,0,16,14,2
15,8-6,8,6,Miami Dolphins,2013,0,14,16,-2
14,7-6,7,6,Miami Dolphins,2013,0,16,17,-1
13,6-6,6,6,Miami Dolphins,2013,0,17,21,-4
12,5-6,5,6,Miami Dolphins,2013,0,21,17,4
11,5-5,5,5,Miami Dolphins,2013,0,17,22,-5
10,4-5,4,5,Miami Dolphins,2013,0,22,19,3
9,4-4,4,4,Miami Dolphins,2013,0,19,19,0
8,3-4,3,4,Miami Dolphins,2013,0,19,16,3
7,3-3,3,3,Miami Dolphins,2013,0,16,14,2
6,3-2,3,2,Miami Dolphins,2013,0,14,13,1
5,3-2,3,2,Miami Dolphins,2013,0,13,7,6
4,3-1,3,1,Miami Dolphins,2013,0,7,7,0
3,3-0,3,0,Miami Dolphins,2013,0,7,12,-5
2,2-0,2,0,Miami Dolphins,2013,0,12,17,-5
1,1-0,1,0,Miami Dolphins,2013,0,17,20,-3
0,7-9,7,9,Miami Dolphins,2013,0,20,0,20
17,7-9,7,9,Miami Dolphins,2012,0,20,19,1
16,7-8,7,8,Miami Dolphins,2012,0,19,19,0
15,6-8,6,8,Miami Dolphins,2012,0,19,21,-2
14,5-8,5,8,Miami Dolphins,2012,0,21,20,1
13,5-7,5,7,Miami Dolphins,2012,0,20,18,2
12,5-6,5,6,Miami Dolphins,2012,0,18,20,-2
11,4-6,4,6,Miami Dolphins,2012,0,20,18,2
10,4-5,4,5,Miami Dolphins,2012,0,18,15,3
9,4-4,4,4,Miami Dolphins,2012,0,15,12,3
8,4-3,4,3,Miami Dolphins,2012,0,12,16,-4
7,3-3,3,3,Miami Dolphins,2012,0,16,17,-1
6,3-3,3,3,Miami Dolphins,2012,0,17,19,-2
5,2-3,2,3,Miami Dolphins,2012,0,19,26,-7
4,1-3,1,3,Miami Dolphins,2012,0,26,29,-3
3,1-2,1,2,Miami Dolphins,2012,0,29,25,4
2,1-1,1,1,Miami Dolphins,2012,0,25,30,-5
1,0-1,0,1,Miami Dolphins,2012,0,30,27,3
0,6-10,6,10,Miami Dolphins,2012,0,27,0,27
17,6-10,6,10,Miami Dolphins,2015,0,21,27,-6
16,5-10,5,10,Miami Dolphins,2015,0,27,25,2
15,5-9,5,9,Miami Dolphins,2015,0,25,23,2
14,5-8,5,8,Miami Dolphins,2015,0,23,24,-1
13,5-7,5,7,Miami Dolphins,2015,0,24,23,1
12,4-7,4,7,Miami Dolphins,2015,0,23,23,0
11,4-6,4,6,Miami Dolphins,2015,0,23,18,5
10,4-5,4,5,Miami Dolphins,2015,0,18,20,-2
9,3-5,3,5,Miami Dolphins,2015,0,20,17,3
8,3-4,3,4,Miami Dolphins,2015,0,17,13,4
7,3-3,3,3,Miami Dolphins,2015,0,13,21,-8
6,2-3,2,3,Miami Dolphins,2015,0,21,29,-8
5,1-3,1,3,Miami Dolphins,2015,0,29,30,-1
4,1-3,1,3,Miami Dolphins,2015,0,30,23,7
3,1-2,1,2,Miami Dolphins,2015,0,23,15,8
2,1-1,1,1,Miami Dolphins,2015,0,15,16,-1
1,1-0,1,0,Miami Dolphins,2015,0,16,15,1
0,8-8,8,8,Miami Dolphins,2015,0,15,0,15
17,8-8,8,8,Miami Dolphins,2014,0,19,16,3
16,8-7,8,7,Miami Dolphins,2014,0,16,16,0
15,7-7,7,7,Miami Dolphins,2014,0,16,15,1
14,7-6,7,6,Miami Dolphins,2014,0,15,15,0
13,7-5,7,5,Miami Dolphins,2014,0,15,17,-2
12,6-5,6,5,Miami Dolphins,2014,0,17,15,2
11,6-4,6,4,Miami Dolphins,2014,0,15,17,-2
10,5-4,5,4,Miami Dolphins,2014,0,17,13,4
9,5-3,5,3,Miami Dolphins,2014,0,13,18,-5
8,4-3,4,3,Miami Dolphins,2014,0,18,18,0
7,3-3,3,3,Miami Dolphins,2014,0,18,23,-5
6,2-3,2,3,Miami Dolphins,2014,0,23,24,-1
5,2-2,2,2,Miami Dolphins,2014,0,24,22,2
4,2-2,2,2,Miami Dolphins,2014,0,22,25,-3
3,1-2,1,2,Miami Dolphins,2014,0,25,20,5
2,1-1,1,1,Miami Dolphins,2014,0,20,15,5
1,1-0,1,0,Miami Dolphins,2014,0,15,22,-7
0,8-8,8,8,Miami Dolphins,2014,0,22,0,22
17,6-10,6,10,Minnesota Vikings,2006,0,26,25,1
16,6-9,6,9,Minnesota Vikings,2006,0,25,24,1
15,6-8,6,8,Minnesota Vikings,2006,0,24,21,3
14,6-7,6,7,Minnesota Vikings,2006,0,21,24,-3
13,5-7,5,7,Minnesota Vikings,2006,0,24,21,3
12,5-6,5,6,Minnesota Vikings,2006,0,21,24,-3
11,4-6,4,6,Minnesota Vikings,2006,0,24,23,1
10,4-5,4,5,Minnesota Vikings,2006,0,23,18,5
9,4-4,4,4,Minnesota Vikings,2006,0,18,16,2
8,4-3,4,3,Minnesota Vikings,2006,0,16,12,4
7,4-2,4,2,Minnesota Vikings,2006,0,12,18,-6
6,3-2,3,2,Minnesota Vikings,2006,0,18,17,1
5,3-2,3,2,Minnesota Vikings,2006,0,17,20,-3
4,2-2,2,2,Minnesota Vikings,2006,0,20,15,5
3,2-1,2,1,Minnesota Vikings,2006,0,15,14,1
2,2-0,2,0,Minnesota Vikings,2006,0,14,17,-3
1,1-0,1,0,Minnesota Vikings,2006,0,17,19,-2
0,9-7,9,7,Minnesota Vikings,2006,0,19,0,19
17,8-8,8,8,Minnesota Vikings,2007,0,15,14,1
16,8-7,8,7,Minnesota Vikings,2007,0,14,11,3
15,8-6,8,6,Minnesota Vikings,2007,0,11,12,-1
14,7-6,7,6,Minnesota Vikings,2007,0,12,13,-1
13,6-6,6,6,Minnesota Vikings,2007,0,13,18,-5
12,5-6,5,6,Minnesota Vikings,2007,0,18,23,-5
11,4-6,4,6,Minnesota Vikings,2007,0,23,27,-4
10,3-6,3,6,Minnesota Vikings,2007,0,27,23,4
9,3-5,3,5,Minnesota Vikings,2007,0,23,26,-3
8,2-5,2,5,Minnesota Vikings,2007,0,26,26,0
7,2-4,2,4,Minnesota Vikings,2007,0,26,22,4
6,2-3,2,3,Minnesota Vikings,2007,0,22,27,-5
5,1-3,1,3,Minnesota Vikings,2007,0,27,27,0
4,1-3,1,3,Minnesota Vikings,2007,0,27,25,2
3,1-2,1,2,Minnesota Vikings,2007,0,25,22,3
2,1-1,1,1,Minnesota Vikings,2007,0,22,24,-2
1,1-0,1,0,Minnesota Vikings,2007,0,24,27,-3
0,6-10,6,10,Minnesota Vikings,2007,0,27,0,27
17,10-6,10,6,Minnesota Vikings,2008,0,10,11,-1
16,9-6,9,6,Minnesota Vikings,2008,0,11,12,-1
15,9-5,9,5,Minnesota Vikings,2008,0,12,15,-3
14,8-5,8,5,Minnesota Vikings,2008,0,15,15,0
13,7-5,7,5,Minnesota Vikings,2008,0,15,17,-2
12,6-5,6,5,Minnesota Vikings,2008,0,17,21,-4
11,5-5,5,5,Minnesota Vikings,2008,0,21,18,3
10,5-4,5,4,Minnesota Vikings,2008,0,18,20,-2
9,4-4,4,4,Minnesota Vikings,2008,0,20,23,-3
8,3-4,3,4,Minnesota Vikings,2008,0,23,22,1
7,3-4,3,4,Minnesota Vikings,2008,0,22,21,1
6,3-3,3,3,Minnesota Vikings,2008,0,21,19,2
5,2-3,2,3,Minnesota Vikings,2008,0,19,21,-2
4,1-3,1,3,Minnesota Vikings,2008,0,21,19,2
3,1-2,1,2,Minnesota Vikings,2008,0,19,21,-2
2,0-2,0,2,Minnesota Vikings,2008,0,21,16,5
1,0-1,0,1,Minnesota Vikings,2008,0,16,11,5
0,8-8,8,8,Minnesota Vikings,2008,0,11,0,11
17,12-4,12,4,Minnesota Vikings,2009,0,3,5,-2
16,11-4,11,4,Minnesota Vikings,2009,0,5,4,1
15,11-3,11,3,Minnesota Vikings,2009,0,4,3,1
14,11-2,11,2,Minnesota Vikings,2009,0,3,3,0
13,10-2,10,2,Minnesota Vikings,2009,0,3,3,0
12,10-1,10,1,Minnesota Vikings,2009,0,3,3,0
11,9-1,9,1,Minnesota Vikings,2009,0,3,3,0
10,8-1,8,1,Minnesota Vikings,2009,0,3,3,0
9,7-1,7,1,Minnesota Vikings,2009,0,3,3,0
8,7-1,7,1,Minnesota Vikings,2009,0,3,4,-1
7,6-1,6,1,Minnesota Vikings,2009,0,4,3,1
6,6-0,6,0,Minnesota Vikings,2009,0,3,3,0
5,5-0,5,0,Minnesota Vikings,2009,0,3,3,0
4,4-0,4,0,Minnesota Vikings,2009,0,3,5,-2
3,3-0,3,0,Minnesota Vikings,2009,0,5,5,0
2,2-0,2,0,Minnesota Vikings,2009,0,5,8,-3
1,1-0,1,0,Minnesota Vikings,2009,0,8,9,-1
0,10-6,10,6,Minnesota Vikings,2009,0,9,0,9
17,6-10,6,10,Minnesota Vikings,2010,0,23,19,4
16,6-9,6,9,Minnesota Vikings,2010,0,19,24,-5
15,5-9,5,9,Minnesota Vikings,2010,0,24,26,-2
14,5-8,5,8,Minnesota Vikings,2010,0,26,23,3
13,5-7,5,7,Minnesota Vikings,2010,0,23,23,0
12,4-7,4,7,Minnesota Vikings,2010,0,23,25,-2
11,3-7,3,7,Minnesota Vikings,2010,0,25,24,1
10,3-6,3,6,Minnesota Vikings,2010,0,24,22,2
9,3-5,3,5,Minnesota Vikings,2010,0,22,23,-1
8,2-5,2,5,Minnesota Vikings,2010,0,23,19,4
7,2-4,2,4,Minnesota Vikings,2010,0,19,17,2
6,2-3,2,3,Minnesota Vikings,2010,0,17,20,-3
5,1-3,1,3,Minnesota Vikings,2010,0,20,15,5
4,1-2,1,2,Minnesota Vikings,2010,0,15,17,-2
3,1-2,1,2,Minnesota Vikings,2010,0,17,18,-1
2,0-2,0,2,Minnesota Vikings,2010,0,18,6,12
1,0-1,0,1,Minnesota Vikings,2010,0,6,5,1
0,12-4,12,4,Minnesota Vikings,2010,0,5,0,5
17,3-13,3,13,Minnesota Vikings,2011,0,30,30,0
16,3-12,3,12,Minnesota Vikings,2011,0,30,30,0
15,2-12,2,12,Minnesota Vikings,2011,0,30,30,0
14,2-11,2,11,Minnesota Vikings,2011,0,30,30,0
13,2-10,2,10,Minnesota Vikings,2011,0,30,30,0
12,2-9,2,9,Minnesota Vikings,2011,0,30,29,1
11,2-8,2,8,Minnesota Vikings,2011,0,29,27,2
10,2-7,2,7,Minnesota Vikings,2011,0,27,24,3
9,2-6,2,6,Minnesota Vikings,2011,0,24,23,1
8,2-6,2,6,Minnesota Vikings,2011,0,23,28,-5
7,1-6,1,6,Minnesota Vikings,2011,0,28,28,0
6,1-5,1,5,Minnesota Vikings,2011,0,28,26,2
5,1-4,1,4,Minnesota Vikings,2011,0,26,30,-4
4,0-4,0,4,Minnesota Vikings,2011,0,30,28,2
3,0-3,0,3,Minnesota Vikings,2011,0,28,26,2
2,0-2,0,2,Minnesota Vikings,2011,0,26,24,2
1,0-1,0,1,Minnesota Vikings,2011,0,24,20,4
0,6-10,6,10,Minnesota Vikings,2011,0,20,0,20
17,5-10,5,10,Minnesota Vikings,2013,0,24,25,-1
16,4-10,4,10,Minnesota Vikings,2013,0,25,23,2
15,4-9,4,9,Minnesota Vikings,2013,0,23,27,-4
14,3-9,3,9,Minnesota Vikings,2013,0,27,28,-1
13,3-8,3,8,Minnesota Vikings,2013,0,28,28,0
12,2-8,2,8,Minnesota Vikings,2013,0,28,31,-3
11,2-8,2,8,Minnesota Vikings,2013,0,31,30,1
10,2-7,2,7,Minnesota Vikings,2013,0,30,30,0
9,1-7,1,7,Minnesota Vikings,2013,0,30,30,0
8,1-6,1,6,Minnesota Vikings,2013,0,30,30,0
7,1-5,1,5,Minnesota Vikings,2013,0,30,29,1
6,1-4,1,4,Minnesota Vikings,2013,0,29,28,1
5,1-3,1,3,Minnesota Vikings,2013,0,28,24,4
4,1-3,1,3,Minnesota Vikings,2013,0,24,26,-2
3,0-3,0,3,Minnesota Vikings,2013,0,26,23,3
2,0-2,0,2,Minnesota Vikings,2013,0,23,21,2
1,0-1,0,1,Minnesota Vikings,2013,0,21,17,4
0,10-6,10,6,Minnesota Vikings,2013,0,17,0,17
17,10-6,10,6,Minnesota Vikings,2012,0,12,12,0
16,9-6,9,6,Minnesota Vikings,2012,0,12,15,-3
15,8-6,8,6,Minnesota Vikings,2012,0,15,16,-1
14,7-6,7,6,Minnesota Vikings,2012,0,16,17,-1
13,6-6,6,6,Minnesota Vikings,2012,0,17,16,1
12,6-5,6,5,Minnesota Vikings,2012,0,16,14,2
11,6-4,6,4,Minnesota Vikings,2012,0,14,14,0
10,6-4,6,4,Minnesota Vikings,2012,0,14,16,-2
9,5-4,5,4,Minnesota Vikings,2012,0,16,11,5
8,5-3,5,3,Minnesota Vikings,2012,0,11,9,2
7,5-2,5,2,Minnesota Vikings,2012,0,9,10,-1
6,4-2,4,2,Minnesota Vikings,2012,0,10,8,2
5,4-1,4,1,Minnesota Vikings,2012,0,8,14,-6
4,3-1,3,1,Minnesota Vikings,2012,0,14,21,-7
3,2-1,2,1,Minnesota Vikings,2012,0,21,29,-8
2,1-1,1,1,Minnesota Vikings,2012,0,29,28,1
1,1-0,1,0,Minnesota Vikings,2012,0,28,30,-2
0,3-13,3,13,Minnesota Vikings,2012,0,30,0,30
17,7-9,7,9,Minnesota Vikings,2014,0,20,23,-3
16,6-9,6,9,Minnesota Vikings,2014,0,23,23,0
15,6-8,6,8,Minnesota Vikings,2014,0,23,22,1
14,6-7,6,7,Minnesota Vikings,2014,0,22,24,-2
13,5-7,5,7,Minnesota Vikings,2014,0,24,24,0
12,4-7,4,7,Minnesota Vikings,2014,0,24,24,0
11,4-6,4,6,Minnesota Vikings,2014,0,24,21,3
10,4-5,4,5,Minnesota Vikings,2014,0,21,23,-2
9,4-5,4,5,Minnesota Vikings,2014,0,23,25,-2
8,3-5,3,5,Minnesota Vikings,2014,0,25,27,-2
7,2-5,2,5,Minnesota Vikings,2014,0,27,27,0
6,2-4,2,4,Minnesota Vikings,2014,0,27,25,2
5,2-3,2,3,Minnesota Vikings,2014,0,25,24,1
4,2-2,2,2,Minnesota Vikings,2014,0,24,29,-5
3,1-2,1,2,Minnesota Vikings,2014,0,29,26,3
2,1-1,1,1,Minnesota Vikings,2014,0,26,17,9
1,1-0,1,0,Minnesota Vikings,2014,0,17,26,-9
0,5-10,5,10,Minnesota Vikings,2014,0,26,0,26
17,11-5,11,5,Minnesota Vikings,2015,0,9,11,-2
16,10-5,10,5,Minnesota Vikings,2015,0,11,11,0
15,9-5,9,5,Minnesota Vikings,2015,0,11,11,0
14,8-5,8,5,Minnesota Vikings,2015,0,11,11,0
13,8-4,8,4,Minnesota Vikings,2015,0,11,6,5
12,8-3,8,3,Minnesota Vikings,2015,0,6,7,-1
11,7-3,7,3,Minnesota Vikings,2015,0,7,5,2
10,7-2,7,2,Minnesota Vikings,2015,0,5,8,-3
9,6-2,6,2,Minnesota Vikings,2015,0,8,11,-3
8,5-2,5,2,Minnesota Vikings,2015,0,11,11,0
7,4-2,4,2,Minnesota Vikings,2015,0,11,15,-4
6,3-2,3,2,Minnesota Vikings,2015,0,15,16,-1
5,2-2,2,2,Minnesota Vikings,2015,0,16,14,2
4,2-2,2,2,Minnesota Vikings,2015,0,14,13,1
3,2-1,2,1,Minnesota Vikings,2015,0,13,16,-3
2,1-1,1,1,Minnesota Vikings,2015,0,16,25,-9
1,0-1,0,1,Minnesota Vikings,2015,0,25,17,8
0,7-9,7,9,Minnesota Vikings,2015,0,17,0,17
17,12-4,12,4,New England Patriots,2006,0,3,5,-2
16,11-4,11,4,New England Patriots,2006,0,5,5,0
15,10-4,10,4,New England Patriots,2006,0,5,8,-3
14,9-4,9,4,New England Patriots,2006,0,8,5,3
13,9-3,9,3,New England Patriots,2006,0,5,4,1
12,8-3,8,3,New England Patriots,2006,0,4,5,-1
11,7-3,7,3,New England Patriots,2006,0,5,6,-1
10,6-3,6,3,New England Patriots,2006,0,6,4,2
9,6-2,6,2,New England Patriots,2006,0,4,3,1
8,6-1,6,1,New England Patriots,2006,0,3,4,-1
7,5-1,5,1,New England Patriots,2006,0,4,6,-2
6,4-1,4,1,New England Patriots,2006,0,6,7,-1
5,4-1,4,1,New England Patriots,2006,0,7,5,2
4,3-1,3,1,New England Patriots,2006,0,5,11,-6
3,2-1,2,1,New England Patriots,2006,0,11,10,1
2,2-0,2,0,New England Patriots,2006,0,10,10,0
1,1-0,1,0,New England Patriots,2006,0,10,7,3
0,10-6,10,6,New England Patriots,2006,0,7,0,7
17,11-5,11,5,New England Patriots,2008,0,9,8,1
16,10-5,10,5,New England Patriots,2008,0,8,9,-1
15,9-5,9,5,New England Patriots,2008,0,9,10,-1
14,8-5,8,5,New England Patriots,2008,0,10,11,-1
13,7-5,7,5,New England Patriots,2008,0,11,8,3
12,7-4,7,4,New England Patriots,2008,0,8,10,-2
11,6-4,6,4,New England Patriots,2008,0,10,7,3
10,6-3,6,3,New England Patriots,2008,0,7,12,-5
9,5-3,5,3,New England Patriots,2008,0,12,7,5
8,5-2,5,2,New England Patriots,2008,0,7,9,-2
7,4-2,4,2,New England Patriots,2008,0,9,17,-8
6,3-2,3,2,New England Patriots,2008,0,17,9,8
5,3-1,3,1,New England Patriots,2008,0,9,13,-4
4,2-1,2,1,New England Patriots,2008,0,13,11,2
3,2-1,2,1,New England Patriots,2008,0,11,6,5
2,2-0,2,0,New England Patriots,2008,0,6,9,-3
1,1-0,1,0,New England Patriots,2008,0,9,1,8
0,16-0,16,0,New England Patriots,2008,0,1,0,1
17,16-0,16,0,New England Patriots,2007,0,1,1,0
16,15-0,15,0,New England Patriots,2007,0,1,1,0
15,14-0,14,0,New England Patriots,2007,0,1,1,0
14,13-0,13,0,New England Patriots,2007,0,1,1,0
13,12-0,12,0,New England Patriots,2007,0,1,1,0
12,11-0,11,0,New England Patriots,2007,0,1,1,0
11,10-0,10,0,New England Patriots,2007,0,1,1,0
10,9-0,9,0,New England Patriots,2007,0,1,1,0
9,9-0,9,0,New England Patriots,2007,0,1,1,0
8,8-0,8,0,New England Patriots,2007,0,1,1,0
7,7-0,7,0,New England Patriots,2007,0,1,1,0
6,6-0,6,0,New England Patriots,2007,0,1,1,0
5,5-0,5,0,New England Patriots,2007,0,1,1,0
4,4-0,4,0,New England Patriots,2007,0,1,1,0
3,3-0,3,0,New England Patriots,2007,0,1,1,0
2,2-0,2,0,New England Patriots,2007,0,1,1,0
1,1-0,1,0,New England Patriots,2007,0,1,1,0
0,12-4,12,4,New England Patriots,2007,0,1,0,1
17,10-6,10,6,New England Patriots,2009,0,10,10,0
16,10-5,10,5,New England Patriots,2009,0,10,9,1
15,9-5,9,5,New England Patriots,2009,0,9,9,0
14,8-5,8,5,New England Patriots,2009,0,9,11,-2
13,7-5,7,5,New England Patriots,2009,0,11,6,5
12,7-4,7,4,New England Patriots,2009,0,6,4,2
11,7-3,7,3,New England Patriots,2009,0,4,5,-1
10,6-3,6,3,New England Patriots,2009,0,5,6,-1
9,6-2,6,2,New England Patriots,2009,0,6,5,1
8,5-2,5,2,New England Patriots,2009,0,5,5,0
7,5-2,5,2,New England Patriots,2009,0,5,6,-1
6,4-2,4,2,New England Patriots,2009,0,6,10,-4
5,3-2,3,2,New England Patriots,2009,0,10,6,4
4,3-1,3,1,New England Patriots,2009,0,6,7,-1
3,2-1,2,1,New England Patriots,2009,0,7,10,-3
2,1-1,1,1,New England Patriots,2009,0,10,2,8
1,1-0,1,0,New England Patriots,2009,0,2,2,0
0,11-5,11,5,New England Patriots,2009,0,2,0,2
17,14-2,14,2,New England Patriots,2010,0,1,1,0
16,13-2,13,2,New England Patriots,2010,0,1,1,0
15,12-2,12,2,New England Patriots,2010,0,1,1,0
14,11-2,11,2,New England Patriots,2010,0,1,2,-1
13,10-2,10,2,New England Patriots,2010,0,2,2,0
12,9-2,9,2,New England Patriots,2010,0,2,2,0
11,8-2,8,2,New England Patriots,2010,0,2,2,0
10,7-2,7,2,New England Patriots,2010,0,2,6,-4
9,6-2,6,2,New England Patriots,2010,0,6,1,5
8,6-1,6,1,New England Patriots,2010,0,1,3,-2
7,5-1,5,1,New England Patriots,2010,0,3,3,0
6,4-1,4,1,New England Patriots,2010,0,3,6,-3
5,3-1,3,1,New England Patriots,2010,0,6,8,-2
4,3-1,3,1,New England Patriots,2010,0,8,10,-2
3,2-1,2,1,New England Patriots,2010,0,10,9,1
2,1-1,1,1,New England Patriots,2010,0,9,4,5
1,1-0,1,0,New England Patriots,2010,0,4,10,-6
0,10-6,10,6,New England Patriots,2010,0,10,0,10
17,13-3,13,3,New England Patriots,2011,0,4,4,0
16,12-3,12,3,New England Patriots,2011,0,4,4,0
15,11-3,11,3,New England Patriots,2011,0,4,5,-1
14,10-3,10,3,New England Patriots,2011,0,5,6,-1
13,9-3,9,3,New England Patriots,2011,0,6,6,0
12,8-3,8,3,New England Patriots,2011,0,6,6,0
11,7-3,7,3,New England Patriots,2011,0,6,8,-2
10,6-3,6,3,New England Patriots,2011,0,8,12,-4
9,5-3,5,3,New England Patriots,2011,0,12,5,7
8,5-2,5,2,New England Patriots,2011,0,5,2,3
7,5-1,5,1,New England Patriots,2011,0,2,2,0
6,5-1,5,1,New England Patriots,2011,0,2,2,0
5,4-1,4,1,New England Patriots,2011,0,2,3,-1
4,3-1,3,1,New England Patriots,2011,0,3,3,0
3,2-1,2,1,New England Patriots,2011,0,3,2,1
2,2-0,2,0,New England Patriots,2011,0,2,2,0
1,1-0,1,0,New England Patriots,2011,0,2,2,0
0,14-2,14,2,New England Patriots,2011,0,2,0,2
17,12-4,12,4,New England Patriots,2012,0,4,5,-1
16,11-4,11,4,New England Patriots,2012,0,5,4,1
15,10-4,10,4,New England Patriots,2012,0,4,1,3
14,10-3,10,3,New England Patriots,2012,0,1,3,-2
13,9-3,9,3,New England Patriots,2012,0,3,5,-2
12,8-3,8,3,New England Patriots,2012,0,5,8,-3
11,7-3,7,3,New England Patriots,2012,0,8,8,0
10,6-3,6,3,New England Patriots,2012,0,8,9,-1
9,5-3,5,3,New England Patriots,2012,0,9,8,1
8,5-3,5,3,New England Patriots,2012,0,8,8,0
7,4-3,4,3,New England Patriots,2012,0,8,7,1
6,3-3,3,3,New England Patriots,2012,0,7,5,2
5,3-2,3,2,New England Patriots,2012,0,5,6,-1
4,2-2,2,2,New England Patriots,2012,0,6,8,-2
3,1-2,1,2,New England Patriots,2012,0,8,5,3
2,1-1,1,1,New England Patriots,2012,0,5,1,4
1,1-0,1,0,New England Patriots,2012,0,1,2,-1
0,13-3,13,3,New England Patriots,2012,0,2,0,2
17,12-4,12,4,New England Patriots,2013,0,5,5,0
16,11-4,11,4,New England Patriots,2013,0,5,7,-2
15,10-4,10,4,New England Patriots,2013,0,7,4,3
14,10-3,10,3,New England Patriots,2013,0,4,4,0
13,9-3,9,3,New England Patriots,2013,0,4,4,0
12,8-3,8,3,New England Patriots,2013,0,4,6,-2
11,7-3,7,3,New England Patriots,2013,0,6,5,1
10,7-2,7,2,New England Patriots,2013,0,5,7,-2
9,7-2,7,2,New England Patriots,2013,0,7,9,-2
8,6-2,6,2,New England Patriots,2013,0,9,8,1
7,5-2,5,2,New England Patriots,2013,0,8,5,3
6,5-1,5,1,New England Patriots,2013,0,5,6,-1
5,4-1,4,1,New England Patriots,2013,0,6,4,2
4,4-0,4,0,New England Patriots,2013,0,4,5,-1
3,3-0,3,0,New England Patriots,2013,0,5,7,-2
2,2-0,2,0,New England Patriots,2013,0,7,5,2
1,1-0,1,0,New England Patriots,2013,0,5,6,-1
0,12-4,12,4,New England Patriots,2013,0,6,0,6
17,12-4,12,4,New England Patriots,2014,0,2,1,1
16,12-3,12,3,New England Patriots,2014,0,1,1,0
15,11-3,11,3,New England Patriots,2014,0,1,2,-1
14,10-3,10,3,New England Patriots,2014,0,2,2,0
13,9-3,9,3,New England Patriots,2014,0,2,1,1
12,9-2,9,2,New England Patriots,2014,0,1,1,0
11,8-2,8,2,New England Patriots,2014,0,1,1,0
10,7-2,7,2,New England Patriots,2014,0,1,1,0
9,7-2,7,2,New England Patriots,2014,0,1,3,-2
8,6-2,6,2,New England Patriots,2014,0,3,8,-5
7,5-2,5,2,New England Patriots,2014,0,8,10,-2
6,4-2,4,2,New England Patriots,2014,0,10,11,-1
5,3-2,3,2,New England Patriots,2014,0,11,16,-5
4,2-2,2,2,New England Patriots,2014,0,16,7,9
3,2-1,2,1,New England Patriots,2014,0,7,5,2
2,1-1,1,1,New England Patriots,2014,0,5,7,-2
1,0-1,0,1,New England Patriots,2014,0,7,3,4
0,12-4,12,4,New England Patriots,2014,0,3,0,3
17,12-4,12,4,New England Patriots,2015,0,5,3,2
16,12-3,12,3,New England Patriots,2015,0,3,3,0
15,12-2,12,2,New England Patriots,2015,0,3,3,0
14,11-2,11,2,New England Patriots,2015,0,3,5,-2
13,10-2,10,2,New England Patriots,2015,0,5,2,3
12,10-1,10,1,New England Patriots,2015,0,2,1,1
11,10-0,10,0,New England Patriots,2015,0,1,1,0
10,9-0,9,0,New England Patriots,2015,0,1,1,0
9,8-0,8,0,New England Patriots,2015,0,1,1,0
8,7-0,7,0,New England Patriots,2015,0,1,1,0
7,6-0,6,0,New England Patriots,2015,0,1,1,0
6,5-0,5,0,New England Patriots,2015,0,1,1,0
5,4-0,4,0,New England Patriots,2015,0,1,1,0
4,3-0,3,0,New England Patriots,2015,0,1,1,0
3,3-0,3,0,New England Patriots,2015,0,1,1,0
2,2-0,2,0,New England Patriots,2015,0,1,1,0
1,1-0,1,0,New England Patriots,2015,0,1,2,-1
0,12-4,12,4,New England Patriots,2015,0,2,0,2
17,10-6,10,6,New Orleans Saints,2006,0,6,4,2
16,10-5,10,5,New Orleans Saints,2006,0,4,6,-2
15,9-5,9,5,New Orleans Saints,2006,0,6,3,3
14,9-4,9,4,New Orleans Saints,2006,0,3,7,-4
13,8-4,8,4,New Orleans Saints,2006,0,7,10,-3
12,7-4,7,4,New Orleans Saints,2006,0,10,13,-3
11,6-4,6,4,New Orleans Saints,2006,0,13,9,4
10,6-3,6,3,New Orleans Saints,2006,0,9,8,1
9,6-2,6,2,New Orleans Saints,2006,0,8,9,-1
8,5-2,5,2,New Orleans Saints,2006,0,9,5,4
7,5-1,5,1,New Orleans Saints,2006,0,5,7,-2
6,5-1,5,1,New Orleans Saints,2006,0,7,13,-6
5,4-1,4,1,New Orleans Saints,2006,0,13,15,-2
4,3-1,3,1,New Orleans Saints,2006,0,15,14,1
3,3-0,3,0,New Orleans Saints,2006,0,14,17,-3
2,2-0,2,0,New Orleans Saints,2006,0,17,24,-7
1,1-0,1,0,New Orleans Saints,2006,0,24,29,-5
0,3-13,3,13,New Orleans Saints,2006,0,29,0,29
17,7-9,7,9,New Orleans Saints,2007,0,18,17,1
16,7-8,7,8,New Orleans Saints,2007,0,17,14,3
15,7-7,7,7,New Orleans Saints,2007,0,14,16,-2
14,6-7,6,7,New Orleans Saints,2007,0,16,17,-1
13,5-7,5,7,New Orleans Saints,2007,0,17,13,4
12,5-6,5,6,New Orleans Saints,2007,0,13,20,-7
11,4-6,4,6,New Orleans Saints,2007,0,20,16,4
10,4-5,4,5,New Orleans Saints,2007,0,16,11,5
9,4-4,4,4,New Orleans Saints,2007,0,11,19,-8
8,3-4,3,4,New Orleans Saints,2007,0,19,24,-5
7,2-4,2,4,New Orleans Saints,2007,0,24,26,-2
6,1-4,1,4,New Orleans Saints,2007,0,26,30,-4
5,0-4,0,4,New Orleans Saints,2007,0,30,29,1
4,0-3,0,3,New Orleans Saints,2007,0,29,26,3
3,0-3,0,3,New Orleans Saints,2007,0,26,19,7
2,0-2,0,2,New Orleans Saints,2007,0,19,11,8
1,0-1,0,1,New Orleans Saints,2007,0,11,6,5
0,10-6,10,6,New Orleans Saints,2007,0,6,0,6
17,13-3,13,3,New Orleans Saints,2009,0,5,3,2
16,13-2,13,2,New Orleans Saints,2009,0,3,2,1
15,13-1,13,1,New Orleans Saints,2009,0,2,1,1
14,13-0,13,0,New Orleans Saints,2009,0,1,1,0
13,12-0,12,0,New Orleans Saints,2009,0,1,1,0
12,11-0,11,0,New Orleans Saints,2009,0,1,1,0
11,10-0,10,0,New Orleans Saints,2009,0,1,1,0
10,9-0,9,0,New Orleans Saints,2009,0,1,1,0
9,8-0,8,0,New Orleans Saints,2009,0,1,1,0
8,7-0,7,0,New Orleans Saints,2009,0,1,2,-1
7,6-0,6,0,New Orleans Saints,2009,0,2,2,0
6,5-0,5,0,New Orleans Saints,2009,0,2,4,-2
5,4-0,4,0,New Orleans Saints,2009,0,4,4,0
4,4-0,4,0,New Orleans Saints,2009,0,4,4,0
3,3-0,3,0,New Orleans Saints,2009,0,4,7,-3
2,2-0,2,0,New Orleans Saints,2009,0,7,12,-5
1,1-0,1,0,New Orleans Saints,2009,0,12,18,-6
0,8-8,8,8,New Orleans Saints,2009,0,18,0,18
17,11-5,11,5,New Orleans Saints,2010,0,5,4,1
16,11-4,11,4,New Orleans Saints,2010,0,4,7,-3
15,10-4,10,4,New Orleans Saints,2010,0,7,4,3
14,10-3,10,3,New Orleans Saints,2010,0,4,5,-1
13,9-3,9,3,New Orleans Saints,2010,0,5,6,-1
12,8-3,8,3,New Orleans Saints,2010,0,6,8,-2
11,7-3,7,3,New Orleans Saints,2010,0,8,9,-1
10,6-3,6,3,New Orleans Saints,2010,0,9,9,0
9,6-3,6,3,New Orleans Saints,2010,0,9,10,-1
8,5-3,5,3,New Orleans Saints,2010,0,10,14,-4
7,4-3,4,3,New Orleans Saints,2010,0,14,6,8
6,4-2,4,2,New Orleans Saints,2010,0,6,9,-3
5,3-2,3,2,New Orleans Saints,2010,0,9,2,7
4,3-1,3,1,New Orleans Saints,2010,0,2,2,0
3,2-1,2,1,New Orleans Saints,2010,0,2,1,1
2,2-0,2,0,New Orleans Saints,2010,0,1,1,0
1,1-0,1,0,New Orleans Saints,2010,0,1,2,-1
0,13-3,13,3,New Orleans Saints,2010,0,2,0,2
17,13-3,13,3,New Orleans Saints,2011,0,2,2,0
16,12-3,12,3,New Orleans Saints,2011,0,2,2,0
15,11-3,11,3,New Orleans Saints,2011,0,2,3,-1
14,10-3,10,3,New Orleans Saints,2011,0,3,4,-1
13,9-3,9,3,New Orleans Saints,2011,0,4,4,0
12,8-3,8,3,New Orleans Saints,2011,0,4,3,1
11,7-3,7,3,New Orleans Saints,2011,0,3,3,0
10,7-3,7,3,New Orleans Saints,2011,0,3,4,-1
9,6-3,6,3,New Orleans Saints,2011,0,4,6,-2
8,5-3,5,3,New Orleans Saints,2011,0,6,3,3
7,5-2,5,2,New Orleans Saints,2011,0,3,5,-2
6,4-2,4,2,New Orleans Saints,2011,0,5,3,2
5,4-1,4,1,New Orleans Saints,2011,0,3,2,1
4,3-1,3,1,New Orleans Saints,2011,0,2,2,0
3,2-1,2,1,New Orleans Saints,2011,0,2,4,-2
2,1-1,1,1,New Orleans Saints,2011,0,4,6,-2
1,0-1,0,1,New Orleans Saints,2011,0,6,5,1
0,11-5,11,5,New Orleans Saints,2011,0,5,0,5
17,7-9,7,9,New Orleans Saints,2012,0,19,17,2
16,7-8,7,8,New Orleans Saints,2012,0,17,18,-1
15,6-8,6,8,New Orleans Saints,2012,0,18,22,-4
14,5-8,5,8,New Orleans Saints,2012,0,22,18,4
13,5-7,5,7,New Orleans Saints,2012,0,18,15,3
12,5-6,5,6,New Orleans Saints,2012,0,15,13,2
11,5-5,5,5,New Orleans Saints,2012,0,13,16,-3
10,4-5,4,5,New Orleans Saints,2012,0,16,22,-6
9,3-5,3,5,New Orleans Saints,2012,0,22,26,-4
8,2-5,2,5,New Orleans Saints,2012,0,26,20,6
7,2-4,2,4,New Orleans Saints,2012,0,20,24,-4
6,1-4,1,4,New Orleans Saints,2012,0,24,24,0
5,1-4,1,4,New Orleans Saints,2012,0,24,28,-4
4,0-4,0,4,New Orleans Saints,2012,0,28,28,0
3,0-3,0,3,New Orleans Saints,2012,0,28,24,4
2,0-2,0,2,New Orleans Saints,2012,0,24,16,8
1,0-1,0,1,New Orleans Saints,2012,0,16,11,5
0,13-3,13,3,New Orleans Saints,2012,0,11,0,11
17,11-5,11,5,New Orleans Saints,2013,0,6,6,0
16,10-5,10,5,New Orleans Saints,2013,0,6,5,1
15,10-4,10,4,New Orleans Saints,2013,0,5,3,2
14,10-3,10,3,New Orleans Saints,2013,0,3,5,-2
13,9-3,9,3,New Orleans Saints,2013,0,5,2,3
12,9-2,9,2,New Orleans Saints,2013,0,2,4,-2
11,8-2,8,2,New Orleans Saints,2013,0,4,4,0
10,7-2,7,2,New Orleans Saints,2013,0,4,6,-2
9,6-2,6,2,New Orleans Saints,2013,0,6,5,1
8,6-1,6,1,New Orleans Saints,2013,0,5,5,0
7,5-1,5,1,New Orleans Saints,2013,0,5,3,2
6,5-1,5,1,New Orleans Saints,2013,0,3,2,1
5,5-0,5,0,New Orleans Saints,2013,0,2,3,-1
4,4-0,4,0,New Orleans Saints,2013,0,3,3,0
3,3-0,3,0,New Orleans Saints,2013,0,3,8,-5
2,2-0,2,0,New Orleans Saints,2013,0,8,8,0
1,1-0,1,0,New Orleans Saints,2013,0,8,13,-5
0,7-9,7,9,New Orleans Saints,2013,0,13,0,13
17,8-8,8,8,New Orleans Saints,2008,0,19,17,2
16,8-7,8,7,New Orleans Saints,2008,0,17,19,-2
15,7-7,7,7,New Orleans Saints,2008,0,19,17,2
14,7-6,7,6,New Orleans Saints,2008,0,17,18,-1
13,6-6,6,6,New Orleans Saints,2008,0,18,16,2
12,6-5,6,5,New Orleans Saints,2008,0,16,20,-4
11,5-5,5,5,New Orleans Saints,2008,0,20,23,-3
10,4-5,4,5,New Orleans Saints,2008,0,23,18,5
9,4-4,4,4,New Orleans Saints,2008,0,18,17,1
8,4-4,4,4,New Orleans Saints,2008,0,17,21,-4
7,3-4,3,4,New Orleans Saints,2008,0,21,18,3
6,3-3,3,3,New Orleans Saints,2008,0,18,22,-4
5,2-3,2,3,New Orleans Saints,2008,0,22,16,6
4,2-2,2,2,New Orleans Saints,2008,0,16,16,0
3,1-2,1,2,New Orleans Saints,2008,0,16,12,4
2,1-1,1,1,New Orleans Saints,2008,0,12,4,8
1,1-0,1,0,New Orleans Saints,2008,0,4,7,-3
0,7-9,7,9,New Orleans Saints,2008,0,7,0,7
17,7-9,7,9,New Orleans Saints,2014,0,21,24,-3
16,6-9,6,9,New Orleans Saints,2014,0,24,19,5
15,6-8,6,8,New Orleans Saints,2014,0,19,23,-4
14,5-8,5,8,New Orleans Saints,2014,0,23,19,4
13,5-7,5,7,New Orleans Saints,2014,0,19,21,-2
12,4-7,4,7,New Orleans Saints,2014,0,21,20,1
11,4-6,4,6,New Orleans Saints,2014,0,20,19,1
10,4-5,4,5,New Orleans Saints,2014,0,19,15,4
9,4-4,4,4,New Orleans Saints,2014,0,15,17,-2
8,3-4,3,4,New Orleans Saints,2014,0,17,22,-5
7,2-4,2,4,New Orleans Saints,2014,0,22,17,5
6,2-3,2,3,New Orleans Saints,2014,0,17,20,-3
5,2-3,2,3,New Orleans Saints,2014,0,20,21,-1
4,1-3,1,3,New Orleans Saints,2014,0,21,15,6
3,1-2,1,2,New Orleans Saints,2014,0,15,16,-1
2,0-2,0,2,New Orleans Saints,2014,0,16,6,10
1,0-1,0,1,New Orleans Saints,2014,0,6,5,1
0,11-5,11,5,New Orleans Saints,2014,0,5,0,5
17,7-9,7,9,New Orleans Saints,2015,0,19,20,-1
16,6-9,6,9,New Orleans Saints,2015,0,20,23,-3
15,5-9,5,9,New Orleans Saints,2015,0,23,22,1
14,5-8,5,8,New Orleans Saints,2015,0,22,25,-3
13,4-8,4,8,New Orleans Saints,2015,0,25,22,3
12,4-7,4,7,New Orleans Saints,2015,0,22,26,-4
11,4-6,4,6,New Orleans Saints,2015,0,26,24,2
10,4-6,4,6,New Orleans Saints,2015,0,24,18,6
9,4-5,4,5,New Orleans Saints,2015,0,18,15,3
8,4-4,4,4,New Orleans Saints,2015,0,15,17,-2
7,3-4,3,4,New Orleans Saints,2015,0,17,20,-3
6,2-4,2,4,New Orleans Saints,2015,0,20,26,-6
5,1-4,1,4,New Orleans Saints,2015,0,26,21,5
4,1-3,1,3,New Orleans Saints,2015,0,21,31,-10
3,0-3,0,3,New Orleans Saints,2015,0,31,30,1
2,0-2,0,2,New Orleans Saints,2015,0,30,22,8
1,0-1,0,1,New Orleans Saints,2015,0,22,16,6
0,7-9,7,9,New Orleans Saints,2015,0,16,0,16
17,2-14,2,14,Oakland Raiders,2006,0,32,31,1
16,2-13,2,13,Oakland Raiders,2006,0,31,31,0
15,2-12,2,12,Oakland Raiders,2006,0,31,31,0
14,2-11,2,11,Oakland Raiders,2006,0,31,31,0
13,2-10,2,10,Oakland Raiders,2006,0,31,30,1
12,2-9,2,9,Oakland Raiders,2006,0,30,32,-2
11,2-8,2,8,Oakland Raiders,2006,0,32,31,1
10,2-7,2,7,Oakland Raiders,2006,0,31,31,0
9,2-6,2,6,Oakland Raiders,2006,0,31,28,3
8,2-5,2,5,Oakland Raiders,2006,0,28,31,-3
7,1-5,1,5,Oakland Raiders,2006,0,31,32,-1
6,0-5,0,5,Oakland Raiders,2006,0,32,32,0
5,0-5,0,5,Oakland Raiders,2006,0,32,32,0
4,0-3,0,3,Oakland Raiders,2006,0,32,32,0
3,0-2,0,2,Oakland Raiders,2006,0,32,32,0
2,0-2,0,2,Oakland Raiders,2006,0,32,31,1
1,0-1,0,1,Oakland Raiders,2006,0,31,25,6
0,4-12,4,12,Oakland Raiders,2006,0,25,0,25
17,5-11,5,11,Oakland Raiders,2008,0,26,27,-1
16,4-11,4,11,Oakland Raiders,2008,0,27,30,-3
15,3-11,3,11,Oakland Raiders,2008,0,30,29,1
14,3-10,3,10,Oakland Raiders,2008,0,29,28,1
13,3-9,3,9,Oakland Raiders,2008,0,28,26,2
12,3-8,3,8,Oakland Raiders,2008,0,26,31,-5
11,2-8,2,8,Oakland Raiders,2008,0,31,31,0
10,2-7,2,7,Oakland Raiders,2008,0,31,30,1
9,2-6,2,6,Oakland Raiders,2008,0,30,28,2
8,2-5,2,5,Oakland Raiders,2008,0,28,27,1
7,2-4,2,4,Oakland Raiders,2008,0,27,29,-2
6,1-4,1,4,Oakland Raiders,2008,0,29,27,2
5,1-3,1,3,Oakland Raiders,2008,0,27,28,-1
4,1-3,1,3,Oakland Raiders,2008,0,28,29,-1
3,1-2,1,2,Oakland Raiders,2008,0,29,27,2
2,1-1,1,1,Oakland Raiders,2008,0,27,30,-3
1,0-1,0,1,Oakland Raiders,2008,0,30,27,3
0,4-12,4,12,Oakland Raiders,2008,0,27,0,27
17,8-8,8,8,Oakland Raiders,2010,0,15,17,-2
16,7-8,7,8,Oakland Raiders,2010,0,17,16,1
15,7-7,7,7,Oakland Raiders,2010,0,16,17,-1
14,6-7,6,7,Oakland Raiders,2010,0,17,16,1
13,6-6,6,6,Oakland Raiders,2010,0,16,20,-4
12,5-6,5,6,Oakland Raiders,2010,0,20,16,4
11,5-5,5,5,Oakland Raiders,2010,0,16,12,4
10,5-4,5,4,Oakland Raiders,2010,0,12,12,0
9,5-4,5,4,Oakland Raiders,2010,0,12,16,-4
8,4-4,4,4,Oakland Raiders,2010,0,16,23,-7
7,3-4,3,4,Oakland Raiders,2010,0,23,28,-5
6,2-4,2,4,Oakland Raiders,2010,0,28,25,3
5,2-3,2,3,Oakland Raiders,2010,0,25,29,-4
4,1-3,1,3,Oakland Raiders,2010,0,29,28,1
3,1-2,1,2,Oakland Raiders,2010,0,28,27,1
2,1-1,1,1,Oakland Raiders,2010,0,27,27,0
1,0-1,0,1,Oakland Raiders,2010,0,27,24,3
0,5-11,5,11,Oakland Raiders,2010,0,24,0,24
17,8-8,8,8,Oakland Raiders,2011,0,17,14,3
16,8-7,8,7,Oakland Raiders,2011,0,14,19,-5
15,7-7,7,7,Oakland Raiders,2011,0,19,16,3
14,7-6,7,6,Oakland Raiders,2011,0,16,15,1
13,7-5,7,5,Oakland Raiders,2011,0,15,10,5
12,7-4,7,4,Oakland Raiders,2011,0,10,14,-4
11,6-4,6,4,Oakland Raiders,2011,0,14,16,-2
10,5-4,5,4,Oakland Raiders,2011,0,16,21,-5
9,4-4,4,4,Oakland Raiders,2011,0,21,17,4
8,4-3,4,3,Oakland Raiders,2011,0,17,15,2
7,4-3,4,3,Oakland Raiders,2011,0,15,9,6
6,4-2,4,2,Oakland Raiders,2011,0,9,11,-2
5,3-2,3,2,Oakland Raiders,2011,0,11,15,-4
4,2-2,2,2,Oakland Raiders,2011,0,15,13,2
3,2-1,2,1,Oakland Raiders,2011,0,13,20,-7
2,1-1,1,1,Oakland Raiders,2011,0,20,18,2
1,1-0,1,0,Oakland Raiders,2011,0,18,22,-4
0,8-8,8,8,Oakland Raiders,2011,0,22,0,22
17,4-12,4,12,Oakland Raiders,2007,0,27,27,0
16,4-11,4,11,Oakland Raiders,2007,0,27,25,2
15,4-10,4,10,Oakland Raiders,2007,0,25,26,-1
14,4-9,4,9,Oakland Raiders,2007,0,26,26,0
13,4-8,4,8,Oakland Raiders,2007,0,26,27,-1
12,3-8,3,8,Oakland Raiders,2007,0,27,30,-3
11,2-8,2,8,Oakland Raiders,2007,0,30,29,1
10,2-7,2,7,Oakland Raiders,2007,0,29,27,2
9,2-6,2,6,Oakland Raiders,2007,0,27,27,0
8,2-5,2,5,Oakland Raiders,2007,0,27,27,0
7,2-4,2,4,Oakland Raiders,2007,0,27,25,2
6,2-3,2,3,Oakland Raiders,2007,0,25,20,5
5,2-2,2,2,Oakland Raiders,2007,0,20,24,-4
4,2-2,2,2,Oakland Raiders,2007,0,24,24,0
3,1-2,1,2,Oakland Raiders,2007,0,24,30,-6
2,0-2,0,2,Oakland Raiders,2007,0,30,29,1
1,0-1,0,1,Oakland Raiders,2007,0,29,30,-1
0,2-14,2,14,Oakland Raiders,2007,0,30,0,30
17,5-11,5,11,Oakland Raiders,2009,0,26,24,2
16,5-10,5,10,Oakland Raiders,2009,0,24,23,1
15,5-9,5,9,Oakland Raiders,2009,0,23,27,-4
14,4-9,4,9,Oakland Raiders,2009,0,27,25,2
13,4-8,4,8,Oakland Raiders,2009,0,25,28,-3
12,3-8,3,8,Oakland Raiders,2009,0,28,28,0
11,3-7,3,7,Oakland Raiders,2009,0,28,28,0
10,2-7,2,7,Oakland Raiders,2009,0,28,27,1
9,2-6,2,6,Oakland Raiders,2009,0,27,27,0
8,2-6,2,6,Oakland Raiders,2009,0,27,27,0
7,2-5,2,5,Oakland Raiders,2009,0,27,25,2
6,2-4,2,4,Oakland Raiders,2009,0,25,29,-4
5,1-4,1,4,Oakland Raiders,2009,0,29,28,1
4,1-3,1,3,Oakland Raiders,2009,0,28,27,1
3,1-2,1,2,Oakland Raiders,2009,0,27,26,1
2,1-1,1,1,Oakland Raiders,2009,0,26,27,-1
1,0-1,0,1,Oakland Raiders,2009,0,27,30,-3
0,5-11,5,11,Oakland Raiders,2009,0,30,0,30
17,4-12,4,12,Oakland Raiders,2013,0,30,30,0
16,4-11,4,11,Oakland Raiders,2013,0,30,30,0
15,4-10,4,10,Oakland Raiders,2013,0,30,28,2
14,4-9,4,9,Oakland Raiders,2013,0,28,25,3
13,4-8,4,8,Oakland Raiders,2013,0,25,26,-1
12,4-7,4,7,Oakland Raiders,2013,0,26,26,0
11,4-6,4,6,Oakland Raiders,2013,0,26,27,-1
10,3-6,3,6,Oakland Raiders,2013,0,27,24,3
9,3-5,3,5,Oakland Raiders,2013,0,24,22,2
8,3-4,3,4,Oakland Raiders,2013,0,22,28,-6
7,2-4,2,4,Oakland Raiders,2013,0,28,26,2
6,2-4,2,4,Oakland Raiders,2013,0,26,24,2
5,2-3,2,3,Oakland Raiders,2013,0,24,28,-4
4,1-3,1,3,Oakland Raiders,2013,0,28,30,-2
3,1-2,1,2,Oakland Raiders,2013,0,30,29,1
2,1-1,1,1,Oakland Raiders,2013,0,29,31,-2
1,0-1,0,1,Oakland Raiders,2013,0,31,31,0
0,4-12,4,12,Oakland Raiders,2013,0,31,0,31
17,4-12,4,12,Oakland Raiders,2012,0,30,30,0
16,4-11,4,11,Oakland Raiders,2012,0,30,30,0
15,4-10,4,10,Oakland Raiders,2012,0,30,30,0
14,3-10,3,10,Oakland Raiders,2012,0,30,29,1
13,3-9,3,9,Oakland Raiders,2012,0,29,29,0
12,3-8,3,8,Oakland Raiders,2012,0,29,28,1
11,3-7,3,7,Oakland Raiders,2012,0,28,28,0
10,3-6,3,6,Oakland Raiders,2012,0,28,26,2
9,3-5,3,5,Oakland Raiders,2012,0,26,24,2
8,3-4,3,4,Oakland Raiders,2012,0,24,28,-4
7,2-4,2,4,Oakland Raiders,2012,0,28,29,-1
6,1-4,1,4,Oakland Raiders,2012,0,29,29,0
5,1-3,1,3,Oakland Raiders,2012,0,29,29,0
4,1-3,1,3,Oakland Raiders,2012,0,29,27,2
3,1-2,1,2,Oakland Raiders,2012,0,27,30,-3
2,0-2,0,2,Oakland Raiders,2012,0,30,25,5
1,0-1,0,1,Oakland Raiders,2012,0,25,26,-1
0,8-8,8,8,Oakland Raiders,2012,0,26,0,26
17,7-9,7,9,Oakland Raiders,2015,0,16,13,3
16,7-8,7,8,Oakland Raiders,2015,0,13,14,-1
15,6-8,6,8,Oakland Raiders,2015,0,14,14,0
14,6-7,6,7,Oakland Raiders,2015,0,14,17,-3
13,5-7,5,7,Oakland Raiders,2015,0,17,16,1
12,5-6,5,6,Oakland Raiders,2015,0,16,18,-2
11,4-6,4,6,Oakland Raiders,2015,0,18,14,4
10,4-5,4,5,Oakland Raiders,2015,0,14,13,1
9,4-4,4,4,Oakland Raiders,2015,0,13,9,4
8,4-3,4,3,Oakland Raiders,2015,0,9,16,-7
7,3-3,3,3,Oakland Raiders,2015,0,16,23,-7
6,2-3,2,3,Oakland Raiders,2015,0,23,22,1
5,2-3,2,3,Oakland Raiders,2015,0,22,20,2
4,2-2,2,2,Oakland Raiders,2015,0,20,20,0
3,2-1,2,1,Oakland Raiders,2015,0,20,28,-8
2,1-1,1,1,Oakland Raiders,2015,0,28,31,-3
1,0-1,0,1,Oakland Raiders,2015,0,31,28,3
0,3-13,3,13,Oakland Raiders,2015,0,28,0,28
17,10-6,10,6,Philadelphia Eagles,2006,0,7,7,0
16,9-6,9,6,Philadelphia Eagles,2006,0,7,9,-2
15,8-6,8,6,Philadelphia Eagles,2006,0,9,13,-4
14,7-6,7,6,Philadelphia Eagles,2006,0,13,17,-4
13,6-6,6,6,Philadelphia Eagles,2006,0,17,22,-5
12,5-6,5,6,Philadelphia Eagles,2006,0,22,20,2
11,5-5,5,5,Philadelphia Eagles,2006,0,20,11,9
10,5-4,5,4,Philadelphia Eagles,2006,0,11,16,-5
9,4-4,4,4,Philadelphia Eagles,2006,0,16,17,-1
8,4-4,4,4,Philadelphia Eagles,2006,0,17,15,2
7,4-3,4,3,Philadelphia Eagles,2006,0,15,9,6
6,4-2,4,2,Philadelphia Eagles,2006,0,9,4,5
5,4-1,4,1,Philadelphia Eagles,2006,0,4,4,0
4,3-1,3,1,Philadelphia Eagles,2006,0,4,10,-6
3,2-1,2,1,Philadelphia Eagles,2006,0,10,15,-5
2,1-1,1,1,Philadelphia Eagles,2006,0,15,11,4
1,1-0,1,0,Philadelphia Eagles,2006,0,11,15,-4
0,6-10,6,10,Philadelphia Eagles,2006,0,15,0,15
17,3-13,3,13,Oakland Raiders,2014,0,29,28,1
16,3-12,3,12,Oakland Raiders,2014,0,28,31,-3
15,2-12,2,12,Oakland Raiders,2014,0,31,29,2
14,2-11,2,11,Oakland Raiders,2014,0,29,32,-3
13,1-11,1,11,Oakland Raiders,2014,0,32,31,1
12,1-10,1,10,Oakland Raiders,2014,0,31,32,-1
11,0-10,0,10,Oakland Raiders,2014,0,32,32,0
10,0-9,0,9,Oakland Raiders,2014,0,32,32,0
9,0-8,0,8,Oakland Raiders,2014,0,32,32,0
8,0-7,0,7,Oakland Raiders,2014,0,32,32,0
7,0-6,0,6,Oakland Raiders,2014,0,32,31,1
6,0-5,0,5,Oakland Raiders,2014,0,31,32,-1
5,0-4,0,4,Oakland Raiders,2014,0,32,32,0
4,0-4,0,4,Oakland Raiders,2014,0,32,30,2
3,0-3,0,3,Oakland Raiders,2014,0,30,32,-2
2,0-2,0,2,Oakland Raiders,2014,0,32,31,1
1,0-1,0,1,Oakland Raiders,2014,0,31,32,-1
0,4-12,4,12,Oakland Raiders,2014,0,32,0,32
17,9-6,9,6,Philadelphia Eagles,2008,0,11,15,-4
16,8-6,8,6,Philadelphia Eagles,2008,0,15,13,2
15,8-5,8,5,Philadelphia Eagles,2008,0,13,14,-1
14,7-5,7,5,Philadelphia Eagles,2008,0,14,17,-3
13,6-5,6,5,Philadelphia Eagles,2008,0,17,21,-4
12,5-5,5,5,Philadelphia Eagles,2008,0,21,17,4
11,5-4,5,4,Philadelphia Eagles,2008,0,17,13,4
10,5-4,5,4,Philadelphia Eagles,2008,0,13,6,7
9,5-3,5,3,Philadelphia Eagles,2008,0,6,10,-4
8,4-3,4,3,Philadelphia Eagles,2008,0,10,11,-1
7,3-3,3,3,Philadelphia Eagles,2008,0,11,13,-2
6,3-3,3,3,Philadelphia Eagles,2008,0,13,12,1
5,2-3,2,3,Philadelphia Eagles,2008,0,12,9,3
4,2-2,2,2,Philadelphia Eagles,2008,0,9,3,6
3,2-1,2,1,Philadelphia Eagles,2008,0,3,5,-2
2,1-1,1,1,Philadelphia Eagles,2008,0,5,6,-1
1,1-0,1,0,Philadelphia Eagles,2008,0,6,12,-6
0,8-8,8,8,Philadelphia Eagles,2008,0,12,0,12
17,8-8,8,8,Philadelphia Eagles,2007,0,14,15,-1
16,7-8,7,8,Philadelphia Eagles,2007,0,15,18,-3
15,6-8,6,8,Philadelphia Eagles,2007,0,18,21,-3
14,5-8,5,8,Philadelphia Eagles,2007,0,21,19,2
13,5-7,5,7,Philadelphia Eagles,2007,0,19,15,4
12,5-6,5,6,Philadelphia Eagles,2007,0,15,15,0
11,5-5,5,5,Philadelphia Eagles,2007,0,15,17,-2
10,4-5,4,5,Philadelphia Eagles,2007,0,17,22,-5
9,3-5,3,5,Philadelphia Eagles,2007,0,22,20,2
8,3-4,3,4,Philadelphia Eagles,2007,0,20,22,-2
7,2-4,2,4,Philadelphia Eagles,2007,0,22,17,5
6,2-3,2,3,Philadelphia Eagles,2007,0,17,22,-5
5,1-3,1,3,Philadelphia Eagles,2007,0,22,22,0
4,1-3,1,3,Philadelphia Eagles,2007,0,22,16,6
3,1-2,1,2,Philadelphia Eagles,2007,0,16,20,-4
2,0-2,0,2,Philadelphia Eagles,2007,0,20,13,7
1,0-1,0,1,Philadelphia Eagles,2007,0,13,7,6
0,10-6,10,6,Philadelphia Eagles,2007,0,7,0,7
17,10-6,10,6,Philadelphia Eagles,2010,0,7,7,0
16,10-5,10,5,Philadelphia Eagles,2010,0,7,3,4
15,10-4,10,4,Philadelphia Eagles,2010,0,3,6,-3
14,9-4,9,4,Philadelphia Eagles,2010,0,6,9,-3
13,8-4,8,4,Philadelphia Eagles,2010,0,9,9,0
12,7-4,7,4,Philadelphia Eagles,2010,0,9,6,3
11,7-3,7,3,Philadelphia Eagles,2010,0,6,6,0
10,6-3,6,3,Philadelphia Eagles,2010,0,6,8,-2
9,5-3,5,3,Philadelphia Eagles,2010,0,8,12,-4
8,4-3,4,3,Philadelphia Eagles,2010,0,12,11,1
7,4-3,4,3,Philadelphia Eagles,2010,0,11,10,1
6,4-2,4,2,Philadelphia Eagles,2010,0,10,14,-4
5,3-2,3,2,Philadelphia Eagles,2010,0,14,17,-3
4,2-2,2,2,Philadelphia Eagles,2010,0,17,14,3
3,2-1,2,1,Philadelphia Eagles,2010,0,14,16,-2
2,1-1,1,1,Philadelphia Eagles,2010,0,16,18,-2
1,0-1,0,1,Philadelphia Eagles,2010,0,18,15,3
0,11-5,11,5,Philadelphia Eagles,2010,0,15,0,15
17,11-5,11,5,Philadelphia Eagles,2009,0,7,4,3
16,11-4,11,4,Philadelphia Eagles,2009,0,4,5,-1
15,10-4,10,4,Philadelphia Eagles,2009,0,5,5,0
14,9-4,9,4,Philadelphia Eagles,2009,0,5,8,-3
13,8-4,8,4,Philadelphia Eagles,2009,0,8,9,-1
12,7-4,7,4,Philadelphia Eagles,2009,0,9,10,-1
11,6-4,6,4,Philadelphia Eagles,2009,0,10,12,-2
10,5-4,5,4,Philadelphia Eagles,2009,0,12,11,1
9,5-3,5,3,Philadelphia Eagles,2009,0,11,9,2
8,5-2,5,2,Philadelphia Eagles,2009,0,9,12,-3
7,4-2,4,2,Philadelphia Eagles,2009,0,12,12,0
6,3-2,3,2,Philadelphia Eagles,2009,0,12,7,5
5,3-1,3,1,Philadelphia Eagles,2009,0,7,10,-3
4,2-1,2,1,Philadelphia Eagles,2009,0,10,9,1
3,2-1,2,1,Philadelphia Eagles,2009,0,9,9,0
2,1-1,1,1,Philadelphia Eagles,2009,0,9,4,5
1,1-0,1,0,Philadelphia Eagles,2009,0,4,4,0
0,9-6,9,6,Philadelphia Eagles,2009,0,4,0,4
17,8-8,8,8,Philadelphia Eagles,2011,0,15,17,-2
16,7-8,7,8,Philadelphia Eagles,2011,0,17,18,-1
15,6-8,6,8,Philadelphia Eagles,2011,0,18,21,-3
14,5-8,5,8,Philadelphia Eagles,2011,0,21,24,-3
13,4-8,4,8,Philadelphia Eagles,2011,0,24,18,6
12,4-7,4,7,Philadelphia Eagles,2011,0,18,18,0
11,4-6,4,6,Philadelphia Eagles,2011,0,18,22,-4
10,3-6,3,6,Philadelphia Eagles,2011,0,22,16,6
9,3-5,3,5,Philadelphia Eagles,2011,0,16,16,0
8,3-4,3,4,Philadelphia Eagles,2011,0,16,22,-6
7,2-4,2,4,Philadelphia Eagles,2011,0,22,20,2
6,2-4,2,4,Philadelphia Eagles,2011,0,20,21,-1
5,1-4,1,4,Philadelphia Eagles,2011,0,21,20,1
4,1-3,1,3,Philadelphia Eagles,2011,0,20,17,3
3,1-2,1,2,Philadelphia Eagles,2011,0,17,6,11
2,1-1,1,1,Philadelphia Eagles,2011,0,6,3,3
1,1-0,1,0,Philadelphia Eagles,2011,0,3,4,-1
0,10-6,10,6,Philadelphia Eagles,2011,0,4,0,4
17,4-12,4,12,Philadelphia Eagles,2012,0,29,29,0
16,4-11,4,11,Philadelphia Eagles,2012,0,29,29,0
15,4-10,4,10,Philadelphia Eagles,2012,0,29,27,2
14,4-9,4,9,Philadelphia Eagles,2012,0,27,30,-3
13,3-9,3,9,Philadelphia Eagles,2012,0,30,30,0
12,3-8,3,8,Philadelphia Eagles,2012,0,30,27,3
11,3-7,3,7,Philadelphia Eagles,2012,0,27,24,3
10,3-6,3,6,Philadelphia Eagles,2012,0,24,21,3
9,3-5,3,5,Philadelphia Eagles,2012,0,21,18,3
8,3-4,3,4,Philadelphia Eagles,2012,0,18,13,5
7,3-3,3,3,Philadelphia Eagles,2012,0,13,13,0
6,3-3,3,3,Philadelphia Eagles,2012,0,13,11,2
5,3-2,3,2,Philadelphia Eagles,2012,0,11,7,4
4,3-1,3,1,Philadelphia Eagles,2012,0,7,9,-2
3,2-1,2,1,Philadelphia Eagles,2012,0,9,7,2
2,2-0,2,0,Philadelphia Eagles,2012,0,7,12,-5
1,1-0,1,0,Philadelphia Eagles,2012,0,12,7,5
0,8-8,8,8,Philadelphia Eagles,2012,0,7,0,7
17,10-6,10,6,Philadelphia Eagles,2013,0,11,11,0
16,9-6,9,6,Philadelphia Eagles,2013,0,11,11,0
15,8-6,8,6,Philadelphia Eagles,2013,0,11,9,2
14,8-5,8,5,Philadelphia Eagles,2013,0,9,10,-1
13,7-5,7,5,Philadelphia Eagles,2013,0,10,11,-1
12,6-5,6,5,Philadelphia Eagles,2013,0,11,12,-1
11,6-5,6,5,Philadelphia Eagles,2013,0,12,14,-2
10,5-5,5,5,Philadelphia Eagles,2013,0,14,20,-6
9,4-5,4,5,Philadelphia Eagles,2013,0,20,26,-6
8,3-5,3,5,Philadelphia Eagles,2013,0,26,19,7
7,3-4,3,4,Philadelphia Eagles,2013,0,19,17,2
6,3-3,3,3,Philadelphia Eagles,2013,0,17,21,-4
5,2-3,2,3,Philadelphia Eagles,2013,0,21,27,-6
4,1-3,1,3,Philadelphia Eagles,2013,0,27,23,4
3,1-2,1,2,Philadelphia Eagles,2013,0,23,19,4
2,1-1,1,1,Philadelphia Eagles,2013,0,19,14,5
1,1-0,1,0,Philadelphia Eagles,2013,0,14,25,-11
0,4-12,4,12,Philadelphia Eagles,2013,0,25,0,25
17,10-6,10,6,Philadelphia Eagles,2014,0,12,13,-1
16,9-6,9,6,Philadelphia Eagles,2014,0,13,9,4
15,9-5,9,5,Philadelphia Eagles,2014,0,9,7,2
14,9-4,9,4,Philadelphia Eagles,2014,0,7,4,3
13,9-3,9,3,Philadelphia Eagles,2014,0,4,6,-2
12,8-3,8,3,Philadelphia Eagles,2014,0,6,8,-2
11,7-3,7,3,Philadelphia Eagles,2014,0,8,4,4
10,7-2,7,2,Philadelphia Eagles,2014,0,4,4,0
9,6-2,6,2,Philadelphia Eagles,2014,0,4,5,-1
8,5-2,5,2,Philadelphia Eagles,2014,0,5,3,2
7,5-1,5,1,Philadelphia Eagles,2014,0,3,4,-1
6,5-1,5,1,Philadelphia Eagles,2014,0,4,4,0
5,4-1,4,1,Philadelphia Eagles,2014,0,4,6,-2
4,3-1,3,1,Philadelphia Eagles,2014,0,6,4,2
3,3-0,3,0,Philadelphia Eagles,2014,0,4,4,0
2,2-0,2,0,Philadelphia Eagles,2014,0,4,4,0
1,1-0,1,0,Philadelphia Eagles,2014,0,4,7,-3
0,10-6,10,6,Philadelphia Eagles,2014,0,7,0,7
17,7-9,7,9,Philadelphia Eagles,2015,0,18,19,-1
16,6-9,6,9,Philadelphia Eagles,2015,0,19,19,0
15,6-8,6,8,Philadelphia Eagles,2015,0,19,12,7
14,6-7,6,7,Philadelphia Eagles,2015,0,12,19,-7
13,5-7,5,7,Philadelphia Eagles,2015,0,19,24,-5
12,4-7,4,7,Philadelphia Eagles,2015,0,24,25,-1
11,4-6,4,6,Philadelphia Eagles,2015,0,25,19,6
10,4-5,4,5,Philadelphia Eagles,2015,0,19,16,3
9,4-4,4,4,Philadelphia Eagles,2015,0,16,18,-2
8,3-4,3,4,Philadelphia Eagles,2015,0,18,15,3
7,3-4,3,4,Philadelphia Eagles,2015,0,15,9,6
6,3-3,3,3,Philadelphia Eagles,2015,0,9,15,-6
5,2-3,2,3,Philadelphia Eagles,2015,0,15,22,-7
4,1-3,1,3,Philadelphia Eagles,2015,0,22,17,5
3,1-2,1,2,Philadelphia Eagles,2015,0,17,22,-5
2,0-2,0,2,Philadelphia Eagles,2015,0,22,15,7
1,0-1,0,1,Philadelphia Eagles,2015,0,15,9,6
0,10-6,10,6,Philadelphia Eagles,2015,0,9,0,9
17,8-8,8,8,Pittsburgh Steelers,2006,0,13,19,-6
16,7-8,7,8,Pittsburgh Steelers,2006,0,19,14,5
15,7-7,7,7,Pittsburgh Steelers,2006,0,14,20,-6
14,6-7,6,7,Pittsburgh Steelers,2006,0,20,19,1
13,5-7,5,7,Pittsburgh Steelers,2006,0,19,24,-5
12,4-7,4,7,Pittsburgh Steelers,2006,0,24,15,9
11,4-6,4,6,Pittsburgh Steelers,2006,0,15,19,-4
10,3-6,3,6,Pittsburgh Steelers,2006,0,19,24,-5
9,2-6,2,6,Pittsburgh Steelers,2006,0,24,21,3
8,2-5,2,5,Pittsburgh Steelers,2006,0,21,18,3
7,2-4,2,4,Pittsburgh Steelers,2006,0,18,17,1
6,2-3,2,3,Pittsburgh Steelers,2006,0,17,18,-1
5,1-3,1,3,Pittsburgh Steelers,2006,0,18,13,5
4,1-2,1,2,Pittsburgh Steelers,2006,0,13,12,1
3,1-2,1,2,Pittsburgh Steelers,2006,0,12,9,3
2,1-1,1,1,Pittsburgh Steelers,2006,0,9,1,8
1,1-0,1,0,Pittsburgh Steelers,2006,0,1,3,-2
0,11-5,11,5,Pittsburgh Steelers,2006,0,3,0,3
17,10-6,10,6,Pittsburgh Steelers,2007,0,8,8,0
16,10-5,10,5,Pittsburgh Steelers,2007,0,8,8,0
15,9-5,9,5,Pittsburgh Steelers,2007,0,8,8,0
14,9-4,9,4,Pittsburgh Steelers,2007,0,8,5,3
13,9-3,9,3,Pittsburgh Steelers,2007,0,5,6,-1
12,8-3,8,3,Pittsburgh Steelers,2007,0,6,7,-1
11,7-3,7,3,Pittsburgh Steelers,2007,0,7,5,2
10,7-2,7,2,Pittsburgh Steelers,2007,0,5,4,1
9,6-2,6,2,Pittsburgh Steelers,2007,0,4,6,-2
8,5-2,5,2,Pittsburgh Steelers,2007,0,6,6,0
7,4-2,4,2,Pittsburgh Steelers,2007,0,6,3,3
6,4-1,4,1,Pittsburgh Steelers,2007,0,3,4,-1
5,4-1,4,1,Pittsburgh Steelers,2007,0,4,6,-2
4,3-1,3,1,Pittsburgh Steelers,2007,0,6,4,2
3,3-0,3,0,Pittsburgh Steelers,2007,0,4,5,-1
2,2-0,2,0,Pittsburgh Steelers,2007,0,5,9,-4
1,1-0,1,0,Pittsburgh Steelers,2007,0,9,13,-4
0,8-8,8,8,Pittsburgh Steelers,2007,0,13,0,13
17,12-4,12,4,Pittsburgh Steelers,2008,0,3,4,-1
16,11-4,11,4,Pittsburgh Steelers,2008,0,4,1,3
15,11-3,11,3,Pittsburgh Steelers,2008,0,1,3,-2
14,10-3,10,3,Pittsburgh Steelers,2008,0,3,3,0
13,9-3,9,3,Pittsburgh Steelers,2008,0,3,4,-1
12,8-3,8,3,Pittsburgh Steelers,2008,0,4,4,0
11,7-3,7,3,Pittsburgh Steelers,2008,0,4,4,0
10,6-3,6,3,Pittsburgh Steelers,2008,0,4,3,1
9,6-2,6,2,Pittsburgh Steelers,2008,0,3,4,-1
8,5-2,5,2,Pittsburgh Steelers,2008,0,4,3,1
7,5-1,5,1,Pittsburgh Steelers,2008,0,3,3,0
6,4-1,4,1,Pittsburgh Steelers,2008,0,3,5,-2
5,4-1,4,1,Pittsburgh Steelers,2008,0,5,5,0
4,3-1,3,1,Pittsburgh Steelers,2008,0,5,5,0
3,2-1,2,1,Pittsburgh Steelers,2008,0,5,2,3
2,2-0,2,0,Pittsburgh Steelers,2008,0,2,2,0
1,1-0,1,0,Pittsburgh Steelers,2008,0,2,6,-4
0,10-6,10,6,Pittsburgh Steelers,2008,0,6,0,6
17,12-4,12,4,Pittsburgh Steelers,2010,0,3,5,-2
16,11-4,11,4,Pittsburgh Steelers,2010,0,5,6,-1
15,10-4,10,4,Pittsburgh Steelers,2010,0,6,3,3
14,10-3,10,3,Pittsburgh Steelers,2010,0,3,3,0
13,9-3,9,3,Pittsburgh Steelers,2010,0,3,5,-2
12,8-3,8,3,Pittsburgh Steelers,2010,0,5,5,0
11,7-3,7,3,Pittsburgh Steelers,2010,0,5,5,0
10,6-3,6,3,Pittsburgh Steelers,2010,0,5,2,3
9,6-2,6,2,Pittsburgh Steelers,2010,0,2,3,-1
8,5-2,5,2,Pittsburgh Steelers,2010,0,3,1,2
7,5-1,5,1,Pittsburgh Steelers,2010,0,1,1,0
6,4-1,4,1,Pittsburgh Steelers,2010,0,1,1,0
5,3-1,3,1,Pittsburgh Steelers,2010,0,1,1,0
4,3-1,3,1,Pittsburgh Steelers,2010,0,1,1,0
3,3-0,3,0,Pittsburgh Steelers,2010,0,1,5,-4
2,2-0,2,0,Pittsburgh Steelers,2010,0,5,10,-5
1,1-0,1,0,Pittsburgh Steelers,2010,0,10,18,-8
0,9-7,9,7,Pittsburgh Steelers,2010,0,18,0,18
17,8-8,8,8,Pittsburgh Steelers,2012,0,17,18,-1
16,7-8,7,8,Pittsburgh Steelers,2012,0,18,16,2
15,7-7,7,7,Pittsburgh Steelers,2012,0,16,15,1
14,7-6,7,6,Pittsburgh Steelers,2012,0,15,13,2
13,7-5,7,5,Pittsburgh Steelers,2012,0,13,14,-1
12,6-5,6,5,Pittsburgh Steelers,2012,0,14,11,3
11,6-4,6,4,Pittsburgh Steelers,2012,0,11,9,2
10,6-3,6,3,Pittsburgh Steelers,2012,0,9,10,-1
9,5-3,5,3,Pittsburgh Steelers,2012,0,10,10,0
8,4-3,4,3,Pittsburgh Steelers,2012,0,10,10,0
7,3-3,3,3,Pittsburgh Steelers,2012,0,10,14,-4
6,2-3,2,3,Pittsburgh Steelers,2012,0,14,10,4
5,2-2,2,2,Pittsburgh Steelers,2012,0,10,16,-6
4,1-2,1,2,Pittsburgh Steelers,2012,0,16,16,0
3,1-2,1,2,Pittsburgh Steelers,2012,0,16,9,7
2,1-1,1,1,Pittsburgh Steelers,2012,0,9,11,-2
1,0-1,0,1,Pittsburgh Steelers,2012,0,11,8,3
0,12-4,12,4,Pittsburgh Steelers,2012,0,8,0,8
17,12-4,12,4,Pittsburgh Steelers,2011,0,6,6,0
16,11-4,11,4,Pittsburgh Steelers,2011,0,6,6,0
15,10-4,10,4,Pittsburgh Steelers,2011,0,6,4,2
14,10-3,10,3,Pittsburgh Steelers,2011,0,4,5,-1
13,9-3,9,3,Pittsburgh Steelers,2011,0,5,5,0
12,8-3,8,3,Pittsburgh Steelers,2011,0,5,4,1
11,7-3,7,3,Pittsburgh Steelers,2011,0,4,4,0
10,7-3,7,3,Pittsburgh Steelers,2011,0,4,5,-1
9,6-3,6,3,Pittsburgh Steelers,2011,0,5,3,2
8,6-2,6,2,Pittsburgh Steelers,2011,0,3,5,-2
7,5-2,5,2,Pittsburgh Steelers,2011,0,5,8,-3
6,4-2,4,2,Pittsburgh Steelers,2011,0,8,8,0
5,3-2,3,2,Pittsburgh Steelers,2011,0,8,13,-5
4,2-2,2,2,Pittsburgh Steelers,2011,0,13,10,3
3,2-1,2,1,Pittsburgh Steelers,2011,0,10,9,1
2,1-1,1,1,Pittsburgh Steelers,2011,0,9,8,1
1,0-1,0,1,Pittsburgh Steelers,2011,0,8,3,5
0,12-4,12,4,Pittsburgh Steelers,2011,0,3,0,3
17,8-8,8,8,Pittsburgh Steelers,2013,0,14,18,-4
16,7-8,7,8,Pittsburgh Steelers,2013,0,18,19,-1
15,6-8,6,8,Pittsburgh Steelers,2013,0,19,19,0
14,5-8,5,8,Pittsburgh Steelers,2013,0,19,18,1
13,5-7,5,7,Pittsburgh Steelers,2013,0,18,16,2
12,5-6,5,6,Pittsburgh Steelers,2013,0,16,19,-3
11,4-6,4,6,Pittsburgh Steelers,2013,0,19,24,-5
10,3-6,3,6,Pittsburgh Steelers,2013,0,24,27,-3
9,2-6,2,6,Pittsburgh Steelers,2013,0,27,27,0
8,2-5,2,5,Pittsburgh Steelers,2013,0,27,25,2
7,2-4,2,4,Pittsburgh Steelers,2013,0,25,27,-2
6,1-4,1,4,Pittsburgh Steelers,2013,0,27,29,-2
5,0-4,0,4,Pittsburgh Steelers,2013,0,29,29,0
4,0-4,0,4,Pittsburgh Steelers,2013,0,29,28,1
3,0-3,0,3,Pittsburgh Steelers,2013,0,28,25,3
2,0-2,0,2,Pittsburgh Steelers,2013,0,25,23,2
1,0-1,0,1,Pittsburgh Steelers,2013,0,23,16,7
0,8-8,8,8,Pittsburgh Steelers,2013,0,16,0,16
17,9-7,9,7,Pittsburgh Steelers,2009,0,13,12,1
16,8-7,8,7,Pittsburgh Steelers,2009,0,12,15,-3
15,7-7,7,7,Pittsburgh Steelers,2009,0,15,19,-4
14,6-7,6,7,Pittsburgh Steelers,2009,0,19,15,4
13,6-6,6,6,Pittsburgh Steelers,2009,0,15,12,3
12,6-5,6,5,Pittsburgh Steelers,2009,0,12,9,3
11,6-4,6,4,Pittsburgh Steelers,2009,0,9,6,3
10,6-3,6,3,Pittsburgh Steelers,2009,0,6,5,1
9,6-2,6,2,Pittsburgh Steelers,2009,0,5,7,-2
8,5-2,5,2,Pittsburgh Steelers,2009,0,7,7,0
7,5-2,5,2,Pittsburgh Steelers,2009,0,7,8,-1
6,4-2,4,2,Pittsburgh Steelers,2009,0,8,13,-5
5,3-2,3,2,Pittsburgh Steelers,2009,0,13,15,-2
4,2-2,2,2,Pittsburgh Steelers,2009,0,15,16,-1
3,1-2,1,2,Pittsburgh Steelers,2009,0,16,6,10
2,1-1,1,1,Pittsburgh Steelers,2009,0,6,1,5
1,1-0,1,0,Pittsburgh Steelers,2009,0,1,1,0
0,12-4,12,4,Pittsburgh Steelers,2009,0,1,0,1
17,11-5,11,5,Pittsburgh Steelers,2014,0,6,7,-1
16,10-5,10,5,Pittsburgh Steelers,2014,0,7,10,-3
15,9-5,9,5,Pittsburgh Steelers,2014,0,10,10,0
14,8-5,8,5,Pittsburgh Steelers,2014,0,10,16,-6
13,7-5,7,5,Pittsburgh Steelers,2014,0,16,14,2
12,7-4,7,4,Pittsburgh Steelers,2014,0,14,12,2
11,7-4,7,4,Pittsburgh Steelers,2014,0,12,14,-2
10,6-4,6,4,Pittsburgh Steelers,2014,0,14,7,7
9,6-3,6,3,Pittsburgh Steelers,2014,0,7,14,-7
8,5-3,5,3,Pittsburgh Steelers,2014,0,14,15,-1
7,4-3,4,3,Pittsburgh Steelers,2014,0,15,22,-7
6,3-3,3,3,Pittsburgh Steelers,2014,0,22,16,6
5,3-2,3,2,Pittsburgh Steelers,2014,0,16,18,-2
4,2-2,2,2,Pittsburgh Steelers,2014,0,18,11,7
3,2-1,2,1,Pittsburgh Steelers,2014,0,11,19,-8
2,1-1,1,1,Pittsburgh Steelers,2014,0,19,12,7
1,1-0,1,0,Pittsburgh Steelers,2014,0,12,13,-1
0,8-8,8,8,Pittsburgh Steelers,2014,0,13,0,13
17,10-6,10,6,Pittsburgh Steelers,2015,0,7,9,-2
16,9-6,9,6,Pittsburgh Steelers,2015,0,9,4,5
15,9-5,9,5,Pittsburgh Steelers,2015,0,4,6,-2
14,8-5,8,5,Pittsburgh Steelers,2015,0,6,8,-2
13,7-5,7,5,Pittsburgh Steelers,2015,0,8,9,-1
12,6-5,6,5,Pittsburgh Steelers,2015,0,9,9,0
11,6-4,6,4,Pittsburgh Steelers,2015,0,9,9,0
10,6-4,6,4,Pittsburgh Steelers,2015,0,9,9,0
9,5-4,5,4,Pittsburgh Steelers,2015,0,9,13,-4
8,4-4,4,4,Pittsburgh Steelers,2015,0,13,10,3
7,4-3,4,3,Pittsburgh Steelers,2015,0,10,10,0
6,4-2,4,2,Pittsburgh Steelers,2015,0,10,9,1
5,3-2,3,2,Pittsburgh Steelers,2015,0,9,10,-1
4,2-2,2,2,Pittsburgh Steelers,2015,0,10,8,2
3,2-1,2,1,Pittsburgh Steelers,2015,0,8,4,4
2,1-1,1,1,Pittsburgh Steelers,2015,0,4,13,-9
1,0-1,0,1,Pittsburgh Steelers,2015,0,13,7,6
0,11-5,11,5,Pittsburgh Steelers,2015,0,7,0,7
17,7-9,7,9,San Francisco 49ers,2006,0,23,24,-1
16,6-9,6,9,San Francisco 49ers,2006,0,24,20,4
15,6-8,6,8,San Francisco 49ers,2006,0,20,25,-5
14,5-8,5,8,San Francisco 49ers,2006,0,25,22,3
13,5-7,5,7,San Francisco 49ers,2006,0,22,20,2
12,5-6,5,6,San Francisco 49ers,2006,0,20,18,2
11,5-5,5,5,San Francisco 49ers,2006,0,18,22,-4
10,4-5,4,5,San Francisco 49ers,2006,0,22,23,-1
9,3-5,3,5,San Francisco 49ers,2006,0,23,29,-6
8,2-5,2,5,San Francisco 49ers,2006,0,29,25,4
7,2-4,2,4,San Francisco 49ers,2006,0,25,24,1
6,2-4,2,4,San Francisco 49ers,2006,0,24,22,2
5,2-3,2,3,San Francisco 49ers,2006,0,22,29,-7
4,1-3,1,3,San Francisco 49ers,2006,0,29,25,4
3,1-2,1,2,San Francisco 49ers,2006,0,25,25,0
2,1-1,1,1,San Francisco 49ers,2006,0,25,30,-5
1,0-1,0,1,San Francisco 49ers,2006,0,30,32,-2
0,4-12,4,12,San Francisco 49ers,2006,0,32,0,32
17,5-11,5,11,San Francisco 49ers,2007,0,26,25,1
16,5-10,5,10,San Francisco 49ers,2007,0,25,28,-3
15,4-10,4,10,San Francisco 49ers,2007,0,28,31,-3
14,3-10,3,10,San Francisco 49ers,2007,0,31,30,1
13,3-9,3,9,San Francisco 49ers,2007,0,30,28,2
12,3-8,3,8,San Francisco 49ers,2007,0,28,31,-3
11,2-8,2,8,San Francisco 49ers,2007,0,31,28,3
10,2-7,2,7,San Francisco 49ers,2007,0,28,29,-1
9,2-6,2,6,San Francisco 49ers,2007,0,29,28,1
8,2-5,2,5,San Francisco 49ers,2007,0,28,28,0
7,2-4,2,4,San Francisco 49ers,2007,0,28,24,4
6,2-3,2,3,San Francisco 49ers,2007,0,24,21,3
5,2-3,2,3,San Francisco 49ers,2007,0,21,19,2
4,2-2,2,2,San Francisco 49ers,2007,0,19,15,4
3,2-1,2,1,San Francisco 49ers,2007,0,15,10,5
2,2-0,2,0,San Francisco 49ers,2007,0,10,15,-5
1,1-0,1,0,San Francisco 49ers,2007,0,15,16,-1
0,7-9,7,9,San Francisco 49ers,2007,0,16,0,16
17,7-9,7,9,San Francisco 49ers,2008,0,20,23,-3
16,6-9,6,9,San Francisco 49ers,2008,0,23,24,-1
15,5-9,5,9,San Francisco 49ers,2008,0,24,24,0
14,5-8,5,8,San Francisco 49ers,2008,0,24,25,-1
13,4-8,4,8,San Francisco 49ers,2008,0,25,27,-2
12,3-8,3,8,San Francisco 49ers,2008,0,27,26,1
11,3-7,3,7,San Francisco 49ers,2008,0,26,26,0
10,2-7,2,7,San Francisco 49ers,2008,0,26,28,-2
9,2-6,2,6,San Francisco 49ers,2008,0,28,29,-1
8,2-6,2,6,San Francisco 49ers,2008,0,29,28,1
7,2-5,2,5,San Francisco 49ers,2008,0,28,25,3
6,2-4,2,4,San Francisco 49ers,2008,0,25,24,1
5,2-3,2,3,San Francisco 49ers,2008,0,24,22,2
4,2-2,2,2,San Francisco 49ers,2008,0,22,22,0
3,2-1,2,1,San Francisco 49ers,2008,0,22,25,-3
2,1-1,1,1,San Francisco 49ers,2008,0,25,27,-2
1,0-1,0,1,San Francisco 49ers,2008,0,27,29,-2
0,5-11,5,11,San Francisco 49ers,2008,0,29,0,29
17,8-8,8,8,San Francisco 49ers,2009,0,19,21,-2
16,7-8,7,8,San Francisco 49ers,2009,0,21,22,-1
15,6-8,6,8,San Francisco 49ers,2009,0,22,21,1
14,6-7,6,7,San Francisco 49ers,2009,0,21,23,-2
13,5-7,5,7,San Francisco 49ers,2009,0,23,20,3
12,5-6,5,6,San Francisco 49ers,2009,0,20,20,0
11,4-6,4,6,San Francisco 49ers,2009,0,20,19,1
10,4-5,4,5,San Francisco 49ers,2009,0,19,20,-1
9,3-5,3,5,San Francisco 49ers,2009,0,20,19,1
8,3-4,3,4,San Francisco 49ers,2009,0,19,20,-1
7,3-3,3,3,San Francisco 49ers,2009,0,20,15,5
6,3-2,3,2,San Francisco 49ers,2009,0,15,15,0
5,3-2,3,2,San Francisco 49ers,2009,0,15,12,3
4,3-1,3,1,San Francisco 49ers,2009,0,12,15,-3
3,2-1,2,1,San Francisco 49ers,2009,0,15,13,2
2,2-0,2,0,San Francisco 49ers,2009,0,13,18,-5
1,1-0,1,0,San Francisco 49ers,2009,0,18,22,-4
0,7-9,7,9,San Francisco 49ers,2009,0,22,0,22
17,6-10,6,10,San Francisco 49ers,2010,0,25,27,-2
16,5-10,5,10,San Francisco 49ers,2010,0,27,25,2
15,5-9,5,9,San Francisco 49ers,2010,0,25,23,2
14,5-8,5,8,San Francisco 49ers,2010,0,23,26,-3
13,4-8,4,8,San Francisco 49ers,2010,0,26,25,1
12,4-7,4,7,San Francisco 49ers,2010,0,25,26,-1
11,3-7,3,7,San Francisco 49ers,2010,0,26,25,1
10,3-6,3,6,San Francisco 49ers,2010,0,25,28,-3
9,2-6,2,6,San Francisco 49ers,2010,0,28,30,-2
8,2-6,2,6,San Francisco 49ers,2010,0,30,31,-1
7,1-6,1,6,San Francisco 49ers,2010,0,31,27,4
6,1-5,1,5,San Francisco 49ers,2010,0,27,30,-3
5,0-5,0,5,San Francisco 49ers,2010,0,30,28,2
4,0-4,0,4,San Francisco 49ers,2010,0,28,25,3
3,0-3,0,3,San Francisco 49ers,2010,0,25,23,2
2,0-2,0,2,San Francisco 49ers,2010,0,23,20,3
1,0-1,0,1,San Francisco 49ers,2010,0,20,13,7
0,8-8,8,8,San Francisco 49ers,2010,0,13,0,13
17,13-3,13,3,San Francisco 49ers,2011,0,3,3,0
16,12-3,12,3,San Francisco 49ers,2011,0,3,3,0
15,11-3,11,3,San Francisco 49ers,2011,0,3,6,-3
14,10-3,10,3,San Francisco 49ers,2011,0,6,3,3
13,10-2,10,2,San Francisco 49ers,2011,0,3,3,0
12,9-2,9,2,San Francisco 49ers,2011,0,3,2,1
11,9-1,9,1,San Francisco 49ers,2011,0,2,2,0
10,8-1,8,1,San Francisco 49ers,2011,0,2,2,0
9,7-1,7,1,San Francisco 49ers,2011,0,2,2,0
8,6-1,6,1,San Francisco 49ers,2011,0,2,4,-2
7,5-1,5,1,San Francisco 49ers,2011,0,4,4,0
6,5-1,5,1,San Francisco 49ers,2011,0,4,9,-5
5,4-1,4,1,San Francisco 49ers,2011,0,9,16,-7
4,3-1,3,1,San Francisco 49ers,2011,0,16,20,-4
3,2-1,2,1,San Francisco 49ers,2011,0,20,23,-3
2,1-1,1,1,San Francisco 49ers,2011,0,23,22,1
1,1-0,1,0,San Francisco 49ers,2011,0,22,26,-4
0,6-10,6,10,San Francisco 49ers,2011,0,26,0,26
17,11-4,11,4,San Francisco 49ers,2012,0,3,3,0
16,10-4,10,4,San Francisco 49ers,2012,0,3,1,2
15,10-3,10,3,San Francisco 49ers,2012,0,1,4,-3
14,9-3,9,3,San Francisco 49ers,2012,0,4,4,0
13,8-3,8,3,San Francisco 49ers,2012,0,4,3,1
12,8-2,8,2,San Francisco 49ers,2012,0,3,3,0
11,7-2,7,2,San Francisco 49ers,2012,0,3,4,-1
10,6-2,6,2,San Francisco 49ers,2012,0,4,4,0
9,6-2,6,2,San Francisco 49ers,2012,0,4,4,0
8,6-2,6,2,San Francisco 49ers,2012,0,4,4,0
7,5-2,5,2,San Francisco 49ers,2012,0,4,5,-1
6,4-2,4,2,San Francisco 49ers,2012,0,5,3,2
5,4-1,4,1,San Francisco 49ers,2012,0,3,4,-1
4,3-1,3,1,San Francisco 49ers,2012,0,4,4,0
3,2-1,2,1,San Francisco 49ers,2012,0,4,1,3
2,2-0,2,0,San Francisco 49ers,2012,0,1,2,-1
1,1-0,1,0,San Francisco 49ers,2012,0,2,4,-2
0,13-3,13,3,San Francisco 49ers,2012,0,4,0,4
17,12-4,12,4,San Francisco 49ers,2013,0,4,4,0
16,11-4,11,4,San Francisco 49ers,2013,0,4,3,1
15,10-4,10,4,San Francisco 49ers,2013,0,3,5,-2
14,9-4,9,4,San Francisco 49ers,2013,0,5,6,-1
13,8-4,8,4,San Francisco 49ers,2013,0,6,7,-1
12,7-4,7,4,San Francisco 49ers,2013,0,7,9,-2
11,6-4,6,4,San Francisco 49ers,2013,0,9,8,1
10,6-3,6,3,San Francisco 49ers,2013,0,8,5,3
9,6-2,6,2,San Francisco 49ers,2013,0,5,6,-1
8,6-2,6,2,San Francisco 49ers,2013,0,6,6,0
7,5-2,5,2,San Francisco 49ers,2013,0,6,7,-1
6,4-2,4,2,San Francisco 49ers,2013,0,7,7,0
5,3-2,3,2,San Francisco 49ers,2013,0,7,8,-1
4,2-2,2,2,San Francisco 49ers,2013,0,8,10,-2
3,1-2,1,2,San Francisco 49ers,2013,0,10,3,7
2,1-1,1,1,San Francisco 49ers,2013,0,3,1,2
1,1-0,1,0,San Francisco 49ers,2013,0,1,3,-2
0,11-4,11,4,San Francisco 49ers,2013,0,3,0,3
17,8-8,8,8,San Francisco 49ers,2014,0,18,18,0
16,7-8,7,8,San Francisco 49ers,2014,0,18,17,1
15,7-7,7,7,San Francisco 49ers,2014,0,17,16,1
14,7-6,7,6,San Francisco 49ers,2014,0,16,12,4
13,7-5,7,5,San Francisco 49ers,2014,0,12,9,3
12,7-4,7,4,San Francisco 49ers,2014,0,9,10,-1
11,6-4,6,4,San Francisco 49ers,2014,0,10,12,-2
10,5-4,5,4,San Francisco 49ers,2014,0,12,16,-4
9,4-4,4,4,San Francisco 49ers,2014,0,16,11,5
8,4-3,4,3,San Francisco 49ers,2014,0,11,12,-1
7,4-3,4,3,San Francisco 49ers,2014,0,12,7,5
6,4-2,4,2,San Francisco 49ers,2014,0,7,7,0
5,3-2,3,2,San Francisco 49ers,2014,0,7,9,-2
4,2-2,2,2,San Francisco 49ers,2014,0,9,16,-7
3,1-2,1,2,San Francisco 49ers,2014,0,16,7,9
2,1-1,1,1,San Francisco 49ers,2014,0,7,3,4
1,1-0,1,0,San Francisco 49ers,2014,0,3,4,-1
0,12-4,12,4,San Francisco 49ers,2014,0,4,0,4
17,5-11,5,11,San Francisco 49ers,2015,0,29,31,-2
16,4-11,4,11,San Francisco 49ers,2015,0,31,30,1
15,4-10,4,10,San Francisco 49ers,2015,0,30,31,-1
14,4-9,4,9,San Francisco 49ers,2015,0,31,26,5
13,4-8,4,8,San Francisco 49ers,2015,0,26,31,-5
12,3-8,3,8,San Francisco 49ers,2015,0,31,29,2
11,3-7,3,7,San Francisco 49ers,2015,0,29,31,-2
10,3-6,3,6,San Francisco 49ers,2015,0,31,30,1
9,3-6,3,6,San Francisco 49ers,2015,0,30,31,-1
8,2-6,2,6,San Francisco 49ers,2015,0,31,27,4
7,2-5,2,5,San Francisco 49ers,2015,0,27,19,8
6,2-4,2,4,San Francisco 49ers,2015,0,19,25,-6
5,1-4,1,4,San Francisco 49ers,2015,0,25,27,-2
4,1-3,1,3,San Francisco 49ers,2015,0,27,28,-1
3,1-2,1,2,San Francisco 49ers,2015,0,28,20,8
2,1-1,1,1,San Francisco 49ers,2015,0,20,19,1
1,1-0,1,0,San Francisco 49ers,2015,0,19,24,-5
0,8-8,8,8,San Francisco 49ers,2015,0,24,0,24
17,9-7,9,7,Seattle Seahawks,2006,0,9,15,-6
16,8-7,8,7,Seattle Seahawks,2006,0,15,15,0
15,8-6,8,6,Seattle Seahawks,2006,0,15,10,5
14,8-5,8,5,Seattle Seahawks,2006,0,10,9,1
13,8-4,8,4,Seattle Seahawks,2006,0,9,8,1
12,7-4,7,4,Seattle Seahawks,2006,0,8,11,-3
11,6-4,6,4,Seattle Seahawks,2006,0,11,7,4
10,6-3,6,3,Seattle Seahawks,2006,0,7,12,-5
9,5-3,5,3,Seattle Seahawks,2006,0,12,13,-1
8,4-3,4,3,Seattle Seahawks,2006,0,13,11,2
7,4-2,4,2,Seattle Seahawks,2006,0,11,5,6
6,4-1,4,1,Seattle Seahawks,2006,0,5,8,-3
5,3-1,3,1,Seattle Seahawks,2006,0,8,6,2
4,3-1,3,1,Seattle Seahawks,2006,0,6,3,3
3,3-0,3,0,Seattle Seahawks,2006,0,3,2,1
2,2-0,2,0,Seattle Seahawks,2006,0,2,3,-1
1,1-0,1,0,Seattle Seahawks,2006,0,3,1,2
0,13-3,13,3,Seattle Seahawks,2006,0,1,0,1
17,10-6,10,6,Seattle Seahawks,2007,0,7,7,0
16,10-5,10,5,Seattle Seahawks,2007,0,7,10,-3
15,9-5,9,5,Seattle Seahawks,2007,0,10,6,4
14,9-4,9,4,Seattle Seahawks,2007,0,6,7,-1
13,8-4,8,4,Seattle Seahawks,2007,0,7,8,-1
12,7-4,7,4,Seattle Seahawks,2007,0,8,9,-1
11,6-4,6,4,Seattle Seahawks,2007,0,9,13,-4
10,5-4,5,4,Seattle Seahawks,2007,0,13,16,-3
9,4-4,4,4,Seattle Seahawks,2007,0,16,12,4
8,4-3,4,3,Seattle Seahawks,2007,0,12,15,-3
7,4-3,4,3,Seattle Seahawks,2007,0,15,14,1
6,3-3,3,3,Seattle Seahawks,2007,0,14,10,4
5,3-2,3,2,Seattle Seahawks,2007,0,10,5,5
4,3-1,3,1,Seattle Seahawks,2007,0,5,7,-2
3,2-1,2,1,Seattle Seahawks,2007,0,7,9,-2
2,1-1,1,1,Seattle Seahawks,2007,0,9,8,1
1,1-0,1,0,Seattle Seahawks,2007,0,8,10,-2
0,9-7,9,7,Seattle Seahawks,2007,0,10,0,10
17,4-12,4,12,Seattle Seahawks,2008,0,28,26,2
16,4-11,4,11,Seattle Seahawks,2008,0,26,27,-1
15,3-11,3,11,Seattle Seahawks,2008,0,27,28,-1
14,2-11,2,11,Seattle Seahawks,2008,0,28,29,-1
13,2-10,2,10,Seattle Seahawks,2008,0,29,28,1
12,2-9,2,9,Seattle Seahawks,2008,0,28,27,1
11,2-8,2,8,Seattle Seahawks,2008,0,27,27,0
10,2-7,2,7,Seattle Seahawks,2008,0,27,27,0
9,2-6,2,6,Seattle Seahawks,2008,0,27,27,0
8,2-5,2,5,Seattle Seahawks,2008,0,27,29,-2
7,1-5,1,5,Seattle Seahawks,2008,0,29,27,2
6,1-4,1,4,Seattle Seahawks,2008,0,27,26,1
5,1-3,1,3,Seattle Seahawks,2008,0,26,23,3
4,1-2,1,2,Seattle Seahawks,2008,0,23,23,0
3,1-2,1,2,Seattle Seahawks,2008,0,23,23,0
2,0-2,0,2,Seattle Seahawks,2008,0,23,18,5
1,0-1,0,1,Seattle Seahawks,2008,0,18,9,9
0,10-6,10,6,Seattle Seahawks,2008,0,9,0,9
17,7-9,7,9,Seattle Seahawks,2010,0,19,26,-7
16,6-9,6,9,Seattle Seahawks,2010,0,26,23,3
15,6-8,6,8,Seattle Seahawks,2010,0,23,24,-1
14,6-7,6,7,Seattle Seahawks,2010,0,24,20,4
13,6-6,6,6,Seattle Seahawks,2010,0,20,22,-2
12,5-6,5,6,Seattle Seahawks,2010,0,22,21,1
11,5-5,5,5,Seattle Seahawks,2010,0,21,20,1
10,5-4,5,4,Seattle Seahawks,2010,0,20,24,-4
9,4-4,4,4,Seattle Seahawks,2010,0,24,20,4
8,4-3,4,3,Seattle Seahawks,2010,0,20,17,3
7,4-2,4,2,Seattle Seahawks,2010,0,17,23,-6
6,3-2,3,2,Seattle Seahawks,2010,0,23,27,-4
5,2-2,2,2,Seattle Seahawks,2010,0,27,26,1
4,2-2,2,2,Seattle Seahawks,2010,0,26,19,7
3,2-1,2,1,Seattle Seahawks,2010,0,19,26,-7
2,1-1,1,1,Seattle Seahawks,2010,0,26,21,5
1,1-0,1,0,Seattle Seahawks,2010,0,21,26,-5
0,5-11,5,11,Seattle Seahawks,2010,0,26,0,26
17,5-11,5,11,Seattle Seahawks,2009,0,27,26,1
16,5-10,5,10,Seattle Seahawks,2009,0,26,24,2
15,5-9,5,9,Seattle Seahawks,2009,0,24,24,0
14,5-8,5,8,Seattle Seahawks,2009,0,24,21,3
13,5-7,5,7,Seattle Seahawks,2009,0,21,25,-4
12,4-7,4,7,Seattle Seahawks,2009,0,25,25,0
11,3-7,3,7,Seattle Seahawks,2009,0,25,25,0
10,3-6,3,6,Seattle Seahawks,2009,0,25,25,0
9,3-5,3,5,Seattle Seahawks,2009,0,25,24,1
8,2-5,2,5,Seattle Seahawks,2009,0,24,23,1
7,2-4,2,4,Seattle Seahawks,2009,0,23,23,0
6,2-4,2,4,Seattle Seahawks,2009,0,23,20,3
5,2-3,2,3,Seattle Seahawks,2009,0,20,24,-4
4,1-3,1,3,Seattle Seahawks,2009,0,24,23,1
3,1-2,1,2,Seattle Seahawks,2009,0,23,22,1
2,1-1,1,1,Seattle Seahawks,2009,0,22,14,8
1,1-0,1,0,Seattle Seahawks,2009,0,14,15,-1
0,4-12,4,12,Seattle Seahawks,2009,0,15,0,15
17,13-3,13,3,Seattle Seahawks,2013,0,1,1,0
16,12-3,12,3,Seattle Seahawks,2013,0,1,1,0
15,12-2,12,2,Seattle Seahawks,2013,0,1,1,0
14,11-2,11,2,Seattle Seahawks,2013,0,1,1,0
13,11-1,11,1,Seattle Seahawks,2013,0,1,1,0
12,10-1,10,1,Seattle Seahawks,2013,0,1,2,-1
11,10-1,10,1,Seattle Seahawks,2013,0,2,3,-1
10,9-1,9,1,Seattle Seahawks,2013,0,3,4,-1
9,8-1,8,1,Seattle Seahawks,2013,0,4,4,0
8,7-1,7,1,Seattle Seahawks,2013,0,4,4,0
7,6-1,6,1,Seattle Seahawks,2013,0,4,4,0
6,5-1,5,1,Seattle Seahawks,2013,0,4,5,-1
5,4-1,4,1,Seattle Seahawks,2013,0,5,2,3
4,4-0,4,0,Seattle Seahawks,2013,0,2,1,1
3,3-0,3,0,Seattle Seahawks,2013,0,1,1,0
2,2-0,2,0,Seattle Seahawks,2013,0,1,2,-1
1,1-0,1,0,Seattle Seahawks,2013,0,2,1,1
0,11-5,11,5,Seattle Seahawks,2013,0,1,0,1
17,11-5,11,5,Seattle Seahawks,2012,0,5,6,-1
16,10-5,10,5,Seattle Seahawks,2012,0,6,7,-1
15,9-5,9,5,Seattle Seahawks,2012,0,7,10,-3
14,8-5,8,5,Seattle Seahawks,2012,0,10,12,-2
13,7-5,7,5,Seattle Seahawks,2012,0,12,13,-1
12,6-5,6,5,Seattle Seahawks,2012,0,13,12,1
11,6-4,6,4,Seattle Seahawks,2012,0,12,12,0
10,6-4,6,4,Seattle Seahawks,2012,0,12,12,0
9,5-4,5,4,Seattle Seahawks,2012,0,12,13,-1
8,4-4,4,4,Seattle Seahawks,2012,0,13,11,2
7,4-3,4,3,Seattle Seahawks,2012,0,11,9,2
6,4-2,4,2,Seattle Seahawks,2012,0,9,16,-7
5,3-2,3,2,Seattle Seahawks,2012,0,16,17,-1
4,2-2,2,2,Seattle Seahawks,2012,0,17,10,7
3,2-1,2,1,Seattle Seahawks,2012,0,10,17,-7
2,1-1,1,1,Seattle Seahawks,2012,0,17,26,-9
1,0-1,0,1,Seattle Seahawks,2012,0,26,20,6
0,7-9,7,9,Seattle Seahawks,2012,0,20,0,20
17,12-4,12,4,Seattle Seahawks,2014,0,1,2,-1
16,11-4,11,4,Seattle Seahawks,2014,0,2,3,-1
15,10-4,10,4,Seattle Seahawks,2014,0,3,4,-1
14,9-4,9,4,Seattle Seahawks,2014,0,4,5,-1
13,8-4,8,4,Seattle Seahawks,2014,0,5,7,-2
12,7-4,7,4,Seattle Seahawks,2014,0,7,11,-4
11,6-4,6,4,Seattle Seahawks,2014,0,11,9,2
10,6-3,6,3,Seattle Seahawks,2014,0,9,10,-1
9,5-3,5,3,Seattle Seahawks,2014,0,10,10,0
8,4-3,4,3,Seattle Seahawks,2014,0,10,11,-1
7,3-3,3,3,Seattle Seahawks,2014,0,11,5,6
6,3-2,3,2,Seattle Seahawks,2014,0,5,1,4
5,3-1,3,1,Seattle Seahawks,2014,0,1,1,0
4,2-1,2,1,Seattle Seahawks,2014,0,1,1,0
3,2-1,2,1,Seattle Seahawks,2014,0,1,2,-1
2,1-1,1,1,Seattle Seahawks,2014,0,2,1,1
1,1-0,1,0,Seattle Seahawks,2014,0,1,1,0
0,13-3,13,3,Seattle Seahawks,2014,0,1,0,1
17,7-9,7,9,Seattle Seahawks,2011,0,21,18,3
16,7-8,7,8,Seattle Seahawks,2011,0,18,15,3
15,7-7,7,7,Seattle Seahawks,2011,0,15,20,-5
14,6-7,6,7,Seattle Seahawks,2011,0,20,19,1
13,5-7,5,7,Seattle Seahawks,2011,0,19,24,-5
12,4-7,4,7,Seattle Seahawks,2011,0,24,23,1
11,4-6,4,6,Seattle Seahawks,2011,0,23,24,-1
10,3-6,3,6,Seattle Seahawks,2011,0,24,28,-4
9,2-6,2,6,Seattle Seahawks,2011,0,28,27,1
8,2-5,2,5,Seattle Seahawks,2011,0,27,26,1
7,2-4,2,4,Seattle Seahawks,2011,0,26,22,4
6,2-3,2,3,Seattle Seahawks,2011,0,22,22,0
5,2-3,2,3,Seattle Seahawks,2011,0,22,25,-3
4,1-3,1,3,Seattle Seahawks,2011,0,25,24,1
3,1-2,1,2,Seattle Seahawks,2011,0,24,32,-8
2,0-2,0,2,Seattle Seahawks,2011,0,32,31,1
1,0-1,0,1,Seattle Seahawks,2011,0,31,25,6
0,7-9,7,9,Seattle Seahawks,2011,0,25,0,25
17,10-6,10,6,Seattle Seahawks,2015,0,3,10,-7
16,9-6,9,6,Seattle Seahawks,2015,0,10,7,3
15,9-5,9,5,Seattle Seahawks,2015,0,7,8,-1
14,8-5,8,5,Seattle Seahawks,2015,0,8,6,2
13,7-5,7,5,Seattle Seahawks,2015,0,6,7,-1
12,6-5,6,5,Seattle Seahawks,2015,0,7,8,-1
11,5-5,5,5,Seattle Seahawks,2015,0,8,11,-3
10,4-5,4,5,Seattle Seahawks,2015,0,11,7,4
9,4-4,4,4,Seattle Seahawks,2015,0,7,8,-1
8,4-4,4,4,Seattle Seahawks,2015,0,8,9,-1
7,3-4,3,4,Seattle Seahawks,2015,0,9,12,-3
6,2-4,2,4,Seattle Seahawks,2015,0,12,8,4
5,2-3,2,3,Seattle Seahawks,2015,0,8,7,1
4,2-2,2,2,Seattle Seahawks,2015,0,7,7,0
3,1-2,1,2,Seattle Seahawks,2015,0,7,7,0
2,0-2,0,2,Seattle Seahawks,2015,0,7,3,4
1,0-1,0,1,Seattle Seahawks,2015,0,3,1,2
0,12-4,12,4,Seattle Seahawks,2015,0,1,0,1
17,4-12,4,12,Tampa Bay Buccaneers,2006,0,29,29,0
16,4-11,4,11,Tampa Bay Buccaneers,2006,0,29,30,-1
15,3-11,3,11,Tampa Bay Buccaneers,2006,0,30,30,0
14,3-10,3,10,Tampa Bay Buccaneers,2006,0,30,30,0
13,3-9,3,9,Tampa Bay Buccaneers,2006,0,30,28,2
12,3-8,3,8,Tampa Bay Buccaneers,2006,0,28,27,1
11,3-7,3,7,Tampa Bay Buccaneers,2006,0,27,28,-1
10,2-7,2,7,Tampa Bay Buccaneers,2006,0,28,27,1
9,2-6,2,6,Tampa Bay Buccaneers,2006,0,27,24,3
8,2-5,2,5,Tampa Bay Buccaneers,2006,0,24,21,3
7,2-4,2,4,Tampa Bay Buccaneers,2006,0,21,22,-1
6,1-4,1,4,Tampa Bay Buccaneers,2006,0,22,28,-6
5,0-4,0,4,Tampa Bay Buccaneers,2006,0,28,27,1
4,0-3,0,3,Tampa Bay Buccaneers,2006,0,27,27,0
3,0-3,0,3,Tampa Bay Buccaneers,2006,0,27,23,4
2,0-2,0,2,Tampa Bay Buccaneers,2006,0,23,21,2
1,0-1,0,1,Tampa Bay Buccaneers,2006,0,21,12,9
0,11-5,11,5,Tampa Bay Buccaneers,2006,0,12,0,12
17,9-7,9,7,Tampa Bay Buccaneers,2007,0,12,12,0
16,9-6,9,6,Tampa Bay Buccaneers,2007,0,12,9,3
15,9-5,9,5,Tampa Bay Buccaneers,2007,0,9,11,-2
14,8-5,8,5,Tampa Bay Buccaneers,2007,0,11,8,3
13,8-4,8,4,Tampa Bay Buccaneers,2007,0,8,9,-1
12,7-4,7,4,Tampa Bay Buccaneers,2007,0,9,10,-1
11,6-4,6,4,Tampa Bay Buccaneers,2007,0,10,12,-2
10,5-4,5,4,Tampa Bay Buccaneers,2007,0,12,13,-1
9,5-4,5,4,Tampa Bay Buccaneers,2007,0,13,17,-4
8,4-4,4,4,Tampa Bay Buccaneers,2007,0,17,16,1
7,4-3,4,3,Tampa Bay Buccaneers,2007,0,16,8,8
6,4-2,4,2,Tampa Bay Buccaneers,2007,0,8,11,-3
5,3-2,3,2,Tampa Bay Buccaneers,2007,0,11,9,2
4,3-1,3,1,Tampa Bay Buccaneers,2007,0,9,19,-10
3,2-1,2,1,Tampa Bay Buccaneers,2007,0,19,23,-4
2,1-1,1,1,Tampa Bay Buccaneers,2007,0,23,28,-5
1,0-1,0,1,Tampa Bay Buccaneers,2007,0,28,28,0
0,4-12,4,12,Tampa Bay Buccaneers,2007,0,28,0,28
17,3-13,3,13,Tampa Bay Buccaneers,2009,0,30,29,1
16,3-12,3,12,Tampa Bay Buccaneers,2009,0,29,30,-1
15,2-12,2,12,Tampa Bay Buccaneers,2009,0,30,31,-1
14,1-12,1,12,Tampa Bay Buccaneers,2009,0,31,30,1
13,1-11,1,11,Tampa Bay Buccaneers,2009,0,30,30,0
12,1-10,1,10,Tampa Bay Buccaneers,2009,0,30,30,0
11,1-9,1,9,Tampa Bay Buccaneers,2009,0,30,29,1
10,1-8,1,8,Tampa Bay Buccaneers,2009,0,29,31,-2
9,1-7,1,7,Tampa Bay Buccaneers,2009,0,31,32,-1
8,0-7,0,7,Tampa Bay Buccaneers,2009,0,32,31,1
7,0-7,0,7,Tampa Bay Buccaneers,2009,0,31,31,0
6,0-6,0,6,Tampa Bay Buccaneers,2009,0,31,31,0
5,0-5,0,5,Tampa Bay Buccaneers,2009,0,31,31,0
4,0-4,0,4,Tampa Bay Buccaneers,2009,0,31,31,0
3,0-3,0,3,Tampa Bay Buccaneers,2009,0,31,28,3
2,0-2,0,2,Tampa Bay Buccaneers,2009,0,28,29,-1
1,0-1,0,1,Tampa Bay Buccaneers,2009,0,29,26,3
0,9-7,9,7,Tampa Bay Buccaneers,2009,0,26,0,26
17,9-7,9,7,Tampa Bay Buccaneers,2008,0,16,12,4
16,9-6,9,6,Tampa Bay Buccaneers,2008,0,12,10,2
15,9-5,9,5,Tampa Bay Buccaneers,2008,0,10,6,4
14,9-4,9,4,Tampa Bay Buccaneers,2008,0,6,4,2
13,9-3,9,3,Tampa Bay Buccaneers,2008,0,4,5,-1
12,8-3,8,3,Tampa Bay Buccaneers,2008,0,5,5,0
11,7-3,7,3,Tampa Bay Buccaneers,2008,0,5,6,-1
10,6-3,6,3,Tampa Bay Buccaneers,2008,0,6,7,-1
9,6-3,6,3,Tampa Bay Buccaneers,2008,0,7,9,-2
8,5-3,5,3,Tampa Bay Buccaneers,2008,0,9,6,3
7,5-2,5,2,Tampa Bay Buccaneers,2008,0,6,7,-1
6,4-2,4,2,Tampa Bay Buccaneers,2008,0,7,13,-6
5,3-2,3,2,Tampa Bay Buccaneers,2008,0,13,10,3
4,3-1,3,1,Tampa Bay Buccaneers,2008,0,10,13,-3
3,2-1,2,1,Tampa Bay Buccaneers,2008,0,13,17,-4
2,1-1,1,1,Tampa Bay Buccaneers,2008,0,17,20,-3
1,0-1,0,1,Tampa Bay Buccaneers,2008,0,20,15,5
0,9-7,9,7,Tampa Bay Buccaneers,2008,0,15,0,15
17,10-6,10,6,Tampa Bay Buccaneers,2010,0,13,13,0
16,9-6,9,6,Tampa Bay Buccaneers,2010,0,13,15,-2
15,8-6,8,6,Tampa Bay Buccaneers,2010,0,15,13,2
14,8-5,8,5,Tampa Bay Buccaneers,2010,0,13,13,0
13,7-5,7,5,Tampa Bay Buccaneers,2010,0,13,13,0
12,7-4,7,4,Tampa Bay Buccaneers,2010,0,13,11,2
11,7-3,7,3,Tampa Bay Buccaneers,2010,0,11,11,0
10,6-3,6,3,Tampa Bay Buccaneers,2010,0,11,13,-2
9,5-3,5,3,Tampa Bay Buccaneers,2010,0,13,14,-1
8,5-2,5,2,Tampa Bay Buccaneers,2010,0,14,18,-4
7,4-2,4,2,Tampa Bay Buccaneers,2010,0,18,19,-1
6,3-2,3,2,Tampa Bay Buccaneers,2010,0,19,16,3
5,3-1,3,1,Tampa Bay Buccaneers,2010,0,16,23,-7
4,2-1,2,1,Tampa Bay Buccaneers,2010,0,23,20,3
3,2-1,2,1,Tampa Bay Buccaneers,2010,0,20,21,-1
2,2-0,2,0,Tampa Bay Buccaneers,2010,0,21,28,-7
1,1-0,1,0,Tampa Bay Buccaneers,2010,0,28,30,-2
0,3-13,3,13,Tampa Bay Buccaneers,2010,0,30,0,30
17,4-12,4,12,Tampa Bay Buccaneers,2011,0,29,29,0
16,4-11,4,11,Tampa Bay Buccaneers,2011,0,29,29,0
15,4-10,4,10,Tampa Bay Buccaneers,2011,0,29,28,1
14,4-9,4,9,Tampa Bay Buccaneers,2011,0,28,26,2
13,4-8,4,8,Tampa Bay Buccaneers,2011,0,26,20,6
12,4-7,4,7,Tampa Bay Buccaneers,2011,0,20,20,0
11,4-6,4,6,Tampa Bay Buccaneers,2011,0,20,20,0
10,4-5,4,5,Tampa Bay Buccaneers,2011,0,20,18,2
9,4-4,4,4,Tampa Bay Buccaneers,2011,0,18,19,-1
8,4-3,4,3,Tampa Bay Buccaneers,2011,0,19,17,2
7,4-3,4,3,Tampa Bay Buccaneers,2011,0,17,12,5
6,4-2,4,2,Tampa Bay Buccaneers,2011,0,12,16,-4
5,3-2,3,2,Tampa Bay Buccaneers,2011,0,16,11,5
4,3-1,3,1,Tampa Bay Buccaneers,2011,0,11,14,-3
3,2-1,2,1,Tampa Bay Buccaneers,2011,0,14,14,0
2,1-1,1,1,Tampa Bay Buccaneers,2011,0,14,14,0
1,0-1,0,1,Tampa Bay Buccaneers,2011,0,14,12,2
0,10-6,10,6,Tampa Bay Buccaneers,2011,0,12,0,12
17,7-9,7,9,Tampa Bay Buccaneers,2012,0,21,22,-1
16,6-9,6,9,Tampa Bay Buccaneers,2012,0,22,20,2
15,6-8,6,8,Tampa Bay Buccaneers,2012,0,20,18,2
14,6-7,6,7,Tampa Bay Buccaneers,2012,0,18,15,3
13,6-6,6,6,Tampa Bay Buccaneers,2012,0,15,12,3
12,6-5,6,5,Tampa Bay Buccaneers,2012,0,12,10,2
11,6-4,6,4,Tampa Bay Buccaneers,2012,0,10,13,-3
10,5-4,5,4,Tampa Bay Buccaneers,2012,0,13,13,0
9,4-4,4,4,Tampa Bay Buccaneers,2012,0,13,21,-8
8,3-4,3,4,Tampa Bay Buccaneers,2012,0,21,26,-5
7,2-4,2,4,Tampa Bay Buccaneers,2012,0,26,22,4
6,2-3,2,3,Tampa Bay Buccaneers,2012,0,22,23,-1
5,1-3,1,3,Tampa Bay Buccaneers,2012,0,23,22,1
4,1-3,1,3,Tampa Bay Buccaneers,2012,0,22,20,2
3,1-2,1,2,Tampa Bay Buccaneers,2012,0,20,21,-1
2,1-1,1,1,Tampa Bay Buccaneers,2012,0,21,21,0
1,1-0,1,0,Tampa Bay Buccaneers,2012,0,21,25,-4
0,4-12,4,12,Tampa Bay Buccaneers,2012,0,25,0,25
17,4-12,4,12,Tampa Bay Buccaneers,2013,0,27,26,1
16,4-11,4,11,Tampa Bay Buccaneers,2013,0,26,24,2
15,4-10,4,10,Tampa Bay Buccaneers,2013,0,24,24,0
14,4-9,4,9,Tampa Bay Buccaneers,2013,0,24,26,-2
13,3-9,3,9,Tampa Bay Buccaneers,2013,0,26,27,-1
12,3-8,3,8,Tampa Bay Buccaneers,2013,0,27,28,-1
11,2-8,2,8,Tampa Bay Buccaneers,2013,0,28,31,-3
10,1-8,1,8,Tampa Bay Buccaneers,2013,0,31,31,0
9,0-8,0,8,Tampa Bay Buccaneers,2013,0,31,31,0
8,0-7,0,7,Tampa Bay Buccaneers,2013,0,31,31,0
7,0-6,0,6,Tampa Bay Buccaneers,2013,0,31,30,1
6,0-5,0,5,Tampa Bay Buccaneers,2013,0,30,30,0
5,0-4,0,4,Tampa Bay Buccaneers,2013,0,30,31,-1
4,0-4,0,4,Tampa Bay Buccaneers,2013,0,31,31,0
3,0-3,0,3,Tampa Bay Buccaneers,2013,0,31,30,1
2,0-2,0,2,Tampa Bay Buccaneers,2013,0,30,28,2
1,0-1,0,1,Tampa Bay Buccaneers,2013,0,28,22,6
0,7-9,7,9,Tampa Bay Buccaneers,2013,0,22,0,22
17,2-14,2,14,Tampa Bay Buccaneers,2014,0,31,31,0
16,2-13,2,13,Tampa Bay Buccaneers,2014,0,31,29,2
15,2-12,2,12,Tampa Bay Buccaneers,2014,0,29,30,-1
14,2-11,2,11,Tampa Bay Buccaneers,2014,0,30,28,2
13,2-10,2,10,Tampa Bay Buccaneers,2014,0,28,29,-1
12,2-9,2,9,Tampa Bay Buccaneers,2014,0,29,30,-1
11,2-8,2,8,Tampa Bay Buccaneers,2014,0,30,30,0
10,1-8,1,8,Tampa Bay Buccaneers,2014,0,30,29,1
9,1-7,1,7,Tampa Bay Buccaneers,2014,0,29,29,0
8,1-6,1,6,Tampa Bay Buccaneers,2014,0,29,30,-1
7,1-5,1,5,Tampa Bay Buccaneers,2014,0,30,30,0
6,1-5,1,5,Tampa Bay Buccaneers,2014,0,30,27,3
5,1-4,1,4,Tampa Bay Buccaneers,2014,0,27,29,-2
4,1-3,1,3,Tampa Bay Buccaneers,2014,0,29,31,-2
3,0-3,0,3,Tampa Bay Buccaneers,2014,0,31,29,2
2,0-2,0,2,Tampa Bay Buccaneers,2014,0,29,24,5
1,0-1,0,1,Tampa Bay Buccaneers,2014,0,24,19,5
0,4-12,4,12,Tampa Bay Buccaneers,2014,0,19,0,19
17,6-10,6,10,Tampa Bay Buccaneers,2015,0,24,22,2
16,6-9,6,9,Tampa Bay Buccaneers,2015,0,22,17,5
15,6-8,6,8,Tampa Bay Buccaneers,2015,0,17,18,-1
14,6-7,6,7,Tampa Bay Buccaneers,2015,0,18,14,4
13,6-6,6,6,Tampa Bay Buccaneers,2015,0,14,17,-3
12,5-6,5,6,Tampa Bay Buccaneers,2015,0,17,12,5
11,5-5,5,5,Tampa Bay Buccaneers,2015,0,12,23,-11
10,4-5,4,5,Tampa Bay Buccaneers,2015,0,23,25,-2
9,3-5,3,5,Tampa Bay Buccaneers,2015,0,25,21,4
8,3-4,3,4,Tampa Bay Buccaneers,2015,0,21,28,-7
7,2-4,2,4,Tampa Bay Buccaneers,2015,0,28,31,-3
6,2-3,2,3,Tampa Bay Buccaneers,2015,0,31,28,3
5,2-3,2,3,Tampa Bay Buccaneers,2015,0,28,32,-4
4,1-3,1,3,Tampa Bay Buccaneers,2015,0,32,30,2
3,1-2,1,2,Tampa Bay Buccaneers,2015,0,30,29,1
2,1-1,1,1,Tampa Bay Buccaneers,2015,0,29,32,-3
1,0-1,0,1,Tampa Bay Buccaneers,2015,0,32,29,3
0,2-14,2,14,Tampa Bay Buccaneers,2015,0,29,0,29
17,8-8,8,8,Tennessee Titans,2006,0,15,11,4
16,8-7,8,7,Tennessee Titans,2006,0,11,13,-2
15,7-7,7,7,Tennessee Titans,2006,0,13,14,-1
14,6-7,6,7,Tennessee Titans,2006,0,14,16,-2
13,5-7,5,7,Tennessee Titans,2006,0,16,23,-7
12,4-7,4,7,Tennessee Titans,2006,0,23,25,-2
11,3-7,3,7,Tennessee Titans,2006,0,25,29,-4
10,2-7,2,7,Tennessee Titans,2006,0,29,29,0
9,2-6,2,6,Tennessee Titans,2006,0,29,22,7
8,2-5,2,5,Tennessee Titans,2006,0,22,27,-5
7,1-5,1,5,Tennessee Titans,2006,0,27,26,1
6,1-5,1,5,Tennessee Titans,2006,0,26,30,-4
5,0-5,0,5,Tennessee Titans,2006,0,30,31,-1
4,0-4,0,4,Tennessee Titans,2006,0,31,30,1
3,0-3,0,3,Tennessee Titans,2006,0,30,31,-1
2,0-2,0,2,Tennessee Titans,2006,0,31,29,2
1,0-1,0,1,Tennessee Titans,2006,0,29,26,3
0,4-12,4,12,Tennessee Titans,2006,0,26,0,26
17,10-6,10,6,Tennessee Titans,2007,0,11,9,2
16,9-6,9,6,Tennessee Titans,2007,0,9,13,-4
15,8-6,8,6,Tennessee Titans,2007,0,13,13,0
14,7-6,7,6,Tennessee Titans,2007,0,13,12,1
13,7-5,7,5,Tennessee Titans,2007,0,12,12,0
12,6-5,6,5,Tennessee Titans,2007,0,12,11,1
11,6-4,6,4,Tennessee Titans,2007,0,11,8,3
10,6-3,6,3,Tennessee Titans,2007,0,8,7,1
9,6-2,6,2,Tennessee Titans,2007,0,7,9,-2
8,5-2,5,2,Tennessee Titans,2007,0,9,8,1
7,4-2,4,2,Tennessee Titans,2007,0,8,12,-4
6,3-2,3,2,Tennessee Titans,2007,0,12,7,5
5,3-1,3,1,Tennessee Titans,2007,0,7,7,0
4,2-1,2,1,Tennessee Titans,2007,0,7,11,-4
3,2-1,2,1,Tennessee Titans,2007,0,11,15,-4
2,1-1,1,1,Tennessee Titans,2007,0,15,14,1
1,1-0,1,0,Tennessee Titans,2007,0,14,22,-8
0,8-8,8,8,Tennessee Titans,2007,0,22,0,22
17,8-8,8,8,Tennessee Titans,2009,0,16,17,-1
16,7-8,7,8,Tennessee Titans,2009,0,17,14,3
15,7-7,7,7,Tennessee Titans,2009,0,14,17,-3
14,6-7,6,7,Tennessee Titans,2009,0,17,17,0
13,5-7,5,7,Tennessee Titans,2009,0,17,16,1
12,5-6,5,6,Tennessee Titans,2009,0,16,19,-3
11,4-6,4,6,Tennessee Titans,2009,0,19,22,-3
10,3-6,3,6,Tennessee Titans,2009,0,22,23,-1
9,2-6,2,6,Tennessee Titans,2009,0,23,26,-3
8,1-6,1,6,Tennessee Titans,2009,0,26,29,-3
7,0-6,0,6,Tennessee Titans,2009,0,29,30,-1
6,0-6,0,6,Tennessee Titans,2009,0,30,27,3
5,0-5,0,5,Tennessee Titans,2009,0,27,25,2
4,0-4,0,4,Tennessee Titans,2009,0,25,18,7
3,0-3,0,3,Tennessee Titans,2009,0,18,16,2
2,0-2,0,2,Tennessee Titans,2009,0,16,9,7
1,0-1,0,1,Tennessee Titans,2009,0,9,7,2
0,13-3,13,3,Tennessee Titans,2009,0,7,0,7
17,13-3,13,3,Tennessee Titans,2008,0,1,1,0
16,13-2,13,2,Tennessee Titans,2008,0,1,2,-1
15,12-2,12,2,Tennessee Titans,2008,0,2,1,1
14,12-1,12,1,Tennessee Titans,2008,0,1,2,-1
13,11-1,11,1,Tennessee Titans,2008,0,2,2,0
12,10-1,10,1,Tennessee Titans,2008,0,2,1,1
11,10-0,10,0,Tennessee Titans,2008,0,1,1,0
10,9-0,9,0,Tennessee Titans,2008,0,1,1,0
9,8-0,8,0,Tennessee Titans,2008,0,1,1,0
8,7-0,7,0,Tennessee Titans,2008,0,1,1,0
7,6-0,6,0,Tennessee Titans,2008,0,1,1,0
6,5-0,5,0,Tennessee Titans,2008,0,1,2,-1
5,5-0,5,0,Tennessee Titans,2008,0,2,2,0
4,4-0,4,0,Tennessee Titans,2008,0,2,4,-2
3,3-0,3,0,Tennessee Titans,2008,0,4,9,-5
2,2-0,2,0,Tennessee Titans,2008,0,9,11,-2
1,1-0,1,0,Tennessee Titans,2008,0,11,14,-3
0,10-6,10,6,Tennessee Titans,2008,0,14,0,14
17,9-7,9,7,Tennessee Titans,2011,0,12,15,-3
16,8-7,8,7,Tennessee Titans,2011,0,15,20,-5
15,7-7,7,7,Tennessee Titans,2011,0,20,13,7
14,7-6,7,6,Tennessee Titans,2011,0,13,13,0
13,7-5,7,5,Tennessee Titans,2011,0,13,17,-4
12,6-5,6,5,Tennessee Titans,2011,0,17,16,1
11,5-5,5,5,Tennessee Titans,2011,0,16,15,1
10,5-4,5,4,Tennessee Titans,2011,0,15,20,-5
9,4-4,4,4,Tennessee Titans,2011,0,20,20,0
8,4-3,4,3,Tennessee Titans,2011,0,20,19,1
7,3-3,3,3,Tennessee Titans,2011,0,19,13,6
6,3-2,3,2,Tennessee Titans,2011,0,13,13,0
5,3-2,3,2,Tennessee Titans,2011,0,13,8,5
4,3-1,3,1,Tennessee Titans,2011,0,8,15,-7
3,2-1,2,1,Tennessee Titans,2011,0,15,17,-2
2,1-1,1,1,Tennessee Titans,2011,0,17,25,-8
1,0-1,0,1,Tennessee Titans,2011,0,25,23,2
0,6-10,6,10,Tennessee Titans,2011,0,23,0,23
17,6-10,6,10,Tennessee Titans,2010,0,20,20,0
16,6-9,6,9,Tennessee Titans,2010,0,20,19,1
15,6-8,6,8,Tennessee Titans,2010,0,19,22,-3
14,5-8,5,8,Tennessee Titans,2010,0,22,22,0
13,5-7,5,7,Tennessee Titans,2010,0,22,19,3
12,5-6,5,6,Tennessee Titans,2010,0,19,17,2
11,5-5,5,5,Tennessee Titans,2010,0,17,13,4
10,5-4,5,4,Tennessee Titans,2010,0,13,11,2
9,5-3,5,3,Tennessee Titans,2010,0,11,9,2
8,5-3,5,3,Tennessee Titans,2010,0,9,7,2
7,5-2,5,2,Tennessee Titans,2010,0,7,8,-1
6,4-2,4,2,Tennessee Titans,2010,0,8,12,-4
5,3-2,3,2,Tennessee Titans,2010,0,12,19,-7
4,2-2,2,2,Tennessee Titans,2010,0,19,13,6
3,2-1,2,1,Tennessee Titans,2010,0,13,15,-2
2,1-1,1,1,Tennessee Titans,2010,0,15,9,6
1,1-0,1,0,Tennessee Titans,2010,0,9,16,-7
0,8-8,8,8,Tennessee Titans,2010,0,16,0,16
17,6-10,6,10,Tennessee Titans,2012,0,26,27,-1
16,5-10,5,10,Tennessee Titans,2012,0,27,26,1
15,5-9,5,9,Tennessee Titans,2012,0,26,28,-2
14,4-9,4,9,Tennessee Titans,2012,0,28,26,2
13,4-8,4,8,Tennessee Titans,2012,0,26,26,0
12,4-7,4,7,Tennessee Titans,2012,0,26,23,3
11,4-6,4,6,Tennessee Titans,2012,0,23,25,-2
10,4-6,4,6,Tennessee Titans,2012,0,25,27,-2
9,3-6,3,6,Tennessee Titans,2012,0,27,27,0
8,3-5,3,5,Tennessee Titans,2012,0,27,25,2
7,3-4,3,4,Tennessee Titans,2012,0,25,27,-2
6,2-4,2,4,Tennessee Titans,2012,0,27,28,-1
5,1-4,1,4,Tennessee Titans,2012,0,28,25,3
4,1-3,1,3,Tennessee Titans,2012,0,25,24,1
3,1-2,1,2,Tennessee Titans,2012,0,24,26,-2
2,0-2,0,2,Tennessee Titans,2012,0,26,22,4
1,0-1,0,1,Tennessee Titans,2012,0,22,18,4
0,9-7,9,7,Tennessee Titans,2012,0,18,0,18
17,7-9,7,9,Tennessee Titans,2013,0,22,21,1
16,6-9,6,9,Tennessee Titans,2013,0,21,21,0
15,5-9,5,9,Tennessee Titans,2013,0,21,22,-1
14,5-8,5,8,Tennessee Titans,2013,0,22,21,1
13,5-7,5,7,Tennessee Titans,2013,0,21,20,1
12,5-6,5,6,Tennessee Titans,2013,0,20,24,-4
11,4-6,4,6,Tennessee Titans,2013,0,24,21,3
10,4-5,4,5,Tennessee Titans,2013,0,21,16,5
9,4-4,4,4,Tennessee Titans,2013,0,16,18,-2
8,3-4,3,4,Tennessee Titans,2013,0,18,17,1
7,3-4,3,4,Tennessee Titans,2013,0,17,16,1
6,3-3,3,3,Tennessee Titans,2013,0,16,14,2
5,3-2,3,2,Tennessee Titans,2013,0,14,13,1
4,3-1,3,1,Tennessee Titans,2013,0,13,17,-4
3,2-1,2,1,Tennessee Titans,2013,0,17,22,-5
2,1-1,1,1,Tennessee Titans,2013,0,22,22,0
1,1-0,1,0,Tennessee Titans,2013,0,22,27,-5
0,6-10,6,10,Tennessee Titans,2013,0,27,0,27
17,2-14,2,14,Tennessee Titans,2014,0,32,32,0
16,2-13,2,13,Tennessee Titans,2014,0,32,32,0
15,2-12,2,12,Tennessee Titans,2014,0,32,32,0
14,2-11,2,11,Tennessee Titans,2014,0,32,30,2
13,2-10,2,10,Tennessee Titans,2014,0,30,28,2
12,2-9,2,9,Tennessee Titans,2014,0,28,27,1
11,2-8,2,8,Tennessee Titans,2014,0,27,29,-2
10,2-7,2,7,Tennessee Titans,2014,0,29,28,1
9,2-6,2,6,Tennessee Titans,2014,0,28,28,0
8,2-6,2,6,Tennessee Titans,2014,0,28,28,0
7,2-5,2,5,Tennessee Titans,2014,0,28,25,3
6,2-4,2,4,Tennessee Titans,2014,0,25,29,-4
5,1-4,1,4,Tennessee Titans,2014,0,29,28,1
4,1-3,1,3,Tennessee Titans,2014,0,28,27,1
3,1-2,1,2,Tennessee Titans,2014,0,27,24,3
2,1-1,1,1,Tennessee Titans,2014,0,24,19,5
1,1-0,1,0,Tennessee Titans,2014,0,19,28,-9
0,7-9,7,9,Tennessee Titans,2014,0,28,0,28
17,3-13,3,13,Tennessee Titans,2015,0,31,32,-1
16,3-12,3,12,Tennessee Titans,2015,0,32,31,1
15,3-11,3,11,Tennessee Titans,2015,0,31,30,1
14,3-10,3,10,Tennessee Titans,2015,0,30,27,3
13,3-9,3,9,Tennessee Titans,2015,0,27,30,-3
12,2-9,2,9,Tennessee Titans,2015,0,30,31,-1
11,2-8,2,8,Tennessee Titans,2015,0,31,25,6
10,2-7,2,7,Tennessee Titans,2015,0,25,29,-4
9,2-6,2,6,Tennessee Titans,2015,0,29,32,-3
8,1-6,1,6,Tennessee Titans,2015,0,32,30,2
7,1-5,1,5,Tennessee Titans,2015,0,30,30,0
6,1-4,1,4,Tennessee Titans,2015,0,30,27,3
5,1-3,1,3,Tennessee Titans,2015,0,27,23,4
4,1-2,1,2,Tennessee Titans,2015,0,23,24,-1
3,1-2,1,2,Tennessee Titans,2015,0,24,27,-3
2,1-1,1,1,Tennessee Titans,2015,0,27,23,4
1,1-0,1,0,Tennessee Titans,2015,0,23,30,-7
0,2-14,2,14,Tennessee Titans,2015,0,30,0,30
17,5-11,5,11,Washington Redskins,2006,0,27,26,1
16,5-10,5,10,Washington Redskins,2006,0,26,26,0
15,5-9,5,9,Washington Redskins,2006,0,26,27,-1
14,4-9,4,9,Washington Redskins,2006,0,27,25,2
13,4-8,4,8,Washington Redskins,2006,0,25,25,0
12,4-7,4,7,Washington Redskins,2006,0,25,28,-3
11,3-7,3,7,Washington Redskins,2006,0,28,25,3
10,3-6,3,6,Washington Redskins,2006,0,25,20,5
9,3-5,3,5,Washington Redskins,2006,0,20,23,-3
8,2-5,2,5,Washington Redskins,2006,0,23,24,-1
7,2-5,2,5,Washington Redskins,2006,0,24,21,3
6,2-4,2,4,Washington Redskins,2006,0,21,20,1
5,2-3,2,3,Washington Redskins,2006,0,20,17,3
4,2-2,2,2,Washington Redskins,2006,0,17,20,-3
3,1-2,1,2,Washington Redskins,2006,0,20,24,-4
2,0-2,0,2,Washington Redskins,2006,0,24,20,4
1,0-1,0,1,Washington Redskins,2006,0,20,14,6
0,10-6,10,6,Washington Redskins,2006,0,14,0,14
17,9-7,9,7,Washington Redskins,2007,0,10,13,-3
16,8-7,8,7,Washington Redskins,2007,0,13,16,-3
15,7-7,7,7,Washington Redskins,2007,0,16,17,-1
14,6-7,6,7,Washington Redskins,2007,0,17,21,-4
13,5-7,5,7,Washington Redskins,2007,0,21,20,1
12,5-6,5,6,Washington Redskins,2007,0,20,18,2
11,5-5,5,5,Washington Redskins,2007,0,18,14,4
10,5-4,5,4,Washington Redskins,2007,0,14,12,2
9,5-3,5,3,Washington Redskins,2007,0,12,15,-3
8,4-3,4,3,Washington Redskins,2007,0,15,10,5
7,4-2,4,2,Washington Redskins,2007,0,10,11,-1
6,3-2,3,2,Washington Redskins,2007,0,11,8,3
5,3-1,3,1,Washington Redskins,2007,0,8,13,-5
4,2-1,2,1,Washington Redskins,2007,0,13,14,-1
3,2-1,2,1,Washington Redskins,2007,0,14,14,0
2,2-0,2,0,Washington Redskins,2007,0,14,19,-5
1,1-0,1,0,Washington Redskins,2007,0,19,19,0
0,5-11,5,11,Washington Redskins,2007,0,19,0,19
17,8-8,8,8,Washington Redskins,2008,0,21,18,3
16,8-7,8,7,Washington Redskins,2008,0,18,20,-2
15,7-7,7,7,Washington Redskins,2008,0,20,18,2
14,7-6,7,6,Washington Redskins,2008,0,18,13,5
13,7-5,7,5,Washington Redskins,2008,0,13,12,1
12,7-4,7,4,Washington Redskins,2008,0,12,9,3
11,6-4,6,4,Washington Redskins,2008,0,9,5,4
10,6-3,6,3,Washington Redskins,2008,0,5,5,0
9,6-3,6,3,Washington Redskins,2008,0,5,5,0
8,6-2,6,2,Washington Redskins,2008,0,5,5,0
7,5-2,5,2,Washington Redskins,2008,0,5,5,0
6,4-2,4,2,Washington Redskins,2008,0,5,3,2
5,4-1,4,1,Washington Redskins,2008,0,3,6,-3
4,3-1,3,1,Washington Redskins,2008,0,6,15,-9
3,2-1,2,1,Washington Redskins,2008,0,15,19,-4
2,1-1,1,1,Washington Redskins,2008,0,19,23,-4
1,0-1,0,1,Washington Redskins,2008,0,23,19,4
0,9-7,9,7,Washington Redskins,2008,0,19,0,19
17,4-12,4,12,Washington Redskins,2009,0,29,28,1
16,4-11,4,11,Washington Redskins,2009,0,28,27,1
15,4-10,4,10,Washington Redskins,2009,0,27,26,1
14,4-9,4,9,Washington Redskins,2009,0,26,27,-1
13,3-9,3,9,Washington Redskins,2009,0,27,26,1
12,3-8,3,8,Washington Redskins,2009,0,26,24,2
11,3-7,3,7,Washington Redskins,2009,0,24,24,0
10,3-6,3,6,Washington Redskins,2009,0,24,26,-2
9,2-6,2,6,Washington Redskins,2009,0,26,25,1
8,2-5,2,5,Washington Redskins,2009,0,25,25,0
7,2-5,2,5,Washington Redskins,2009,0,25,27,-2
6,2-4,2,4,Washington Redskins,2009,0,27,24,3
5,2-3,2,3,Washington Redskins,2009,0,24,22,2
4,2-2,2,2,Washington Redskins,2009,0,22,26,-4
3,1-2,1,2,Washington Redskins,2009,0,26,23,3
2,1-1,1,1,Washington Redskins,2009,0,23,20,3
1,0-1,0,1,Washington Redskins,2009,0,20,20,0
0,8-8,8,8,Washington Redskins,2009,0,20,0,20
17,6-10,6,10,Washington Redskins,2010,0,26,21,5
16,6-9,6,9,Washington Redskins,2010,0,21,26,-5
15,5-9,5,9,Washington Redskins,2010,0,26,25,1
14,5-8,5,8,Washington Redskins,2010,0,25,25,0
13,5-7,5,7,Washington Redskins,2010,0,25,21,4
12,5-6,5,6,Washington Redskins,2010,0,21,18,3
11,5-5,5,5,Washington Redskins,2010,0,18,21,-3
10,4-5,4,5,Washington Redskins,2010,0,21,18,3
9,4-4,4,4,Washington Redskins,2010,0,18,18,0
8,4-4,4,4,Washington Redskins,2010,0,18,13,5
7,4-3,4,3,Washington Redskins,2010,0,13,14,-1
6,3-3,3,3,Washington Redskins,2010,0,14,11,3
5,3-2,3,2,Washington Redskins,2010,0,11,16,-5
4,2-2,2,2,Washington Redskins,2010,0,16,21,-5
3,1-2,1,2,Washington Redskins,2010,0,21,14,7
2,1-1,1,1,Washington Redskins,2010,0,14,14,0
1,1-0,1,0,Washington Redskins,2010,0,14,17,-3
0,4-12,4,12,Washington Redskins,2010,0,17,0,17
17,10-6,10,6,Washington Redskins,2012,0,8,9,-1
16,9-6,9,6,Washington Redskins,2012,0,9,8,1
15,8-6,8,6,Washington Redskins,2012,0,8,12,-4
14,7-6,7,6,Washington Redskins,2012,0,12,14,-2
13,6-6,6,6,Washington Redskins,2012,0,14,17,-3
12,5-6,5,6,Washington Redskins,2012,0,17,18,-1
11,4-6,4,6,Washington Redskins,2012,0,18,21,-3
10,3-6,3,6,Washington Redskins,2012,0,21,19,2
9,3-6,3,6,Washington Redskins,2012,0,19,19,0
8,3-5,3,5,Washington Redskins,2012,0,19,18,1
7,3-4,3,4,Washington Redskins,2012,0,18,15,3
6,3-3,3,3,Washington Redskins,2012,0,15,21,-6
5,2-3,2,3,Washington Redskins,2012,0,21,18,3
4,2-2,2,2,Washington Redskins,2012,0,18,22,-4
3,1-2,1,2,Washington Redskins,2012,0,22,20,2
2,1-1,1,1,Washington Redskins,2012,0,20,15,5
1,1-0,1,0,Washington Redskins,2012,0,15,24,-9
0,5-11,5,11,Washington Redskins,2012,0,24,0,24
17,3-13,3,13,Washington Redskins,2013,0,31,31,0
16,3-12,3,12,Washington Redskins,2013,0,31,31,0
15,3-11,3,11,Washington Redskins,2013,0,31,31,0
14,3-10,3,10,Washington Redskins,2013,0,31,30,1
13,3-9,3,9,Washington Redskins,2013,0,30,29,1
12,3-8,3,8,Washington Redskins,2013,0,29,27,2
11,3-7,3,7,Washington Redskins,2013,0,27,23,4
10,3-6,3,6,Washington Redskins,2013,0,23,22,1
9,3-5,3,5,Washington Redskins,2013,0,22,24,-2
8,2-5,2,5,Washington Redskins,2013,0,24,23,1
7,2-4,2,4,Washington Redskins,2013,0,23,28,-5
6,1-4,1,4,Washington Redskins,2013,0,28,27,1
5,1-3,1,3,Washington Redskins,2013,0,27,25,2
4,1-3,1,3,Washington Redskins,2013,0,25,27,-2
3,0-3,0,3,Washington Redskins,2013,0,27,24,3
2,0-2,0,2,Washington Redskins,2013,0,24,19,5
1,0-1,0,1,Washington Redskins,2013,0,19,10,9
0,10-6,10,6,Washington Redskins,2013,0,10,0,10
17,4-12,4,12,Washington Redskins,2014,0,28,27,1
16,4-11,4,11,Washington Redskins,2014,0,27,28,-1
15,3-11,3,11,Washington Redskins,2014,0,28,27,1
14,3-10,3,10,Washington Redskins,2014,0,27,27,0
13,3-9,3,9,Washington Redskins,2014,0,27,27,0
12,3-8,3,8,Washington Redskins,2014,0,27,29,-2
11,3-7,3,7,Washington Redskins,2014,0,29,26,3
10,3-6,3,6,Washington Redskins,2014,0,26,26,0
9,3-6,3,6,Washington Redskins,2014,0,26,24,2
8,3-5,3,5,Washington Redskins,2014,0,24,26,-2
7,2-5,2,5,Washington Redskins,2014,0,26,28,-2
6,1-5,1,5,Washington Redskins,2014,0,28,26,2
5,1-4,1,4,Washington Redskins,2014,0,26,27,-1
4,1-3,1,3,Washington Redskins,2014,0,27,23,4
3,1-2,1,2,Washington Redskins,2014,0,23,25,-2
2,1-1,1,1,Washington Redskins,2014,0,25,28,-3
1,0-1,0,1,Washington Redskins,2014,0,28,25,3
0,3-13,3,13,Washington Redskins,2014,0,25,0,25
17,9-7,9,7,Washington Redskins,2015,0,11,12,-1
16,8-7,8,7,Washington Redskins,2015,0,12,12,0
15,7-7,7,7,Washington Redskins,2015,0,12,15,-3
14,6-7,6,7,Washington Redskins,2015,0,15,18,-3
13,5-7,5,7,Washington Redskins,2015,0,18,13,5
12,5-6,5,6,Washington Redskins,2015,0,13,20,-7
11,4-6,4,6,Washington Redskins,2015,0,20,20,0
10,4-5,4,5,Washington Redskins,2015,0,20,26,-6
9,3-5,3,5,Washington Redskins,2015,0,26,24,2
8,3-4,3,4,Washington Redskins,2015,0,24,23,1
7,3-4,3,4,Washington Redskins,2015,0,23,22,1
6,2-4,2,4,Washington Redskins,2015,0,22,21,1
5,2-3,2,3,Washington Redskins,2015,0,21,24,-3
4,2-2,2,2,Washington Redskins,2015,0,24,27,-3
3,1-2,1,2,Washington Redskins,2015,0,27,23,4
2,1-1,1,1,Washington Redskins,2015,0,23,29,-6
1,0-1,0,1,Washington Redskins,2015,0,29,32,-3
0,4-12,4,12,Washington Redskins,2015,0,32,0,32
17,5-11,5,11,Washington Redskins,2011,0,26,26,0
16,5-10,5,10,Washington Redskins,2011,0,26,25,1
15,5-9,5,9,Washington Redskins,2011,0,25,27,-2
14,4-9,4,9,Washington Redskins,2011,0,27,27,0
13,4-8,4,8,Washington Redskins,2011,0,27,23,4
12,4-7,4,7,Washington Redskins,2011,0,23,26,-3
11,3-7,3,7,Washington Redskins,2011,0,26,26,0
10,3-6,3,6,Washington Redskins,2011,0,26,22,4
9,3-5,3,5,Washington Redskins,2011,0,22,22,0
8,3-4,3,4,Washington Redskins,2011,0,22,20,2
7,3-3,3,3,Washington Redskins,2011,0,20,15,5
6,3-2,3,2,Washington Redskins,2011,0,15,10,5
5,3-1,3,1,Washington Redskins,2011,0,10,12,-2
4,3-1,3,1,Washington Redskins,2011,0,12,16,-4
3,2-1,2,1,Washington Redskins,2011,0,16,15,1
2,2-0,2,0,Washington Redskins,2011,0,15,19,-4
1,1-0,1,0,Washington Redskins,2011,0,19,28,-9
0,6-10,6,10,Washington Redskins,2011,0,28,0,28
